Day,Month,Year,Description,Category,Value,Balance
1,1,2010,Rhino Sports salary,General,1600,1600
1,1,2010,Sainsburys,Groceries,48,1552
1,1,2010,McDonalds,Eating Out,7,1545
1,1,2010,Pizza Express,Eating Out,24,1521
3,1,2010,ATM Cash Withdrawal,General,20,1501
4,1,2010,South West Trains,Transport,25,1476
4,1,2010,Caffe Nero,Eating Out,1,1475
4,1,2010,The West Cornwall Pasty Company,Eating Out,6,1469
6,1,2010,ATM Cash Withdrawal,General,10,1459
7,1,2010,Cubit and West rent,Rent,400,1059
7,1,2010,Costa Coffee,Eating Out,1,1058
7,1,2010,Subway,Eating Out,5,1053
8,1,2010,Waitrose,Groceries,68,985
8,1,2010,Costa Coffee,Eating Out,2,983
10,1,2010,Anglo restaurant,Eating Out,53,930
10,1,2010,ATM Cash Withdrawal,General,20,910
11,1,2010,South West Trains,Transport,22,888
11,1,2010,Wild Bean Cafe,Eating Out,2,886
11,1,2010,Greggs,Eating Out,6,880
12,1,2010,Costa Coffee,Eating Out,2,878
12,1,2010,Paying back James,,7,871
13,1,2010,Caffe Nero,Eating Out,1,870
14,1,2010,Costa Coffee,Eating Out,2,868
14,1,2010,Chicken Cottage,Eating Out,5,863
15,1,2010,BRGAS-Electricity,Bills,29,834
15,1,2010,BRGAS-Gas,Bills,60,774
15,1,2010,Waitrose,Groceries,53,721
15,1,2010,Wild Bean Cafe,Eating Out,2,719
15,1,2010,Subway,Eating Out,6,713
15,1,2010,Dominos Pizza,Eating Out,33,680
16,1,2010,LBS Council Tax,Bills,20,660
16,1,2010,Heaven Club,Eating Out,12,648
16,1,2010,Heaven Club,Eating Out,10,638
16,1,2010,Heaven Club,Eating Out,13,625
17,1,2010,Pizza Express,Eating Out,39,586
17,1,2010,ATM Cash Withdrawal,General,20,566
17,1,2010,Paying back Julie,,5,561
18,1,2010,South West Trains,Transport,18,543
18,1,2010,Starbucks Coffee,Eating Out,1,542
18,1,2010,McDonalds,Eating Out,5,537
19,1,2010,McDonalds,Eating Out,5,532
20,1,2010,VIRGIN MEDIA PYMTS,Bills,23,509
20,1,2010,Wild Bean Cafe,Eating Out,1,508
20,1,2010,Pret A Manger,Eating Out,5,503
20,1,2010,ATM Cash Withdrawal,General,10,493
21,1,2010,Wild Bean Cafe,Eating Out,2,491
21,1,2010,Subway,Eating Out,7,484
22,1,2010,Morrisons,Groceries,41,443
22,1,2010,Ministry of Sound ClubXOYO Club,Eating Out,6,437
22,1,2010,Ministry of Sound ClubXOYO Club,Eating Out,6,431
22,1,2010,Ministry of Sound ClubXOYO Club,Eating Out,7,424
22,1,2010,Ministry of Sound ClubXOYO Club,Eating Out,14,410
22,1,2010,Ministry of Sound ClubXOYO Club,Eating Out,11,399
22,1,2010,Scott's Restaurant,Eating Out,29,370
24,1,2010,O2,Bills,21,349
24,1,2010,Pizza Express,Eating Out,51,298
25,1,2010,South West Trains,Transport,17,281
25,1,2010,Starbucks Coffee,Eating Out,1,280
25,1,2010,ATM Cash Withdrawal,General,10,270
27,1,2010,Caffe Nero,Eating Out,2,268
28,1,2010,McDonalds,Eating Out,5,263
28,1,2010,ATM Cash Withdrawal,General,10,253
29,1,2010,Waitrose,Groceries,38,215
29,1,2010,Caffe Nero,Eating Out,2,213
29,1,2010,Dominos Pizza,Eating Out,57,156
30,1,2010,The Grand Pub,Eating Out,7,149
30,1,2010,The Grand Pub,Eating Out,10,139
30,1,2010,The Grand Pub,Eating Out,10,129
30,1,2010,The Grand Pub,Eating Out,14,115
30,1,2010,The Grand Pub,Eating Out,13,102
30,1,2010,The Grand Pub,Eating Out,13,89
30,1,2010,ATM Cash Withdrawal,General,10,79
30,1,2010,Cheam Service Station,,8,71
31,1,2010,ATM Cash Withdrawal,General,20,51
1,2,2010,Rhino Sports salary,General,1600,1651
1,2,2010,South West Trains,Transport,23,1628
1,2,2010,Wild Bean Cafe,Eating Out,1,1627
1,2,2010,Subway,Eating Out,7,1620
2,2,2010,Wild Bean Cafe,Eating Out,2,1618
2,2,2010,Subway,Eating Out,6,1612
3,2,2010,Caffe Nero,Eating Out,2,1610
4,2,2010,Caffe Nero,Eating Out,2,1608
4,2,2010,The West Cornwall Pasty Company,Eating Out,8,1600
4,2,2010,ATM Cash Withdrawal,General,10,1590
5,2,2010,ASDA,Groceries,54,1536
5,2,2010,Caffe Nero,Eating Out,2,1534
6,2,2010,Scott's Restaurant,Eating Out,40,1494
7,2,2010,Cubit and West rent,Rent,400,1094
8,2,2010,South West Trains,Transport,19,1075
8,2,2010,Greggs,Eating Out,7,1068
8,2,2010,ATM Cash Withdrawal,General,20,1048
8,2,2010,Tool Shop,,8,1040
9,2,2010,Caffe Nero,Eating Out,1,1039
10,2,2010,Wild Bean Cafe,Eating Out,2,1037
10,2,2010,Pret A Manger,Eating Out,7,1030
10,2,2010,ATM Cash Withdrawal,General,10,1020
11,2,2010,Pret A Manger,Eating Out,7,1013
12,2,2010,Tescos,Groceries,72,941
13,2,2010,Fabric Club,Eating Out,14,927
13,2,2010,Fabric Club,Eating Out,16,911
13,2,2010,Fabric Club,Eating Out,12,899
13,2,2010,Scott's Restaurant,Eating Out,44,855
13,2,2010,ATM Cash Withdrawal,General,10,845
14,2,2010,Restaurant Gordon RamsayPortland Restaurant,Eating Out,54,791
14,2,2010,ATM Cash Withdrawal,General,10,781
14,2,2010,Paying back Julie,,1,780
15,2,2010,BRGAS-Electricity,Bills,22,758
15,2,2010,BRGAS-Gas,Bills,14,744
15,2,2010,South West Trains,Transport,20,724
15,2,2010,Greggs,Eating Out,5,719
16,2,2010,LBS Council Tax,Bills,20,699
16,2,2010,Wild Bean Cafe,Eating Out,1,698
16,2,2010,The West Cornwall Pasty Company,Eating Out,5,693
17,2,2010,Costa Coffee,Eating Out,1,692
17,2,2010,Pret A Manger,Eating Out,5,687
17,2,2010,ATM Cash Withdrawal,General,10,677
18,2,2010,Caffe Nero,Eating Out,1,676
19,2,2010,Tescos,Groceries,49,627
19,2,2010,Starbucks Coffee,Eating Out,2,625
19,2,2010,Pret A Manger,Eating Out,8,617
20,2,2010,VIRGIN MEDIA PYMTS,Bills,19,598
20,2,2010,Scott's Restaurant,Eating Out,48,550
20,2,2010,ATM Cash Withdrawal,General,20,530
21,2,2010,ATM Cash Withdrawal,General,20,510
22,2,2010,South West Trains,Transport,19,491
22,2,2010,Wild Bean Cafe,Eating Out,1,490
22,2,2010,Subway,Eating Out,7,483
23,2,2010,Wild Bean Cafe,Eating Out,1,482
24,2,2010,O2,Bills,23,459
24,2,2010,Starbucks Coffee,Eating Out,1,458
24,2,2010,ATM Cash Withdrawal,General,10,448
25,2,2010,Costa Coffee,Eating Out,2,446
26,2,2010,Morrisons,Groceries,45,401
26,2,2010,Caffe Nero,Eating Out,2,399
26,2,2010,McDonalds,Eating Out,6,393
26,2,2010,ATM Cash Withdrawal,General,20,373
1,3,2010,Rhino Sports salary,General,1600,1973
1,3,2010,South West Trains,Transport,19,1954
1,3,2010,Caffe Nero,Eating Out,1,1953
1,3,2010,Pret A Manger,Eating Out,5,1948
2,3,2010,Costa Coffee,Eating Out,2,1946
2,3,2010,Greggs,Eating Out,5,1941
3,3,2010,Costa Coffee,Eating Out,2,1939
3,3,2010,ATM Cash Withdrawal,General,10,1929
4,3,2010,Costa Coffee,Eating Out,1,1928
4,3,2010,McDonalds,Eating Out,6,1922
5,3,2010,Morrisons,Groceries,40,1882
5,3,2010,Costa Coffee,Eating Out,2,1880
6,3,2010,ATM Cash Withdrawal,General,10,1870
7,3,2010,Cubit and West rent,Rent,400,1470
7,3,2010,Dominos Pizza,Eating Out,32,1438
8,3,2010,South West Trains,Transport,20,1418
8,3,2010,Pret A Manger,Eating Out,7,1411
9,3,2010,Subway,Eating Out,7,1404
9,3,2010,ATM Cash Withdrawal,General,20,1384
10,3,2010,McDonalds,Eating Out,5,1379
10,3,2010,ATM Cash Withdrawal,General,10,1369
11,3,2010,Costa Coffee,Eating Out,2,1367
11,3,2010,McDonalds,Eating Out,6,1361
11,3,2010,ATM Cash Withdrawal,General,10,1351
12,3,2010,Tescos,Groceries,46,1305
12,3,2010,Pret A Manger,Eating Out,8,1297
12,3,2010,ATM Cash Withdrawal,General,20,1277
14,3,2010,Dominos Pizza,Eating Out,25,1252
15,3,2010,BRGAS-Electricity,Bills,27,1225
15,3,2010,BRGAS-Gas,Bills,26,1199
15,3,2010,South West Trains,Transport,25,1174
15,3,2010,Caffe Nero,Eating Out,1,1173
15,3,2010,McDonalds,Eating Out,8,1165
15,3,2010,ATM Cash Withdrawal,General,20,1145
16,3,2010,LBS Council Tax,Bills,20,1125
16,3,2010,Costa Coffee,Eating Out,1,1124
16,3,2010,Pret A Manger,Eating Out,8,1116
16,3,2010,Tool Tec,,5,1111
17,3,2010,Wild Bean Cafe,Eating Out,2,1109
18,3,2010,Starbucks Coffee,Eating Out,2,1107
18,3,2010,Pret A Manger,Eating Out,8,1099
18,3,2010,ATM Cash Withdrawal,General,10,1089
19,3,2010,Sainsburys,Groceries,60,1029
19,3,2010,McDonalds,Eating Out,8,1021
19,3,2010,Restaurant Gordon RamsayPortland Restaurant,Eating Out,42,979
20,3,2010,VIRGIN MEDIA PYMTS,Bills,17,962
21,3,2010,Anglo restaurant,Eating Out,31,931
22,3,2010,South West Trains,Transport,22,909
22,3,2010,Wild Bean Cafe,Eating Out,1,908
22,3,2010,Paying back James,,9,899
23,3,2010,Starbucks Coffee,Eating Out,2,897
23,3,2010,The West Cornwall Pasty Company,Eating Out,4,893
24,3,2010,O2,Bills,20,873
24,3,2010,Starbucks Coffee,Eating Out,2,871
24,3,2010,Chicken Cottage,Eating Out,7,864
25,3,2010,Starbucks Coffee,Eating Out,1,863
25,3,2010,The West Cornwall Pasty Company,Eating Out,6,857
26,3,2010,Tescos,Groceries,48,809
26,3,2010,Subway,Eating Out,7,802
26,3,2010,Scott's Restaurant,Eating Out,26,776
28,3,2010,Scott's Restaurant,Eating Out,37,739
29,3,2010,South West Trains,Transport,22,717
29,3,2010,Caffe Nero,Eating Out,1,716
29,3,2010,Chicken Cottage,Eating Out,7,709
30,3,2010,Costa Coffee,Eating Out,2,707
30,3,2010,Pret A Manger,Eating Out,7,700
30,3,2010,ATM Cash Withdrawal,General,10,690
31,3,2010,The West Cornwall Pasty Company,Eating Out,7,683
1,4,2010,Rhino Sports salary,General,1600,2283
1,4,2010,Starbucks Coffee,Eating Out,2,2281
1,4,2010,The West Cornwall Pasty Company,Eating Out,7,2274
2,4,2010,Tescos,Groceries,60,2214
2,4,2010,Starbucks Coffee,Eating Out,1,2213
2,4,2010,Greggs,Eating Out,4,2209
2,4,2010,Scott's Restaurant,Eating Out,36,2173
3,4,2010,Fabric Club,Eating Out,13,2160
3,4,2010,Fabric Club,Eating Out,7,2153
3,4,2010,Fabric Club,Eating Out,12,2141
3,4,2010,Fabric Club,Eating Out,5,2136
3,4,2010,Fabric Club,Eating Out,9,2127
3,4,2010,Fabric Club,Eating Out,16,2111
3,4,2010,Paying back James,,2,2109
5,4,2010,South West Trains,Transport,18,2091
5,4,2010,Costa Coffee,Eating Out,2,2089
5,4,2010,ATM Cash Withdrawal,General,20,2069
5,4,2010,Red Shop,,7,2062
6,4,2010,Starbucks Coffee,Eating Out,2,2060
7,4,2010,Cubit and West rent,Rent,400,1660
7,4,2010,Caffe Nero,Eating Out,2,1658
7,4,2010,Greggs,Eating Out,7,1651
7,4,2010,ATM Cash Withdrawal,General,10,1641
8,4,2010,Wild Bean Cafe,Eating Out,1,1640
8,4,2010,Greggs,Eating Out,7,1633
8,4,2010,ATM Cash Withdrawal,General,20,1613
9,4,2010,ASDA,Groceries,55,1558
10,4,2010,ATM Cash Withdrawal,General,10,1548
11,4,2010,Restaurant Gordon RamsayPortland Restaurant,Eating Out,44,1504
12,4,2010,South West Trains,Transport,16,1488
13,4,2010,The West Cornwall Pasty Company,Eating Out,8,1480
15,4,2010,BRGAS-Electricity,Bills,16,1464
15,4,2010,BRGAS-Gas,Bills,27,1437
15,4,2010,Starbucks Coffee,Eating Out,2,1435
15,4,2010,Pret A Manger,Eating Out,8,1427
16,4,2010,LBS Council Tax,Bills,20,1407
16,4,2010,Morrisons,Groceries,57,1350
16,4,2010,Wild Bean Cafe,Eating Out,2,1348
18,4,2010,Pizza Express,Eating Out,30,1318
18,4,2010,ATM Cash Withdrawal,General,20,1298
19,4,2010,South West Trains,Transport,25,1273
19,4,2010,Caffe Nero,Eating Out,2,1271
19,4,2010,McDonalds,Eating Out,7,1264
20,4,2010,VIRGIN MEDIA PYMTS,Bills,24,1240
21,4,2010,Caffe Nero,Eating Out,1,1239
21,4,2010,The West Cornwall Pasty Company,Eating Out,6,1233
22,4,2010,Wild Bean Cafe,Eating Out,1,1232
22,4,2010,McDonalds,Eating Out,7,1225
23,4,2010,Morrisons,Groceries,69,1156
23,4,2010,Chicken Cottage,Eating Out,5,1151
24,4,2010,O2,Bills,22,1129
24,4,2010,Anglo restaurant,Eating Out,26,1103
24,4,2010,ATM Cash Withdrawal,General,10,1093
26,4,2010,South West Trains,Transport,19,1074
26,4,2010,Costa Coffee,Eating Out,2,1072
26,4,2010,The West Cornwall Pasty Company,Eating Out,4,1068
27,4,2010,Starbucks Coffee,Eating Out,1,1067
27,4,2010,Greggs,Eating Out,7,1060
27,4,2010,ATM Cash Withdrawal,General,10,1050
28,4,2010,Wild Bean Cafe,Eating Out,2,1048
28,4,2010,Chicken Cottage,Eating Out,8,1040
29,4,2010,Caffe Nero,Eating Out,2,1038
29,4,2010,Pret A Manger,Eating Out,6,1032
29,4,2010,Tool Tec,,4,1028
30,4,2010,Waitrose,Groceries,52,976
30,4,2010,Wild Bean Cafe,Eating Out,2,974
30,4,2010,Dominos Pizza,Eating Out,51,923
30,4,2010,ATM Cash Withdrawal,General,10,913
1,5,2010,Rhino Sports salary,General,1600,2513
2,5,2010,Dominos Pizza,Eating Out,29,2484
3,5,2010,South West Trains,Transport,22,2462
3,5,2010,Starbucks Coffee,Eating Out,1,2461
3,5,2010,Pret A Manger,Eating Out,7,2454
4,5,2010,Starbucks Coffee,Eating Out,1,2453
4,5,2010,McDonalds,Eating Out,6,2447
5,5,2010,Wild Bean Cafe,Eating Out,1,2446
5,5,2010,Greggs,Eating Out,6,2440
7,5,2010,Cubit and West rent,Rent,400,2040
7,5,2010,ASDA,Groceries,46,1994
7,5,2010,Costa Coffee,Eating Out,1,1993
7,5,2010,McDonalds,Eating Out,8,1985
7,5,2010,Pizza Express,Eating Out,25,1960
8,5,2010,Anglo restaurant,Eating Out,54,1906
8,5,2010,ATM Cash Withdrawal,General,20,1886
9,5,2010,Pizza Express,Eating Out,24,1862
10,5,2010,South West Trains,Transport,22,1840
10,5,2010,Wild Bean Cafe,Eating Out,1,1839
10,5,2010,The West Cornwall Pasty Company,Eating Out,4,1835
11,5,2010,Starbucks Coffee,Eating Out,2,1833
11,5,2010,ATM Cash Withdrawal,General,10,1823
12,5,2010,Caffe Nero,Eating Out,2,1821
12,5,2010,Chicken Cottage,Eating Out,7,1814
13,5,2010,Caffe Nero,Eating Out,1,1813
13,5,2010,Tool Shop,,9,1804
14,5,2010,Waitrose,Groceries,42,1762
14,5,2010,Starbucks Coffee,Eating Out,2,1760
14,5,2010,Pret A Manger,Eating Out,5,1755
14,5,2010,Pizza Express,Eating Out,29,1726
15,5,2010,BRGAS-Electricity,Bills,27,1699
15,5,2010,BRGAS-Gas,Bills,28,1671
15,5,2010,Pizza Express,Eating Out,55,1616
16,5,2010,LBS Council Tax,Bills,20,1596
16,5,2010,Dominos Pizza,Eating Out,48,1548
17,5,2010,South West Trains,Transport,21,1527
17,5,2010,Costa Coffee,Eating Out,1,1526
18,5,2010,Starbucks Coffee,Eating Out,2,1524
19,5,2010,Caffe Nero,Eating Out,2,1522
19,5,2010,Chicken Cottage,Eating Out,5,1517
20,5,2010,VIRGIN MEDIA PYMTS,Bills,16,1501
20,5,2010,Greggs,Eating Out,4,1497
20,5,2010,ATM Cash Withdrawal,General,10,1487
21,5,2010,Sainsburys,Groceries,60,1427
21,5,2010,Costa Coffee,Eating Out,2,1425
24,5,2010,O2,Bills,22,1403
24,5,2010,South West Trains,Transport,17,1386
24,5,2010,ATM Cash Withdrawal,General,20,1366
25,5,2010,Starbucks Coffee,Eating Out,2,1364
25,5,2010,Greggs,Eating Out,6,1358
25,5,2010,ATM Cash Withdrawal,General,20,1338
25,5,2010,Red Shop,,7,1331
26,5,2010,Costa Coffee,Eating Out,2,1329
26,5,2010,Chicken Cottage,Eating Out,6,1323
26,5,2010,ATM Cash Withdrawal,General,10,1313
27,5,2010,Starbucks Coffee,Eating Out,2,1311
27,5,2010,Pret A Manger,Eating Out,5,1306
28,5,2010,Morrisons,Groceries,46,1260
28,5,2010,Costa Coffee,Eating Out,2,1258
28,5,2010,Greggs,Eating Out,7,1251
29,5,2010,Dominos Pizza,Eating Out,33,1218
30,5,2010,Dominos Pizza,Eating Out,40,1178
30,5,2010,ATM Cash Withdrawal,General,10,1168
31,5,2010,South West Trains,Transport,22,1146
31,5,2010,Costa Coffee,Eating Out,2,1144
31,5,2010,ATM Cash Withdrawal,General,10,1134
1,6,2010,Rhino Sports salary,General,1600,2734
1,6,2010,Wild Bean Cafe,Eating Out,2,2732
1,6,2010,Subway,Eating Out,7,2725
1,6,2010,Civic Shop,,4,2721
2,6,2010,Costa Coffee,Eating Out,2,2719
2,6,2010,Pret A Manger,Eating Out,4,2715
3,6,2010,Starbucks Coffee,Eating Out,2,2713
4,6,2010,Waitrose,Groceries,47,2666
4,6,2010,Caffe Nero,Eating Out,1,2665
4,6,2010,Subway,Eating Out,8,2657
5,6,2010,Civic Shop,,6,2651
6,6,2010,ATM Cash Withdrawal,General,20,2631
7,6,2010,Cubit and West rent,Rent,400,2231
7,6,2010,South West Trains,Transport,19,2212
7,6,2010,Caffe Nero,Eating Out,1,2211
8,6,2010,Wild Bean Cafe,Eating Out,2,2209
8,6,2010,Subway,Eating Out,7,2202
8,6,2010,ATM Cash Withdrawal,General,20,2182
8,6,2010,British Airways,General,215,1967
8,6,2010,Civic Shop,,4,1963
9,6,2010,Costa Coffee,Eating Out,2,1961
9,6,2010,Chicken Cottage,Eating Out,7,1954
10,6,2010,Costa Coffee,Eating Out,1,1953
10,6,2010,McDonalds,Eating Out,6,1947
11,6,2010,Sainsburys,Groceries,46,1901
11,6,2010,The West Cornwall Pasty Company,Eating Out,8,1893
11,6,2010,Dominos Pizza,Eating Out,43,1850
12,6,2010,The Grand Pub,Eating Out,12,1838
12,6,2010,The Grand Pub,Eating Out,9,1829
12,6,2010,The Grand Pub,Eating Out,12,1817
13,6,2010,Anglo restaurant,Eating Out,53,1764
14,6,2010,South West Trains,Transport,22,1742
14,6,2010,Wild Bean Cafe,Eating Out,2,1740
14,6,2010,The West Cornwall Pasty Company,Eating Out,5,1735
14,6,2010,Red Shop,,2,1733
15,6,2010,BRGAS-Electricity,Bills,25,1708
15,6,2010,BRGAS-Gas,Bills,14,1694
15,6,2010,Greggs,Eating Out,4,1690
16,6,2010,LBS Council Tax,Bills,20,1670
16,6,2010,Wild Bean Cafe,Eating Out,2,1668
16,6,2010,McDonalds,Eating Out,8,1660
17,6,2010,Caffe Nero,Eating Out,2,1658
17,6,2010,Pret A Manger,Eating Out,4,1654
18,6,2010,ASDA,Groceries,37,1617
18,6,2010,Starbucks Coffee,Eating Out,2,1615
18,6,2010,Heaven Club,Eating Out,11,1604
18,6,2010,Heaven Club,Eating Out,15,1589
18,6,2010,Heaven Club,Eating Out,11,1578
18,6,2010,Heaven Club,Eating Out,11,1567
18,6,2010,Heaven Club,Eating Out,13,1554
18,6,2010,ATM Cash Withdrawal,General,20,1534
19,6,2010,ATM Cash Withdrawal,General,20,1514
20,6,2010,VIRGIN MEDIA PYMTS,Bills,21,1493
20,6,2010,Tool Shop,,7,1486
21,6,2010,South West Trains,Transport,20,1466
22,6,2010,Costa Coffee,Eating Out,1,1465
23,6,2010,Caffe Nero,Eating Out,1,1464
23,6,2010,McDonalds,Eating Out,4,1460
24,6,2010,O2,Bills,22,1438
24,6,2010,Wild Bean Cafe,Eating Out,1,1437
24,6,2010,Chicken Cottage,Eating Out,8,1429
24,6,2010,ATM Cash Withdrawal,General,20,1409
25,6,2010,Tescos,Groceries,60,1349
25,6,2010,Costa Coffee,Eating Out,2,1347
25,6,2010,Greggs,Eating Out,8,1339
26,6,2010,Anglo restaurant,Eating Out,26,1313
27,6,2010,Pizza Express,Eating Out,52,1261
28,6,2010,South West Trains,Transport,18,1243
28,6,2010,Starbucks Coffee,Eating Out,2,1241
29,6,2010,Costa Coffee,Eating Out,2,1239
29,6,2010,Chicken Cottage,Eating Out,6,1233
30,6,2010,Caffe Nero,Eating Out,2,1231
30,6,2010,Chicken Cottage,Eating Out,4,1227
30,6,2010,ATM Cash Withdrawal,General,20,1207
1,7,2010,Rhino Sports salary,General,1600,2807
1,7,2010,Caffe Nero,Eating Out,2,2805
1,7,2010,Pret A Manger,Eating Out,6,2799
2,7,2010,Waitrose,Groceries,48,2751
2,7,2010,Wild Bean Cafe,Eating Out,2,2749
2,7,2010,Subway,Eating Out,7,2742
4,7,2010,Tool Shop,,2,2740
5,7,2010,South West Trains,Transport,23,2717
5,7,2010,Wild Bean Cafe,Eating Out,1,2716
5,7,2010,McDonalds,Eating Out,6,2710
6,7,2010,Costa Coffee,Eating Out,1,2709
6,7,2010,Greggs,Eating Out,7,2702
6,7,2010,ATM Cash Withdrawal,General,10,2692
6,7,2010,Tool Shop,,3,2689
7,7,2010,Cubit and West rent,Rent,400,2289
7,7,2010,Wild Bean Cafe,Eating Out,2,2287
7,7,2010,Subway,Eating Out,8,2279
7,7,2010,ATM Cash Withdrawal,General,10,2269
8,7,2010,Caffe Nero,Eating Out,1,2268
8,7,2010,McDonalds,Eating Out,6,2262
9,7,2010,Waitrose,Groceries,52,2210
9,7,2010,Wild Bean Cafe,Eating Out,2,2208
9,7,2010,Pret A Manger,Eating Out,4,2204
10,7,2010,Fabric Club,Eating Out,11,2193
10,7,2010,Fabric Club,Eating Out,14,2179
10,7,2010,Fabric Club,Eating Out,12,2167
10,7,2010,Fabric Club,Eating Out,11,2156
10,7,2010,Fabric Club,Eating Out,14,2142
12,7,2010,South West Trains,Transport,24,2118
12,7,2010,Costa Coffee,Eating Out,2,2116
13,7,2010,Starbucks Coffee,Eating Out,2,2114
13,7,2010,Red Shop,,9,2105
14,7,2010,Starbucks Coffee,Eating Out,2,2103
14,7,2010,Chicken Cottage,Eating Out,4,2099
14,7,2010,Civic Shop,,4,2095
15,7,2010,BRGAS-Electricity,Bills,21,2074
15,7,2010,BRGAS-Gas,Bills,25,2049
15,7,2010,Caffe Nero,Eating Out,2,2047
15,7,2010,The West Cornwall Pasty Company,Eating Out,8,2039
15,7,2010,ATM Cash Withdrawal,General,20,2019
15,7,2010,Paying back James,,9,2010
16,7,2010,LBS Council Tax,Bills,20,1990
16,7,2010,Morrisons,Groceries,53,1937
16,7,2010,Starbucks Coffee,Eating Out,2,1935
16,7,2010,The West Cornwall Pasty Company,Eating Out,7,1928
16,7,2010,Restaurant Gordon RamsayPortland Restaurant,Eating Out,26,1902
18,7,2010,Pizza Express,Eating Out,53,1849
19,7,2010,South West Trains,Transport,25,1824
19,7,2010,Costa Coffee,Eating Out,1,1823
19,7,2010,Subway,Eating Out,4,1819
20,7,2010,VIRGIN MEDIA PYMTS,Bills,16,1803
21,7,2010,Costa Coffee,Eating Out,2,1801
21,7,2010,Greggs,Eating Out,4,1797
21,7,2010,ATM Cash Withdrawal,General,10,1787
22,7,2010,Costa Coffee,Eating Out,1,1786
22,7,2010,Greggs,Eating Out,6,1780
23,7,2010,Morrisons,Groceries,46,1734
23,7,2010,Fabric Club,Eating Out,12,1722
23,7,2010,Cheam Service Station,,6,1716
24,7,2010,O2,Bills,20,1696
24,7,2010,ATM Cash Withdrawal,General,10,1686
26,7,2010,South West Trains,Transport,23,1663
26,7,2010,Starbucks Coffee,Eating Out,1,1662
26,7,2010,Subway,Eating Out,7,1655
27,7,2010,Costa Coffee,Eating Out,2,1653
27,7,2010,Subway,Eating Out,8,1645
27,7,2010,ATM Cash Withdrawal,General,10,1635
28,7,2010,Caffe Nero,Eating Out,2,1633
28,7,2010,ATM Cash Withdrawal,General,10,1623
29,7,2010,Chicken Cottage,Eating Out,5,1618
29,7,2010,Tool Tec,,1,1617
30,7,2010,Morrisons,Groceries,73,1544
30,7,2010,Caffe Nero,Eating Out,2,1542
30,7,2010,The West Cornwall Pasty Company,Eating Out,5,1537
30,7,2010,ATM Cash Withdrawal,General,10,1527
31,7,2010,Tool Tec,,7,1520
1,8,2010,Rhino Sports salary,General,1600,3120
2,8,2010,South West Trains,Transport,17,3103
2,8,2010,Pret A Manger,Eating Out,8,3095
3,8,2010,Starbucks Coffee,Eating Out,2,3093
3,8,2010,Pret A Manger,Eating Out,6,3087
3,8,2010,ATM Cash Withdrawal,General,10,3077
4,8,2010,Chicken Cottage,Eating Out,6,3071
4,8,2010,ATM Cash Withdrawal,General,20,3051
5,8,2010,Caffe Nero,Eating Out,2,3049
5,8,2010,McDonalds,Eating Out,6,3043
6,8,2010,Tescos,Groceries,38,3005
6,8,2010,Wild Bean Cafe,Eating Out,2,3003
6,8,2010,The West Cornwall Pasty Company,Eating Out,6,2997
7,8,2010,Cubit and West rent,Rent,400,2597
7,8,2010,ATM Cash Withdrawal,General,10,2587
8,8,2010,ATM Cash Withdrawal,General,20,2567
9,8,2010,South West Trains,Transport,19,2548
9,8,2010,Wild Bean Cafe,Eating Out,1,2547
9,8,2010,McDonalds,Eating Out,6,2541
10,8,2010,Wild Bean Cafe,Eating Out,2,2539
11,8,2010,Costa Coffee,Eating Out,1,2538
11,8,2010,Greggs,Eating Out,8,2530
12,8,2010,Costa Coffee,Eating Out,2,2528
13,8,2010,Waitrose,Groceries,43,2485
13,8,2010,Costa Coffee,Eating Out,2,2483
13,8,2010,McDonalds,Eating Out,7,2476
14,8,2010,The Grand Pub,Eating Out,6,2470
14,8,2010,The Grand Pub,Eating Out,11,2459
14,8,2010,Scott's Restaurant,Eating Out,50,2409
15,8,2010,BRGAS-Electricity,Bills,21,2388
15,8,2010,BRGAS-Gas,Bills,19,2369
15,8,2010,ATM Cash Withdrawal,General,10,2359
16,8,2010,LBS Council Tax,Bills,20,2339
16,8,2010,South West Trains,Transport,23,2316
16,8,2010,Caffe Nero,Eating Out,2,2314
16,8,2010,McDonalds,Eating Out,8,2306
17,8,2010,Caffe Nero,Eating Out,2,2304
17,8,2010,The West Cornwall Pasty Company,Eating Out,5,2299
17,8,2010,ATM Cash Withdrawal,General,10,2289
18,8,2010,Costa Coffee,Eating Out,1,2288
18,8,2010,Greggs,Eating Out,5,2283
19,8,2010,Caffe Nero,Eating Out,1,2282
20,8,2010,VIRGIN MEDIA PYMTS,Bills,16,2266
20,8,2010,Sainsburys,Groceries,62,2204
20,8,2010,Costa Coffee,Eating Out,1,2203
20,8,2010,Greggs,Eating Out,4,2199
20,8,2010,ATM Cash Withdrawal,General,20,2179
21,8,2010,Fabric Club,Eating Out,10,2169
21,8,2010,Restaurant Gordon RamsayPortland Restaurant,Eating Out,38,2131
21,8,2010,Cheam Service Station,,4,2127
22,8,2010,Scott's Restaurant,Eating Out,40,2087
23,8,2010,South West Trains,Transport,24,2063
23,8,2010,Starbucks Coffee,Eating Out,2,2061
23,8,2010,The West Cornwall Pasty Company,Eating Out,5,2056
23,8,2010,ATM Cash Withdrawal,General,20,2036
24,8,2010,O2,Bills,25,2011
24,8,2010,Costa Coffee,Eating Out,1,2010
24,8,2010,Subway,Eating Out,5,2005
25,8,2010,Costa Coffee,Eating Out,2,2003
25,8,2010,Subway,Eating Out,4,1999
26,8,2010,Chicken Cottage,Eating Out,4,1995
27,8,2010,ASDA,Groceries,37,1958
27,8,2010,Caffe Nero,Eating Out,1,1957
27,8,2010,Greggs,Eating Out,6,1951
27,8,2010,ATM Cash Withdrawal,General,20,1931
28,8,2010,ATM Cash Withdrawal,General,20,1911
29,8,2010,Pizza Express,Eating Out,43,1868
29,8,2010,Tool Shop,,7,1861
30,8,2010,South West Trains,Transport,17,1844
31,8,2010,Wild Bean Cafe,Eating Out,1,1843
1,9,2010,Rhino Sports salary,General,1600,3443
1,9,2010,Caffe Nero,Eating Out,2,3441
1,9,2010,Pret A Manger,Eating Out,7,3434
1,9,2010,ATM Cash Withdrawal,General,20,3414
1,9,2010,Civic Shop,,3,3411
2,9,2010,Starbucks Coffee,Eating Out,2,3409
2,9,2010,ATM Cash Withdrawal,General,10,3399
3,9,2010,Waitrose,Groceries,40,3359
3,9,2010,Greggs,Eating Out,8,3351
3,9,2010,Pizza Express,Eating Out,36,3315
4,9,2010,ATM Cash Withdrawal,General,10,3305
4,9,2010,Cheam Service Station,,2,3303
6,9,2010,South West Trains,Transport,19,3284
6,9,2010,Greggs,Eating Out,7,3277
7,9,2010,Cubit and West rent,Rent,400,2877
7,9,2010,Costa Coffee,Eating Out,1,2876
7,9,2010,Chicken Cottage,Eating Out,8,2868
8,9,2010,Costa Coffee,Eating Out,1,2867
9,9,2010,Caffe Nero,Eating Out,1,2866
10,9,2010,Sainsburys,Groceries,45,2821
10,9,2010,Wild Bean Cafe,Eating Out,1,2820
10,9,2010,Subway,Eating Out,8,2812
10,9,2010,Pizza Express,Eating Out,31,2781
10,9,2010,Tool Shop,,8,2773
12,9,2010,Pizza Express,Eating Out,39,2734
13,9,2010,South West Trains,Transport,17,2717
13,9,2010,Starbucks Coffee,Eating Out,2,2715
13,9,2010,ATM Cash Withdrawal,General,10,2705
14,9,2010,Costa Coffee,Eating Out,2,2703
14,9,2010,Subway,Eating Out,6,2697
15,9,2010,BRGAS-Electricity,Bills,23,2674
15,9,2010,BRGAS-Gas,Bills,18,2656
15,9,2010,Costa Coffee,Eating Out,1,2655
16,9,2010,LBS Council Tax,Bills,20,2635
16,9,2010,Caffe Nero,Eating Out,2,2633
16,9,2010,ATM Cash Withdrawal,General,20,2613
17,9,2010,Waitrose,Groceries,58,2555
17,9,2010,Pret A Manger,Eating Out,5,2550
17,9,2010,Anglo restaurant,Eating Out,51,2499
17,9,2010,ATM Cash Withdrawal,General,20,2479
17,9,2010,Paying back James,,5,2474
18,9,2010,ATM Cash Withdrawal,General,10,2464
20,9,2010,VIRGIN MEDIA PYMTS,Bills,29,2435
20,9,2010,South West Trains,Transport,23,2412
20,9,2010,Subway,Eating Out,4,2408
21,9,2010,Costa Coffee,Eating Out,2,2406
21,9,2010,Subway,Eating Out,8,2398
21,9,2010,ATM Cash Withdrawal,General,20,2378
22,9,2010,Wild Bean Cafe,Eating Out,1,2377
22,9,2010,Pret A Manger,Eating Out,8,2369
22,9,2010,ATM Cash Withdrawal,General,10,2359
24,9,2010,O2,Bills,24,2335
24,9,2010,Tescos,Groceries,50,2285
24,9,2010,Caffe Nero,Eating Out,2,2283
24,9,2010,Fabric Club,Eating Out,10,2273
24,9,2010,ATM Cash Withdrawal,General,20,2253
27,9,2010,South West Trains,Transport,25,2228
27,9,2010,Greggs,Eating Out,4,2224
27,9,2010,Paying back James,,6,2218
28,9,2010,Starbucks Coffee,Eating Out,1,2217
28,9,2010,ATM Cash Withdrawal,General,20,2197
28,9,2010,Cheam Service Station,,2,2195
29,9,2010,Wild Bean Cafe,Eating Out,2,2193
30,9,2010,Caffe Nero,Eating Out,2,2191
30,9,2010,Greggs,Eating Out,7,2184
1,10,2010,Rhino Sports salary,General,1600,3784
1,10,2010,Tescos,Groceries,41,3743
1,10,2010,Starbucks Coffee,Eating Out,2,3741
1,10,2010,Greggs,Eating Out,8,3733
1,10,2010,Dominos Pizza,Eating Out,47,3686
1,10,2010,ATM Cash Withdrawal,General,10,3676
2,10,2010,Restaurant Gordon RamsayPortland Restaurant,Eating Out,24,3652
4,10,2010,South West Trains,Transport,21,3631
4,10,2010,Caffe Nero,Eating Out,1,3630
4,10,2010,Chicken Cottage,Eating Out,7,3623
5,10,2010,Wild Bean Cafe,Eating Out,2,3621
5,10,2010,McDonalds,Eating Out,7,3614
5,10,2010,Tool Tec,,1,3613
7,10,2010,Cubit and West rent,Rent,400,3213
7,10,2010,Chicken Cottage,Eating Out,7,3206
8,10,2010,Waitrose,Groceries,36,3170
8,10,2010,Starbucks Coffee,Eating Out,2,3168
8,10,2010,Subway,Eating Out,7,3161
8,10,2010,ATM Cash Withdrawal,General,20,3141
9,10,2010,Cheam Service Station,,9,3132
10,10,2010,Pizza Express,Eating Out,36,3096
11,10,2010,South West Trains,Transport,17,3079
11,10,2010,Chicken Cottage,Eating Out,7,3072
12,10,2010,Costa Coffee,Eating Out,2,3070
12,10,2010,Greggs,Eating Out,8,3062
13,10,2010,Costa Coffee,Eating Out,1,3061
13,10,2010,The West Cornwall Pasty Company,Eating Out,8,3053
13,10,2010,Paying back James,,1,3052
14,10,2010,Costa Coffee,Eating Out,1,3051
14,10,2010,The West Cornwall Pasty Company,Eating Out,4,3047
14,10,2010,ATM Cash Withdrawal,General,10,3037
15,10,2010,BRGAS-Electricity,Bills,28,3009
15,10,2010,BRGAS-Gas,Bills,20,2989
15,10,2010,Morrisons,Groceries,43,2946
15,10,2010,Caffe Nero,Eating Out,1,2945
15,10,2010,Heaven Club,Eating Out,14,2931
15,10,2010,Heaven Club,Eating Out,8,2923
15,10,2010,Anglo restaurant,Eating Out,49,2874
15,10,2010,ATM Cash Withdrawal,General,20,2854
16,10,2010,LBS Council Tax,Bills,20,2834
18,10,2010,South West Trains,Transport,21,2813
18,10,2010,Caffe Nero,Eating Out,2,2811
18,10,2010,ATM Cash Withdrawal,General,20,2791
19,10,2010,Chicken Cottage,Eating Out,7,2784
20,10,2010,VIRGIN MEDIA PYMTS,Bills,14,2770
20,10,2010,Costa Coffee,Eating Out,1,2769
20,10,2010,Chicken Cottage,Eating Out,4,2765
20,10,2010,Civic Shop,,8,2757
21,10,2010,Costa Coffee,Eating Out,1,2756
22,10,2010,Tescos,Groceries,42,2714
22,10,2010,Costa Coffee,Eating Out,2,2712
22,10,2010,The West Cornwall Pasty Company,Eating Out,6,2706
22,10,2010,ATM Cash Withdrawal,General,10,2696
24,10,2010,O2,Bills,22,2674
24,10,2010,Dominos Pizza,Eating Out,29,2645
25,10,2010,South West Trains,Transport,22,2623
25,10,2010,Starbucks Coffee,Eating Out,2,2621
25,10,2010,Greggs,Eating Out,5,2616
26,10,2010,Costa Coffee,Eating Out,1,2615
27,10,2010,Wild Bean Cafe,Eating Out,2,2613
28,10,2010,The West Cornwall Pasty Company,Eating Out,8,2605
29,10,2010,Tescos,Groceries,50,2555
29,10,2010,Caffe Nero,Eating Out,1,2554
29,10,2010,Greggs,Eating Out,8,2546
29,10,2010,Restaurant Gordon RamsayPortland Restaurant,Eating Out,40,2506
31,10,2010,ATM Cash Withdrawal,General,10,2496
1,11,2010,Rhino Sports salary,General,1600,4096
1,11,2010,South West Trains,Transport,24,4072
1,11,2010,Wild Bean Cafe,Eating Out,2,4070
1,11,2010,Civic Shop,,7,4063
2,11,2010,Caffe Nero,Eating Out,1,4062
2,11,2010,Subway,Eating Out,5,4057
3,11,2010,Costa Coffee,Eating Out,2,4055
3,11,2010,ATM Cash Withdrawal,General,10,4045
4,11,2010,Starbucks Coffee,Eating Out,2,4043
4,11,2010,Subway,Eating Out,6,4037
5,11,2010,Tescos,Groceries,53,3984
7,11,2010,Cubit and West rent,Rent,400,3584
7,11,2010,Restaurant Gordon RamsayPortland Restaurant,Eating Out,29,3555
7,11,2010,ATM Cash Withdrawal,General,10,3545
7,11,2010,Cheam Service Station,,2,3543
8,11,2010,South West Trains,Transport,20,3523
8,11,2010,Starbucks Coffee,Eating Out,2,3521
8,11,2010,McDonalds,Eating Out,7,3514
9,11,2010,Costa Coffee,Eating Out,2,3512
10,11,2010,Costa Coffee,Eating Out,2,3510
10,11,2010,Subway,Eating Out,7,3503
11,11,2010,Starbucks Coffee,Eating Out,2,3501
12,11,2010,Morrisons,Groceries,44,3457
12,11,2010,Wild Bean Cafe,Eating Out,2,3455
14,11,2010,Pizza Express,Eating Out,53,3402
15,11,2010,BRGAS-Electricity,Bills,23,3379
15,11,2010,BRGAS-Gas,Bills,38,3341
15,11,2010,South West Trains,Transport,16,3325
15,11,2010,Costa Coffee,Eating Out,1,3324
15,11,2010,The West Cornwall Pasty Company,Eating Out,5,3319
16,11,2010,LBS Council Tax,Bills,20,3299
16,11,2010,Wild Bean Cafe,Eating Out,1,3298
16,11,2010,Pret A Manger,Eating Out,6,3292
16,11,2010,ATM Cash Withdrawal,General,20,3272
17,11,2010,Costa Coffee,Eating Out,1,3271
17,11,2010,Chicken Cottage,Eating Out,8,3263
17,11,2010,Tool Shop,,2,3261
18,11,2010,Starbucks Coffee,Eating Out,2,3259
19,11,2010,Waitrose,Groceries,51,3208
19,11,2010,Caffe Nero,Eating Out,2,3206
19,11,2010,Subway,Eating Out,8,3198
19,11,2010,Fabric Club,Eating Out,16,3182
19,11,2010,Fabric Club,Eating Out,12,3170
19,11,2010,Fabric Club,Eating Out,13,3157
19,11,2010,Fabric Club,Eating Out,6,3151
19,11,2010,Fabric Club,Eating Out,11,3140
19,11,2010,Fabric Club,Eating Out,7,3133
20,11,2010,VIRGIN MEDIA PYMTS,Bills,29,3104
20,11,2010,Ministry of Sound ClubXOYO Club,Eating Out,7,3097
20,11,2010,Ministry of Sound ClubXOYO Club,Eating Out,7,3090
20,11,2010,Ministry of Sound ClubXOYO Club,Eating Out,12,3078
20,11,2010,Ministry of Sound ClubXOYO Club,Eating Out,10,3068
20,11,2010,Ministry of Sound ClubXOYO Club,Eating Out,16,3052
20,11,2010,Scott's Restaurant,Eating Out,34,3018
20,11,2010,ATM Cash Withdrawal,General,20,2998
22,11,2010,South West Trains,Transport,24,2974
22,11,2010,ATM Cash Withdrawal,General,20,2954
24,11,2010,O2,Bills,24,2930
24,11,2010,Costa Coffee,Eating Out,1,2929
24,11,2010,McDonalds,Eating Out,5,2924
24,11,2010,ATM Cash Withdrawal,General,20,2904
25,11,2010,Starbucks Coffee,Eating Out,2,2902
25,11,2010,Chicken Cottage,Eating Out,7,2895
26,11,2010,Sainsburys,Groceries,61,2834
26,11,2010,Wild Bean Cafe,Eating Out,2,2832
27,11,2010,ATM Cash Withdrawal,General,20,2812
28,11,2010,ATM Cash Withdrawal,General,10,2802
29,11,2010,South West Trains,Transport,21,2781
29,11,2010,Costa Coffee,Eating Out,1,2780
29,11,2010,Chicken Cottage,Eating Out,4,2776
29,11,2010,ATM Cash Withdrawal,General,10,2766
30,11,2010,Starbucks Coffee,Eating Out,2,2764
30,11,2010,Pret A Manger,Eating Out,4,2760
1,12,2010,Rhino Sports salary,General,1600,4360
1,12,2010,Costa Coffee,Eating Out,2,4358
1,12,2010,The West Cornwall Pasty Company,Eating Out,8,4350
1,12,2010,ATM Cash Withdrawal,General,10,4340
2,12,2010,Starbucks Coffee,Eating Out,1,4339
3,12,2010,Morrisons,Groceries,47,4292
3,12,2010,Caffe Nero,Eating Out,2,4290
3,12,2010,McDonalds,Eating Out,7,4283
6,12,2010,South West Trains,Transport,17,4266
6,12,2010,Costa Coffee,Eating Out,2,4264
6,12,2010,Paying back Julie,,8,4256
7,12,2010,Cubit and West rent,Rent,400,3856
7,12,2010,Starbucks Coffee,Eating Out,2,3854
7,12,2010,ATM Cash Withdrawal,General,20,3834
8,12,2010,Costa Coffee,Eating Out,2,3832
9,12,2010,Starbucks Coffee,Eating Out,1,3831
9,12,2010,McDonalds,Eating Out,5,3826
9,12,2010,ATM Cash Withdrawal,General,10,3816
10,12,2010,Morrisons,Groceries,47,3769
10,12,2010,Wild Bean Cafe,Eating Out,1,3768
10,12,2010,Subway,Eating Out,7,3761
10,12,2010,Anglo restaurant,Eating Out,53,3708
12,12,2010,Tool Tec,,5,3703
13,12,2010,South West Trains,Transport,17,3686
13,12,2010,Starbucks Coffee,Eating Out,2,3684
13,12,2010,Greggs,Eating Out,5,3679
14,12,2010,Starbucks Coffee,Eating Out,2,3677
14,12,2010,Chicken Cottage,Eating Out,6,3671
15,12,2010,BRGAS-Electricity,Bills,24,3647
15,12,2010,BRGAS-Gas,Bills,28,3619
15,12,2010,Starbucks Coffee,Eating Out,1,3618
16,12,2010,LBS Council Tax,Bills,20,3598
16,12,2010,Starbucks Coffee,Eating Out,2,3596
16,12,2010,The West Cornwall Pasty Company,Eating Out,6,3590
17,12,2010,Tescos,Groceries,41,3549
17,12,2010,Costa Coffee,Eating Out,1,3548
17,12,2010,Scott's Restaurant,Eating Out,36,3512
18,12,2010,The Grand Pub,Eating Out,6,3506
18,12,2010,ATM Cash Withdrawal,General,20,3486
20,12,2010,VIRGIN MEDIA PYMTS,Bills,23,3463
20,12,2010,South West Trains,Transport,23,3440
20,12,2010,Costa Coffee,Eating Out,2,3438
20,12,2010,McDonalds,Eating Out,7,3431
20,12,2010,ATM Cash Withdrawal,General,10,3421
21,12,2010,Pret A Manger,Eating Out,6,3415
22,12,2010,Wild Bean Cafe,Eating Out,1,3414
22,12,2010,Greggs,Eating Out,4,3410
22,12,2010,ATM Cash Withdrawal,General,10,3400
23,12,2010,Caffe Nero,Eating Out,2,3398
23,12,2010,ATM Cash Withdrawal,General,20,3378
24,12,2010,O2,Bills,22,3356
24,12,2010,Sainsburys,Groceries,38,3318
24,12,2010,Starbucks Coffee,Eating Out,1,3317
24,12,2010,Greggs,Eating Out,8,3309
26,12,2010,Restaurant Gordon RamsayPortland Restaurant,Eating Out,36,3273
27,12,2010,South West Trains,Transport,20,3253
27,12,2010,Caffe Nero,Eating Out,1,3252
27,12,2010,Chicken Cottage,Eating Out,8,3244
28,12,2010,Greggs,Eating Out,6,3238
28,12,2010,Paying back Julie,,4,3234
29,12,2010,Starbucks Coffee,Eating Out,1,3233
29,12,2010,Greggs,Eating Out,8,3225
30,12,2010,Starbucks Coffee,Eating Out,2,3223
30,12,2010,Pret A Manger,Eating Out,6,3217
31,12,2010,Sainsburys,Groceries,73,3144
31,12,2010,Starbucks Coffee,Eating Out,2,3142
31,12,2010,Greggs,Eating Out,8,3134
31,12,2010,ATM Cash Withdrawal,General,20,3114
1,1,2011,Rhino Sports salary,General,1600,4714
2,1,2011,ATM Cash Withdrawal,General,10,4704
3,1,2011,South West Trains,Transport,19,4685
3,1,2011,Costa Coffee,Eating Out,2,4683
3,1,2011,McDonalds,Eating Out,6,4677
4,1,2011,Wild Bean Cafe,Eating Out,2,4675
4,1,2011,ATM Cash Withdrawal,General,10,4665
4,1,2011,Red Shop,,3,4662
5,1,2011,Starbucks Coffee,Eating Out,2,4660
6,1,2011,Starbucks Coffee,Eating Out,1,4659
6,1,2011,Greggs,Eating Out,4,4655
7,1,2011,Cubit and West rent,Rent,400,4255
7,1,2011,ASDA,Groceries,47,4208
7,1,2011,Costa Coffee,Eating Out,2,4206
7,1,2011,Pret A Manger,Eating Out,5,4201
8,1,2011,Tool Shop,,3,4198
9,1,2011,Scott's Restaurant,Eating Out,54,4144
9,1,2011,Civic Shop,,3,4141
10,1,2011,South West Trains,Transport,19,4122
10,1,2011,Wild Bean Cafe,Eating Out,1,4121
11,1,2011,The West Cornwall Pasty Company,Eating Out,4,4117
11,1,2011,Civic Shop,,3,4114
13,1,2011,McDonalds,Eating Out,4,4110
14,1,2011,Morrisons,Groceries,64,4046
14,1,2011,Costa Coffee,Eating Out,2,4044
14,1,2011,Paying back Julie,,6,4038
15,1,2011,BRGAS-Electricity,Bills,32,4006
15,1,2011,BRGAS-Gas,Bills,48,3958
15,1,2011,Scott's Restaurant,Eating Out,58,3900
16,1,2011,LBS Council Tax,Bills,20,3880
17,1,2011,South West Trains,Transport,20,3860
17,1,2011,Starbucks Coffee,Eating Out,2,3858
17,1,2011,McDonalds,Eating Out,8,3850
18,1,2011,Costa Coffee,Eating Out,2,3848
18,1,2011,ATM Cash Withdrawal,General,10,3838
19,1,2011,Starbucks Coffee,Eating Out,2,3836
19,1,2011,Greggs,Eating Out,4,3832
20,1,2011,VIRGIN MEDIA PYMTS,Bills,16,3816
20,1,2011,Costa Coffee,Eating Out,2,3814
20,1,2011,Subway,Eating Out,6,3808
20,1,2011,ATM Cash Withdrawal,General,10,3798
21,1,2011,Morrisons,Groceries,41,3757
21,1,2011,Caffe Nero,Eating Out,1,3756
21,1,2011,ATM Cash Withdrawal,General,20,3736
21,1,2011,Civic Shop,,2,3734
24,1,2011,O2,Bills,23,3711
24,1,2011,South West Trains,Transport,16,3695
24,1,2011,Costa Coffee,Eating Out,2,3693
25,1,2011,Costa Coffee,Eating Out,2,3691
25,1,2011,ATM Cash Withdrawal,General,10,3681
25,1,2011,Paying back Julie,,6,3675
26,1,2011,Costa Coffee,Eating Out,2,3673
26,1,2011,Subway,Eating Out,8,3665
27,1,2011,Wild Bean Cafe,Eating Out,1,3664
27,1,2011,Greggs,Eating Out,5,3659
28,1,2011,Tescos,Groceries,57,3602
28,1,2011,Greggs,Eating Out,5,3597
28,1,2011,Scott's Restaurant,Eating Out,52,3545
29,1,2011,ATM Cash Withdrawal,General,20,3525
30,1,2011,ATM Cash Withdrawal,General,20,3505
31,1,2011,South West Trains,Transport,18,3487
31,1,2011,Subway,Eating Out,6,3481
31,1,2011,Paying back James,,4,3477
1,2,2011,Rhino Sports salary,General,1600,5077
1,2,2011,Caffe Nero,Eating Out,1,5076
1,2,2011,Subway,Eating Out,6,5070
1,2,2011,ATM Cash Withdrawal,General,20,5050
2,2,2011,Wild Bean Cafe,Eating Out,2,5048
4,2,2011,Morrisons,Groceries,54,4994
4,2,2011,Subway,Eating Out,7,4987
4,2,2011,ATM Cash Withdrawal,General,20,4967
5,2,2011,Dominos Pizza,Eating Out,43,4924
5,2,2011,Red Shop,,3,4921
7,2,2011,Cubit and West rent,Rent,400,4521
7,2,2011,South West Trains,Transport,16,4505
7,2,2011,Pret A Manger,Eating Out,6,4499
7,2,2011,ATM Cash Withdrawal,General,20,4479
8,2,2011,Starbucks Coffee,Eating Out,2,4477
8,2,2011,The West Cornwall Pasty Company,Eating Out,6,4471
9,2,2011,Costa Coffee,Eating Out,1,4470
9,2,2011,Greggs,Eating Out,8,4462
10,2,2011,Costa Coffee,Eating Out,1,4461
11,2,2011,Sainsburys,Groceries,53,4408
11,2,2011,Costa Coffee,Eating Out,2,4406
12,2,2011,Pizza Express,Eating Out,53,4353
13,2,2011,Scott's Restaurant,Eating Out,29,4324
13,2,2011,ATM Cash Withdrawal,General,10,4314
14,2,2011,South West Trains,Transport,18,4296
14,2,2011,Costa Coffee,Eating Out,2,4294
15,2,2011,BRGAS-Electricity,Bills,27,4267
15,2,2011,BRGAS-Gas,Bills,14,4253
15,2,2011,Starbucks Coffee,Eating Out,2,4251
15,2,2011,Greggs,Eating Out,7,4244
16,2,2011,LBS Council Tax,Bills,20,4224
16,2,2011,Wild Bean Cafe,Eating Out,1,4223
16,2,2011,Pret A Manger,Eating Out,4,4219
16,2,2011,Civic Shop,,2,4217
17,2,2011,Greggs,Eating Out,4,4213
18,2,2011,Sainsburys,Groceries,56,4157
18,2,2011,Costa Coffee,Eating Out,1,4156
19,2,2011,Ministry of Sound ClubXOYO Club,Eating Out,10,4146
19,2,2011,Ministry of Sound ClubXOYO Club,Eating Out,11,4135
19,2,2011,Ministry of Sound ClubXOYO Club,Eating Out,16,4119
19,2,2011,Ministry of Sound ClubXOYO Club,Eating Out,9,4110
19,2,2011,Ministry of Sound ClubXOYO Club,Eating Out,6,4104
19,2,2011,Ministry of Sound ClubXOYO Club,Eating Out,5,4099
19,2,2011,Scott's Restaurant,Eating Out,29,4070
20,2,2011,VIRGIN MEDIA PYMTS,Bills,18,4052
20,2,2011,Dominos Pizza,Eating Out,56,3996
20,2,2011,ATM Cash Withdrawal,General,10,3986
21,2,2011,South West Trains,Transport,20,3966
21,2,2011,Wild Bean Cafe,Eating Out,1,3965
21,2,2011,Chicken Cottage,Eating Out,5,3960
23,2,2011,Starbucks Coffee,Eating Out,2,3958
24,2,2011,O2,Bills,23,3935
24,2,2011,Wild Bean Cafe,Eating Out,2,3933
24,2,2011,Pret A Manger,Eating Out,5,3928
24,2,2011,Civic Shop,,5,3923
25,2,2011,Tescos,Groceries,57,3866
25,2,2011,Costa Coffee,Eating Out,1,3865
25,2,2011,Greggs,Eating Out,5,3860
25,2,2011,ATM Cash Withdrawal,General,10,3850
26,2,2011,Dominos Pizza,Eating Out,42,3808
27,2,2011,Dominos Pizza,Eating Out,48,3760
27,2,2011,ATM Cash Withdrawal,General,10,3750
28,2,2011,South West Trains,Transport,18,3732
28,2,2011,Subway,Eating Out,8,3724
28,2,2011,ATM Cash Withdrawal,General,20,3704
1,3,2011,Rhino Sports salary,General,1600,5304
1,3,2011,Starbucks Coffee,Eating Out,1,5303
1,3,2011,Subway,Eating Out,4,5299
2,3,2011,Caffe Nero,Eating Out,1,5298
3,3,2011,Caffe Nero,Eating Out,2,5296
3,3,2011,McDonalds,Eating Out,7,5289
4,3,2011,Sainsburys,Groceries,60,5229
4,3,2011,Starbucks Coffee,Eating Out,2,5227
4,3,2011,The West Cornwall Pasty Company,Eating Out,8,5219
5,3,2011,ATM Cash Withdrawal,General,10,5209
6,3,2011,ATM Cash Withdrawal,General,20,5189
6,3,2011,Tool Tec,,3,5186
7,3,2011,Cubit and West rent,Rent,400,4786
7,3,2011,South West Trains,Transport,20,4766
7,3,2011,Costa Coffee,Eating Out,2,4764
7,3,2011,Greggs,Eating Out,7,4757
8,3,2011,Starbucks Coffee,Eating Out,2,4755
9,3,2011,Greggs,Eating Out,7,4748
10,3,2011,Caffe Nero,Eating Out,2,4746
10,3,2011,ATM Cash Withdrawal,General,20,4726
10,3,2011,Civic Shop,,6,4720
11,3,2011,Waitrose,Groceries,64,4656
11,3,2011,Scott's Restaurant,Eating Out,36,4620
11,3,2011,Cheam Service Station,,7,4613
14,3,2011,South West Trains,Transport,20,4593
14,3,2011,Costa Coffee,Eating Out,2,4591
14,3,2011,ATM Cash Withdrawal,General,10,4581
14,3,2011,Paying back James,,9,4572
15,3,2011,BRGAS-Electricity,Bills,29,4543
15,3,2011,BRGAS-Gas,Bills,21,4522
16,3,2011,LBS Council Tax,Bills,20,4502
16,3,2011,Caffe Nero,Eating Out,2,4500
17,3,2011,Caffe Nero,Eating Out,1,4499
17,3,2011,Subway,Eating Out,8,4491
18,3,2011,ASDA,Groceries,45,4446
18,3,2011,Starbucks Coffee,Eating Out,1,4445
18,3,2011,Greggs,Eating Out,7,4438
20,3,2011,VIRGIN MEDIA PYMTS,Bills,26,4412
20,3,2011,Scott's Restaurant,Eating Out,52,4360
21,3,2011,South West Trains,Transport,20,4340
21,3,2011,Costa Coffee,Eating Out,2,4338
22,3,2011,Caffe Nero,Eating Out,2,4336
22,3,2011,Subway,Eating Out,5,4331
23,3,2011,Greggs,Eating Out,7,4324
24,3,2011,O2,Bills,24,4300
24,3,2011,Costa Coffee,Eating Out,2,4298
24,3,2011,Greggs,Eating Out,8,4290
24,3,2011,Tool Shop,,5,4285
25,3,2011,Tescos,Groceries,51,4234
25,3,2011,Costa Coffee,Eating Out,2,4232
25,3,2011,Chicken Cottage,Eating Out,7,4225
26,3,2011,Dominos Pizza,Eating Out,39,4186
28,3,2011,South West Trains,Transport,21,4165
28,3,2011,Wild Bean Cafe,Eating Out,2,4163
28,3,2011,Paying back James,,3,4160
29,3,2011,Starbucks Coffee,Eating Out,2,4158
29,3,2011,McDonalds,Eating Out,5,4153
29,3,2011,ATM Cash Withdrawal,General,20,4133
30,3,2011,Caffe Nero,Eating Out,2,4131
30,3,2011,Chicken Cottage,Eating Out,8,4123
30,3,2011,ATM Cash Withdrawal,General,20,4103
31,3,2011,Costa Coffee,Eating Out,1,4102
31,3,2011,McDonalds,Eating Out,5,4097
1,4,2011,Rhino Sports salary,General,1600,5697
1,4,2011,ASDA,Groceries,60,5637
1,4,2011,Starbucks Coffee,Eating Out,2,5635
1,4,2011,Pret A Manger,Eating Out,5,5630
1,4,2011,Pizza Express,Eating Out,31,5599
2,4,2011,ATM Cash Withdrawal,General,10,5589
4,4,2011,South West Trains,Transport,19,5570
4,4,2011,Greggs,Eating Out,7,5563
5,4,2011,Caffe Nero,Eating Out,2,5561
5,4,2011,Chicken Cottage,Eating Out,8,5553
6,4,2011,Wild Bean Cafe,Eating Out,1,5552
7,4,2011,Cubit and West rent,Rent,400,5152
7,4,2011,Starbucks Coffee,Eating Out,2,5150
7,4,2011,Greggs,Eating Out,6,5144
7,4,2011,ATM Cash Withdrawal,General,20,5124
7,4,2011,Paying back Julie,,4,5120
8,4,2011,Morrisons,Groceries,66,5054
8,4,2011,Caffe Nero,Eating Out,1,5053
8,4,2011,Ministry of Sound ClubXOYO Club,Eating Out,12,5041
8,4,2011,Ministry of Sound ClubXOYO Club,Eating Out,9,5032
8,4,2011,Restaurant Gordon RamsayPortland Restaurant,Eating Out,44,4988
10,4,2011,Scott's Restaurant,Eating Out,37,4951
10,4,2011,ATM Cash Withdrawal,General,10,4941
11,4,2011,South West Trains,Transport,17,4924
11,4,2011,Wild Bean Cafe,Eating Out,2,4922
11,4,2011,Chicken Cottage,Eating Out,5,4917
12,4,2011,Costa Coffee,Eating Out,1,4916
12,4,2011,Greggs,Eating Out,4,4912
12,4,2011,ATM Cash Withdrawal,General,10,4902
13,4,2011,Wild Bean Cafe,Eating Out,2,4900
13,4,2011,Subway,Eating Out,7,4893
15,4,2011,BRGAS-Electricity,Bills,28,4865
15,4,2011,BRGAS-Gas,Bills,19,4846
15,4,2011,ASDA,Groceries,45,4801
15,4,2011,Costa Coffee,Eating Out,2,4799
15,4,2011,McDonalds,Eating Out,8,4791
15,4,2011,Pizza Express,Eating Out,28,4763
16,4,2011,LBS Council Tax,Bills,20,4743
17,4,2011,Scott's Restaurant,Eating Out,47,4696
18,4,2011,South West Trains,Transport,25,4671
18,4,2011,Starbucks Coffee,Eating Out,2,4669
19,4,2011,Caffe Nero,Eating Out,1,4668
19,4,2011,The West Cornwall Pasty Company,Eating Out,4,4664
20,4,2011,VIRGIN MEDIA PYMTS,Bills,29,4635
20,4,2011,Costa Coffee,Eating Out,2,4633
20,4,2011,Chicken Cottage,Eating Out,8,4625
21,4,2011,Caffe Nero,Eating Out,2,4623
21,4,2011,ATM Cash Withdrawal,General,10,4613
22,4,2011,ASDA,Groceries,47,4566
22,4,2011,Starbucks Coffee,Eating Out,2,4564
22,4,2011,Subway,Eating Out,4,4560
22,4,2011,Tool Tec,,3,4557
23,4,2011,Heaven Club,Eating Out,10,4547
23,4,2011,Heaven Club,Eating Out,7,4540
23,4,2011,Heaven Club,Eating Out,16,4524
23,4,2011,Heaven Club,Eating Out,16,4508
23,4,2011,Heaven Club,Eating Out,11,4497
23,4,2011,Heaven Club,Eating Out,5,4492
23,4,2011,Restaurant Gordon RamsayPortland Restaurant,Eating Out,58,4434
24,4,2011,O2,Bills,25,4409
24,4,2011,Red Shop,,1,4408
25,4,2011,South West Trains,Transport,17,4391
25,4,2011,Costa Coffee,Eating Out,2,4389
26,4,2011,Caffe Nero,Eating Out,2,4387
27,4,2011,Caffe Nero,Eating Out,2,4385
28,4,2011,Caffe Nero,Eating Out,2,4383
28,4,2011,Pret A Manger,Eating Out,6,4377
28,4,2011,ATM Cash Withdrawal,General,20,4357
28,4,2011,Civic Shop,,5,4352
29,4,2011,ASDA,Groceries,71,4281
29,4,2011,Wild Bean Cafe,Eating Out,2,4279
29,4,2011,The West Cornwall Pasty Company,Eating Out,8,4271
29,4,2011,Restaurant Gordon RamsayPortland Restaurant,Eating Out,52,4219
29,4,2011,ATM Cash Withdrawal,General,10,4209
30,4,2011,Dominos Pizza,Eating Out,33,4176
1,5,2011,Rhino Sports salary,General,1600,5776
1,5,2011,Restaurant Gordon RamsayPortland Restaurant,Eating Out,34,5742
2,5,2011,South West Trains,Transport,22,5720
2,5,2011,Caffe Nero,Eating Out,1,5719
2,5,2011,McDonalds,Eating Out,5,5714
3,5,2011,Starbucks Coffee,Eating Out,2,5712
3,5,2011,The West Cornwall Pasty Company,Eating Out,5,5707
3,5,2011,ATM Cash Withdrawal,General,20,5687
4,5,2011,Costa Coffee,Eating Out,2,5685
4,5,2011,Subway,Eating Out,6,5679
4,5,2011,ATM Cash Withdrawal,General,20,5659
5,5,2011,Wild Bean Cafe,Eating Out,2,5657
5,5,2011,Subway,Eating Out,8,5649
5,5,2011,Paying back Julie,,8,5641
6,5,2011,Tescos,Groceries,38,5603
6,5,2011,Wild Bean Cafe,Eating Out,2,5601
6,5,2011,The West Cornwall Pasty Company,Eating Out,7,5594
6,5,2011,Pizza Express,Eating Out,27,5567
7,5,2011,Cubit and West rent,Rent,400,5167
8,5,2011,ATM Cash Withdrawal,General,10,5157
9,5,2011,South West Trains,Transport,19,5138
9,5,2011,Starbucks Coffee,Eating Out,2,5136
9,5,2011,ATM Cash Withdrawal,General,20,5116
10,5,2011,McDonalds,Eating Out,6,5110
11,5,2011,Caffe Nero,Eating Out,2,5108
12,5,2011,Caffe Nero,Eating Out,2,5106
12,5,2011,Pret A Manger,Eating Out,7,5099
12,5,2011,ATM Cash Withdrawal,General,20,5079
13,5,2011,Tescos,Groceries,67,5012
13,5,2011,Costa Coffee,Eating Out,1,5011
13,5,2011,The West Cornwall Pasty Company,Eating Out,7,5004
13,5,2011,Ministry of Sound ClubXOYO Club,Eating Out,15,4989
13,5,2011,Ministry of Sound ClubXOYO Club,Eating Out,15,4974
13,5,2011,Ministry of Sound ClubXOYO Club,Eating Out,16,4958
13,5,2011,Anglo restaurant,Eating Out,24,4934
15,5,2011,BRGAS-Electricity,Bills,29,4905
15,5,2011,BRGAS-Gas,Bills,20,4885
15,5,2011,Pizza Express,Eating Out,45,4840
15,5,2011,ATM Cash Withdrawal,General,10,4830
16,5,2011,LBS Council Tax,Bills,20,4810
16,5,2011,South West Trains,Transport,25,4785
16,5,2011,Caffe Nero,Eating Out,2,4783
16,5,2011,McDonalds,Eating Out,4,4779
17,5,2011,Starbucks Coffee,Eating Out,2,4777
17,5,2011,The West Cornwall Pasty Company,Eating Out,8,4769
18,5,2011,Starbucks Coffee,Eating Out,2,4767
18,5,2011,McDonalds,Eating Out,6,4761
19,5,2011,Wild Bean Cafe,Eating Out,1,4760
20,5,2011,VIRGIN MEDIA PYMTS,Bills,17,4743
20,5,2011,Waitrose,Groceries,67,4676
20,5,2011,Starbucks Coffee,Eating Out,1,4675
20,5,2011,Pret A Manger,Eating Out,5,4670
21,5,2011,Civic Shop,,7,4663
23,5,2011,South West Trains,Transport,22,4641
23,5,2011,Costa Coffee,Eating Out,2,4639
23,5,2011,Subway,Eating Out,6,4633
23,5,2011,ATM Cash Withdrawal,General,10,4623
24,5,2011,O2,Bills,20,4603
24,5,2011,Starbucks Coffee,Eating Out,1,4602
24,5,2011,The West Cornwall Pasty Company,Eating Out,8,4594
25,5,2011,Costa Coffee,Eating Out,2,4592
25,5,2011,Greggs,Eating Out,4,4588
25,5,2011,ATM Cash Withdrawal,General,10,4578
26,5,2011,Starbucks Coffee,Eating Out,1,4577
26,5,2011,ATM Cash Withdrawal,General,20,4557
27,5,2011,Morrisons,Groceries,57,4500
27,5,2011,Starbucks Coffee,Eating Out,2,4498
27,5,2011,The Grand Pub,Eating Out,16,4482
27,5,2011,The Grand Pub,Eating Out,9,4473
27,5,2011,The Grand Pub,Eating Out,9,4464
27,5,2011,Restaurant Gordon RamsayPortland Restaurant,Eating Out,24,4440
27,5,2011,ATM Cash Withdrawal,General,10,4430
30,5,2011,South West Trains,Transport,17,4413
30,5,2011,Subway,Eating Out,8,4405
30,5,2011,ATM Cash Withdrawal,General,10,4395
30,5,2011,Red Shop,,4,4391
31,5,2011,Starbucks Coffee,Eating Out,2,4389
31,5,2011,ATM Cash Withdrawal,General,10,4379
1,6,2011,Rhino Sports salary,General,1600,5979
1,6,2011,Wild Bean Cafe,Eating Out,1,5978
1,6,2011,Chicken Cottage,Eating Out,5,5973
1,6,2011,ATM Cash Withdrawal,General,20,5953
2,6,2011,Wild Bean Cafe,Eating Out,2,5951
2,6,2011,The West Cornwall Pasty Company,Eating Out,5,5946
3,6,2011,Tescos,Groceries,58,5888
3,6,2011,Caffe Nero,Eating Out,1,5887
3,6,2011,ATM Cash Withdrawal,General,20,5867
4,6,2011,Anglo restaurant,Eating Out,43,5824
5,6,2011,ATM Cash Withdrawal,General,10,5814
5,6,2011,Paying back Julie,,2,5812
6,6,2011,South West Trains,Transport,22,5790
6,6,2011,Greggs,Eating Out,6,5784
7,6,2011,Cubit and West rent,Rent,400,5384
7,6,2011,Starbucks Coffee,Eating Out,1,5383
8,6,2011,Starbucks Coffee,Eating Out,2,5381
9,6,2011,Starbucks Coffee,Eating Out,1,5380
9,6,2011,McDonalds,Eating Out,4,5376
10,6,2011,Sainsburys,Groceries,50,5326
10,6,2011,Caffe Nero,Eating Out,2,5324
10,6,2011,ATM Cash Withdrawal,General,20,5304
10,6,2011,Paying back James,,3,5301
11,6,2011,Restaurant Gordon RamsayPortland Restaurant,Eating Out,28,5273
11,6,2011,ATM Cash Withdrawal,General,20,5253
12,6,2011,Dominos Pizza,Eating Out,51,5202
13,6,2011,South West Trains,Transport,20,5182
13,6,2011,Costa Coffee,Eating Out,1,5181
13,6,2011,Chicken Cottage,Eating Out,4,5177
14,6,2011,Caffe Nero,Eating Out,2,5175
14,6,2011,Chicken Cottage,Eating Out,5,5170
14,6,2011,ATM Cash Withdrawal,General,10,5160
15,6,2011,BRGAS-Electricity,Bills,14,5146
15,6,2011,BRGAS-Gas,Bills,19,5127
15,6,2011,Starbucks Coffee,Eating Out,2,5125
15,6,2011,Pret A Manger,Eating Out,4,5121
15,6,2011,ATM Cash Withdrawal,General,20,5101
16,6,2011,LBS Council Tax,Bills,20,5081
16,6,2011,Caffe Nero,Eating Out,2,5079
17,6,2011,ASDA,Groceries,47,5032
17,6,2011,Starbucks Coffee,Eating Out,2,5030
17,6,2011,Pizza Express,Eating Out,35,4995
17,6,2011,ATM Cash Withdrawal,General,20,4975
18,6,2011,Pizza Express,Eating Out,26,4949
19,6,2011,Red Shop,,9,4940
20,6,2011,VIRGIN MEDIA PYMTS,Bills,14,4926
20,6,2011,South West Trains,Transport,18,4908
20,6,2011,Caffe Nero,Eating Out,2,4906
21,6,2011,Subway,Eating Out,8,4898
22,6,2011,Costa Coffee,Eating Out,2,4896
22,6,2011,McDonalds,Eating Out,5,4891
23,6,2011,Costa Coffee,Eating Out,2,4889
23,6,2011,McDonalds,Eating Out,7,4882
24,6,2011,O2,Bills,20,4862
24,6,2011,Waitrose,Groceries,72,4790
24,6,2011,Wild Bean Cafe,Eating Out,2,4788
24,6,2011,McDonalds,Eating Out,8,4780
25,6,2011,ATM Cash Withdrawal,General,20,4760
26,6,2011,Scott's Restaurant,Eating Out,42,4718
26,6,2011,ATM Cash Withdrawal,General,20,4698
27,6,2011,South West Trains,Transport,16,4682
27,6,2011,Starbucks Coffee,Eating Out,2,4680
27,6,2011,Subway,Eating Out,8,4672
29,6,2011,Pret A Manger,Eating Out,8,4664
29,6,2011,ATM Cash Withdrawal,General,10,4654
30,6,2011,Wild Bean Cafe,Eating Out,2,4652
30,6,2011,The West Cornwall Pasty Company,Eating Out,6,4646
1,7,2011,Rhino Sports salary,General,1600,6246
1,7,2011,ASDA,Groceries,54,6192
1,7,2011,Caffe Nero,Eating Out,1,6191
1,7,2011,Greggs,Eating Out,5,6186
1,7,2011,ATM Cash Withdrawal,General,10,6176
2,7,2011,Fabric Club,Eating Out,13,6163
2,7,2011,Fabric Club,Eating Out,7,6156
2,7,2011,Fabric Club,Eating Out,5,6151
2,7,2011,Fabric Club,Eating Out,6,6145
2,7,2011,Fabric Club,Eating Out,10,6135
2,7,2011,Fabric Club,Eating Out,9,6126
3,7,2011,Anglo restaurant,Eating Out,35,6091
4,7,2011,South West Trains,Transport,24,6067
4,7,2011,Starbucks Coffee,Eating Out,2,6065
4,7,2011,Greggs,Eating Out,7,6058
5,7,2011,Caffe Nero,Eating Out,1,6057
5,7,2011,McDonalds,Eating Out,4,6053
6,7,2011,Caffe Nero,Eating Out,2,6051
6,7,2011,Greggs,Eating Out,6,6045
7,7,2011,Cubit and West rent,Rent,400,5645
7,7,2011,Civic Shop,,1,5644
8,7,2011,Tescos,Groceries,61,5583
8,7,2011,Caffe Nero,Eating Out,2,5581
8,7,2011,Greggs,Eating Out,5,5576
8,7,2011,Anglo restaurant,Eating Out,36,5540
10,7,2011,Anglo restaurant,Eating Out,31,5509
11,7,2011,South West Trains,Transport,25,5484
11,7,2011,Subway,Eating Out,4,5480
11,7,2011,ATM Cash Withdrawal,General,10,5470
12,7,2011,Wild Bean Cafe,Eating Out,2,5468
12,7,2011,Chicken Cottage,Eating Out,6,5462
13,7,2011,Caffe Nero,Eating Out,1,5461
14,7,2011,Starbucks Coffee,Eating Out,2,5459
14,7,2011,Greggs,Eating Out,4,5455
14,7,2011,Paying back James,,1,5454
15,7,2011,BRGAS-Electricity,Bills,22,5432
15,7,2011,BRGAS-Gas,Bills,16,5416
15,7,2011,Morrisons,Groceries,38,5378
15,7,2011,Starbucks Coffee,Eating Out,2,5376
15,7,2011,Subway,Eating Out,8,5368
15,7,2011,ATM Cash Withdrawal,General,20,5348
16,7,2011,LBS Council Tax,Bills,20,5328
16,7,2011,ATM Cash Withdrawal,General,10,5318
17,7,2011,Dominos Pizza,Eating Out,54,5264
18,7,2011,South West Trains,Transport,18,5246
18,7,2011,Starbucks Coffee,Eating Out,2,5244
18,7,2011,Chicken Cottage,Eating Out,6,5238
18,7,2011,ATM Cash Withdrawal,General,10,5228
19,7,2011,Starbucks Coffee,Eating Out,1,5227
19,7,2011,The West Cornwall Pasty Company,Eating Out,5,5222
20,7,2011,VIRGIN MEDIA PYMTS,Bills,23,5199
20,7,2011,Starbucks Coffee,Eating Out,1,5198
20,7,2011,Red Shop,,9,5189
21,7,2011,Starbucks Coffee,Eating Out,1,5188
21,7,2011,McDonalds,Eating Out,6,5182
22,7,2011,ASDA,Groceries,37,5145
22,7,2011,Starbucks Coffee,Eating Out,1,5144
22,7,2011,Chicken Cottage,Eating Out,5,5139
23,7,2011,Anglo restaurant,Eating Out,48,5091
24,7,2011,O2,Bills,22,5069
24,7,2011,Anglo restaurant,Eating Out,25,5044
25,7,2011,South West Trains,Transport,21,5023
25,7,2011,Costa Coffee,Eating Out,2,5021
25,7,2011,Subway,Eating Out,4,5017
26,7,2011,Wild Bean Cafe,Eating Out,2,5015
27,7,2011,Starbucks Coffee,Eating Out,1,5014
27,7,2011,The West Cornwall Pasty Company,Eating Out,5,5009
28,7,2011,Wild Bean Cafe,Eating Out,2,5007
28,7,2011,Greggs,Eating Out,6,5001
29,7,2011,Sainsburys,Groceries,72,4929
29,7,2011,Starbucks Coffee,Eating Out,2,4927
29,7,2011,Restaurant Gordon RamsayPortland Restaurant,Eating Out,50,4877
29,7,2011,ATM Cash Withdrawal,General,10,4867
30,7,2011,Heaven Club,Eating Out,5,4862
30,7,2011,Heaven Club,Eating Out,5,4857
30,7,2011,Heaven Club,Eating Out,14,4843
30,7,2011,Heaven Club,Eating Out,6,4837
31,7,2011,Scott's Restaurant,Eating Out,37,4800
1,8,2011,Rhino Sports salary,General,1600,6400
1,8,2011,South West Trains,Transport,22,6378
1,8,2011,Costa Coffee,Eating Out,2,6376
1,8,2011,Chicken Cottage,Eating Out,7,6369
1,8,2011,ATM Cash Withdrawal,General,10,6359
2,8,2011,Greggs,Eating Out,6,6353
2,8,2011,ATM Cash Withdrawal,General,10,6343
3,8,2011,The West Cornwall Pasty Company,Eating Out,7,6336
4,8,2011,ATM Cash Withdrawal,General,20,6316
5,8,2011,Sainsburys,Groceries,46,6270
5,8,2011,Caffe Nero,Eating Out,1,6269
5,8,2011,Greggs,Eating Out,5,6264
5,8,2011,Heaven Club,Eating Out,5,6259
5,8,2011,Heaven Club,Eating Out,8,6251
5,8,2011,Heaven Club,Eating Out,12,6239
5,8,2011,Heaven Club,Eating Out,11,6228
5,8,2011,Heaven Club,Eating Out,9,6219
5,8,2011,Tool Tec,,6,6213
7,8,2011,Cubit and West rent,Rent,400,5813
7,8,2011,ATM Cash Withdrawal,General,10,5803
8,8,2011,South West Trains,Transport,25,5778
8,8,2011,Costa Coffee,Eating Out,2,5776
8,8,2011,Subway,Eating Out,6,5770
9,8,2011,The West Cornwall Pasty Company,Eating Out,8,5762
9,8,2011,ATM Cash Withdrawal,General,20,5742
10,8,2011,The West Cornwall Pasty Company,Eating Out,5,5737
11,8,2011,Starbucks Coffee,Eating Out,1,5736
11,8,2011,McDonalds,Eating Out,4,5732
11,8,2011,ATM Cash Withdrawal,General,10,5722
11,8,2011,Civic Shop,,9,5713
12,8,2011,ASDA,Groceries,62,5651
12,8,2011,Wild Bean Cafe,Eating Out,2,5649
12,8,2011,Greggs,Eating Out,6,5643
12,8,2011,Fabric Club,Eating Out,10,5633
12,8,2011,Fabric Club,Eating Out,14,5619
12,8,2011,Fabric Club,Eating Out,12,5607
12,8,2011,Fabric Club,Eating Out,14,5593
12,8,2011,Restaurant Gordon RamsayPortland Restaurant,Eating Out,44,5549
14,8,2011,Anglo restaurant,Eating Out,45,5504
15,8,2011,BRGAS-Electricity,Bills,25,5479
15,8,2011,BRGAS-Gas,Bills,25,5454
15,8,2011,South West Trains,Transport,18,5436
16,8,2011,LBS Council Tax,Bills,20,5416
16,8,2011,Starbucks Coffee,Eating Out,1,5415
17,8,2011,Caffe Nero,Eating Out,1,5414
17,8,2011,Greggs,Eating Out,4,5410
17,8,2011,ATM Cash Withdrawal,General,10,5400
18,8,2011,The West Cornwall Pasty Company,Eating Out,6,5394
18,8,2011,ATM Cash Withdrawal,General,20,5374
19,8,2011,Waitrose,Groceries,40,5334
19,8,2011,Caffe Nero,Eating Out,2,5332
19,8,2011,Subway,Eating Out,8,5324
19,8,2011,Ministry of Sound ClubXOYO Club,Eating Out,5,5319
19,8,2011,Ministry of Sound ClubXOYO Club,Eating Out,7,5312
19,8,2011,Ministry of Sound ClubXOYO Club,Eating Out,11,5301
19,8,2011,Ministry of Sound ClubXOYO Club,Eating Out,8,5293
19,8,2011,Pizza Express,Eating Out,40,5253
19,8,2011,ATM Cash Withdrawal,General,20,5233
20,8,2011,VIRGIN MEDIA PYMTS,Bills,14,5219
20,8,2011,ATM Cash Withdrawal,General,10,5209
21,8,2011,ATM Cash Withdrawal,General,20,5189
22,8,2011,South West Trains,Transport,16,5173
22,8,2011,Pret A Manger,Eating Out,7,5166
23,8,2011,Wild Bean Cafe,Eating Out,2,5164
23,8,2011,ATM Cash Withdrawal,General,10,5154
24,8,2011,O2,Bills,21,5133
24,8,2011,Wild Bean Cafe,Eating Out,1,5132
24,8,2011,Subway,Eating Out,7,5125
25,8,2011,Costa Coffee,Eating Out,1,5124
25,8,2011,The West Cornwall Pasty Company,Eating Out,7,5117
26,8,2011,Tescos,Groceries,59,5058
26,8,2011,Starbucks Coffee,Eating Out,2,5056
26,8,2011,McDonalds,Eating Out,4,5052
26,8,2011,Heaven Club,Eating Out,7,5045
26,8,2011,Heaven Club,Eating Out,8,5037
26,8,2011,Pizza Express,Eating Out,53,4984
26,8,2011,ATM Cash Withdrawal,General,20,4964
27,8,2011,Dominos Pizza,Eating Out,33,4931
27,8,2011,ATM Cash Withdrawal,General,10,4921
28,8,2011,Pizza Express,Eating Out,55,4866
29,8,2011,South West Trains,Transport,22,4844
29,8,2011,Costa Coffee,Eating Out,2,4842
29,8,2011,The West Cornwall Pasty Company,Eating Out,7,4835
30,8,2011,Starbucks Coffee,Eating Out,1,4834
30,8,2011,Subway,Eating Out,5,4829
30,8,2011,ATM Cash Withdrawal,General,10,4819
30,8,2011,Paying back Julie,,1,4818
31,8,2011,Wild Bean Cafe,Eating Out,1,4817
1,9,2011,Rhino Sports salary,General,1600,6417
1,9,2011,Wild Bean Cafe,Eating Out,1,6416
2,9,2011,ASDA,Groceries,52,6364
2,9,2011,Starbucks Coffee,Eating Out,2,6362
2,9,2011,Scott's Restaurant,Eating Out,33,6329
3,9,2011,ATM Cash Withdrawal,General,10,6319
3,9,2011,Tool Tec,,2,6317
4,9,2011,Paying back Julie,,3,6314
5,9,2011,South West Trains,Transport,17,6297
5,9,2011,Starbucks Coffee,Eating Out,2,6295
5,9,2011,Pret A Manger,Eating Out,4,6291
6,9,2011,Starbucks Coffee,Eating Out,1,6290
6,9,2011,Greggs,Eating Out,4,6286
7,9,2011,Cubit and West rent,Rent,400,5886
7,9,2011,Costa Coffee,Eating Out,2,5884
7,9,2011,The West Cornwall Pasty Company,Eating Out,7,5877
7,9,2011,ATM Cash Withdrawal,General,20,5857
8,9,2011,Wild Bean Cafe,Eating Out,1,5856
8,9,2011,ATM Cash Withdrawal,General,10,5846
8,9,2011,Tool Shop,,7,5839
9,9,2011,Tescos,Groceries,40,5799
9,9,2011,Pret A Manger,Eating Out,6,5793
9,9,2011,Restaurant Gordon RamsayPortland Restaurant,Eating Out,52,5741
10,9,2011,Heaven Club,Eating Out,9,5732
10,9,2011,Heaven Club,Eating Out,7,5725
10,9,2011,Heaven Club,Eating Out,16,5709
10,9,2011,Heaven Club,Eating Out,15,5694
10,9,2011,Heaven Club,Eating Out,16,5678
11,9,2011,Anglo restaurant,Eating Out,31,5647
12,9,2011,South West Trains,Transport,21,5626
12,9,2011,Caffe Nero,Eating Out,2,5624
13,9,2011,Caffe Nero,Eating Out,1,5623
14,9,2011,Tool Tec,,1,5622
15,9,2011,BRGAS-Electricity,Bills,17,5605
15,9,2011,BRGAS-Gas,Bills,22,5583
15,9,2011,Caffe Nero,Eating Out,2,5581
16,9,2011,LBS Council Tax,Bills,20,5561
16,9,2011,Tescos,Groceries,50,5511
16,9,2011,Wild Bean Cafe,Eating Out,1,5510
16,9,2011,ATM Cash Withdrawal,General,10,5500
17,9,2011,Scott's Restaurant,Eating Out,30,5470
17,9,2011,ATM Cash Withdrawal,General,20,5450
17,9,2011,Paying back Julie,,3,5447
18,9,2011,Anglo restaurant,Eating Out,58,5389
18,9,2011,ATM Cash Withdrawal,General,20,5369
18,9,2011,Paying back James,,9,5360
19,9,2011,South West Trains,Transport,24,5336
19,9,2011,Starbucks Coffee,Eating Out,2,5334
19,9,2011,McDonalds,Eating Out,8,5326
20,9,2011,VIRGIN MEDIA PYMTS,Bills,26,5300
21,9,2011,Costa Coffee,Eating Out,1,5299
21,9,2011,Paying back James,,4,5295
22,9,2011,Starbucks Coffee,Eating Out,2,5293
22,9,2011,Pret A Manger,Eating Out,6,5287
22,9,2011,Civic Shop,,7,5280
23,9,2011,Sainsburys,Groceries,53,5227
23,9,2011,Costa Coffee,Eating Out,2,5225
23,9,2011,Subway,Eating Out,6,5219
23,9,2011,ATM Cash Withdrawal,General,10,5209
24,9,2011,O2,Bills,22,5187
24,9,2011,Restaurant Gordon RamsayPortland Restaurant,Eating Out,55,5132
26,9,2011,South West Trains,Transport,20,5112
26,9,2011,Wild Bean Cafe,Eating Out,1,5111
27,9,2011,Wild Bean Cafe,Eating Out,2,5109
27,9,2011,Chicken Cottage,Eating Out,4,5105
28,9,2011,Caffe Nero,Eating Out,2,5103
28,9,2011,The West Cornwall Pasty Company,Eating Out,8,5095
29,9,2011,Wild Bean Cafe,Eating Out,2,5093
29,9,2011,Pret A Manger,Eating Out,6,5087
29,9,2011,Civic Shop,,9,5078
30,9,2011,Morrisons,Groceries,47,5031
30,9,2011,Heaven Club,Eating Out,16,5015
30,9,2011,Heaven Club,Eating Out,5,5010
30,9,2011,Heaven Club,Eating Out,5,5005
30,9,2011,Heaven Club,Eating Out,6,4999
30,9,2011,Pizza Express,Eating Out,30,4969
1,10,2011,Rhino Sports salary,General,1600,6569
1,10,2011,ATM Cash Withdrawal,General,10,6559
2,10,2011,Dominos Pizza,Eating Out,33,6526
2,10,2011,ATM Cash Withdrawal,General,20,6506
3,10,2011,South West Trains,Transport,25,6481
3,10,2011,Costa Coffee,Eating Out,2,6479
3,10,2011,The West Cornwall Pasty Company,Eating Out,7,6472
4,10,2011,Wild Bean Cafe,Eating Out,1,6471
5,10,2011,Caffe Nero,Eating Out,1,6470
5,10,2011,ATM Cash Withdrawal,General,10,6460
6,10,2011,Caffe Nero,Eating Out,1,6459
6,10,2011,The West Cornwall Pasty Company,Eating Out,7,6452
7,10,2011,Cubit and West rent,Rent,400,6052
7,10,2011,Waitrose,Groceries,74,5978
8,10,2011,ATM Cash Withdrawal,General,20,5958
9,10,2011,ATM Cash Withdrawal,General,20,5938
9,10,2011,Tool Tec,,3,5935
10,10,2011,South West Trains,Transport,21,5914
10,10,2011,Subway,Eating Out,5,5909
10,10,2011,Paying back James,,7,5902
11,10,2011,Caffe Nero,Eating Out,2,5900
12,10,2011,Starbucks Coffee,Eating Out,1,5899
13,10,2011,Wild Bean Cafe,Eating Out,1,5898
13,10,2011,Subway,Eating Out,5,5893
14,10,2011,Waitrose,Groceries,71,5822
14,10,2011,Pret A Manger,Eating Out,8,5814
14,10,2011,Restaurant Gordon RamsayPortland Restaurant,Eating Out,44,5770
15,10,2011,BRGAS-Electricity,Bills,18,5752
15,10,2011,BRGAS-Gas,Bills,25,5727
15,10,2011,Scott's Restaurant,Eating Out,42,5685
15,10,2011,Red Shop,,2,5683
16,10,2011,LBS Council Tax,Bills,20,5663
16,10,2011,Scott's Restaurant,Eating Out,28,5635
16,10,2011,ATM Cash Withdrawal,General,10,5625
16,10,2011,Paying back Julie,,4,5621
17,10,2011,South West Trains,Transport,22,5599
17,10,2011,Costa Coffee,Eating Out,2,5597
18,10,2011,Caffe Nero,Eating Out,1,5596
18,10,2011,ATM Cash Withdrawal,General,10,5586
18,10,2011,Civic Shop,,2,5584
19,10,2011,Greggs,Eating Out,5,5579
19,10,2011,ATM Cash Withdrawal,General,10,5569
20,10,2011,VIRGIN MEDIA PYMTS,Bills,23,5546
20,10,2011,Costa Coffee,Eating Out,1,5545
20,10,2011,Greggs,Eating Out,4,5541
21,10,2011,Tescos,Groceries,50,5491
21,10,2011,Greggs,Eating Out,5,5486
21,10,2011,The Grand Pub,Eating Out,5,5481
21,10,2011,The Grand Pub,Eating Out,11,5470
21,10,2011,The Grand Pub,Eating Out,12,5458
21,10,2011,The Grand Pub,Eating Out,10,5448
21,10,2011,The Grand Pub,Eating Out,9,5439
21,10,2011,The Grand Pub,Eating Out,16,5423
21,10,2011,Pizza Express,Eating Out,43,5380
23,10,2011,Anglo restaurant,Eating Out,34,5346
23,10,2011,ATM Cash Withdrawal,General,10,5336
24,10,2011,O2,Bills,24,5312
24,10,2011,South West Trains,Transport,24,5288
25,10,2011,McDonalds,Eating Out,7,5281
26,10,2011,Pret A Manger,Eating Out,7,5274
26,10,2011,Civic Shop,,5,5269
27,10,2011,Starbucks Coffee,Eating Out,2,5267
27,10,2011,McDonalds,Eating Out,5,5262
28,10,2011,Tescos,Groceries,73,5189
28,10,2011,ATM Cash Withdrawal,General,20,5169
29,10,2011,Fabric Club,Eating Out,10,5159
30,10,2011,Restaurant Gordon RamsayPortland Restaurant,Eating Out,54,5105
30,10,2011,ATM Cash Withdrawal,General,20,5085
31,10,2011,South West Trains,Transport,21,5064
31,10,2011,Greggs,Eating Out,7,5057
31,10,2011,Red Shop,,3,5054
1,11,2011,Rhino Sports salary,General,1600,6654
1,11,2011,Starbucks Coffee,Eating Out,2,6652
1,11,2011,Pret A Manger,Eating Out,5,6647
2,11,2011,Costa Coffee,Eating Out,2,6645
2,11,2011,Subway,Eating Out,7,6638
3,11,2011,McDonalds,Eating Out,8,6630
4,11,2011,ASDA,Groceries,61,6569
4,11,2011,Caffe Nero,Eating Out,2,6567
4,11,2011,Pret A Manger,Eating Out,7,6560
5,11,2011,Pizza Express,Eating Out,30,6530
5,11,2011,ATM Cash Withdrawal,General,20,6510
6,11,2011,Anglo restaurant,Eating Out,45,6465
7,11,2011,Cubit and West rent,Rent,400,6065
7,11,2011,South West Trains,Transport,25,6040
7,11,2011,Caffe Nero,Eating Out,2,6038
7,11,2011,McDonalds,Eating Out,7,6031
7,11,2011,Civic Shop,,1,6030
8,11,2011,Caffe Nero,Eating Out,2,6028
8,11,2011,Subway,Eating Out,7,6021
9,11,2011,Wild Bean Cafe,Eating Out,2,6019
10,11,2011,Costa Coffee,Eating Out,1,6018
10,11,2011,Pret A Manger,Eating Out,6,6012
10,11,2011,ATM Cash Withdrawal,General,10,6002
11,11,2011,Morrisons,Groceries,52,5950
11,11,2011,Caffe Nero,Eating Out,2,5948
11,11,2011,Subway,Eating Out,7,5941
12,11,2011,Paying back James,,3,5938
14,11,2011,South West Trains,Transport,20,5918
14,11,2011,Wild Bean Cafe,Eating Out,2,5916
14,11,2011,Subway,Eating Out,6,5910
15,11,2011,BRGAS-Electricity,Bills,21,5889
15,11,2011,BRGAS-Gas,Bills,34,5855
15,11,2011,Starbucks Coffee,Eating Out,1,5854
15,11,2011,Pret A Manger,Eating Out,5,5849
16,11,2011,LBS Council Tax,Bills,20,5829
16,11,2011,Costa Coffee,Eating Out,2,5827
17,11,2011,Subway,Eating Out,7,5820
17,11,2011,ATM Cash Withdrawal,General,10,5810
18,11,2011,Tescos,Groceries,41,5769
18,11,2011,The West Cornwall Pasty Company,Eating Out,6,5763
18,11,2011,Restaurant Gordon RamsayPortland Restaurant,Eating Out,35,5728
18,11,2011,ATM Cash Withdrawal,General,10,5718
20,11,2011,VIRGIN MEDIA PYMTS,Bills,19,5699
21,11,2011,South West Trains,Transport,25,5674
21,11,2011,Wild Bean Cafe,Eating Out,1,5673
21,11,2011,McDonalds,Eating Out,5,5668
22,11,2011,Wild Bean Cafe,Eating Out,2,5666
22,11,2011,Greggs,Eating Out,6,5660
23,11,2011,Starbucks Coffee,Eating Out,2,5658
24,11,2011,O2,Bills,21,5637
24,11,2011,Wild Bean Cafe,Eating Out,2,5635
24,11,2011,Greggs,Eating Out,8,5627
25,11,2011,Sainsburys,Groceries,46,5581
25,11,2011,Wild Bean Cafe,Eating Out,1,5580
25,11,2011,Scott's Restaurant,Eating Out,25,5555
26,11,2011,Ministry of Sound ClubXOYO Club,Eating Out,11,5544
26,11,2011,Anglo restaurant,Eating Out,55,5489
28,11,2011,South West Trains,Transport,23,5466
28,11,2011,Wild Bean Cafe,Eating Out,1,5465
28,11,2011,ATM Cash Withdrawal,General,10,5455
29,11,2011,McDonalds,Eating Out,6,5449
30,11,2011,Wild Bean Cafe,Eating Out,2,5447
30,11,2011,McDonalds,Eating Out,7,5440
30,11,2011,Paying back Julie,,1,5439
1,12,2011,Rhino Sports salary,General,1600,7039
1,12,2011,The West Cornwall Pasty Company,Eating Out,7,7032
1,12,2011,ATM Cash Withdrawal,General,20,7012
2,12,2011,Morrisons,Groceries,52,6960
2,12,2011,Caffe Nero,Eating Out,2,6958
2,12,2011,Greggs,Eating Out,6,6952
2,12,2011,ATM Cash Withdrawal,General,10,6942
3,12,2011,ATM Cash Withdrawal,General,20,6922
5,12,2011,South West Trains,Transport,22,6900
5,12,2011,Starbucks Coffee,Eating Out,1,6899
5,12,2011,Subway,Eating Out,5,6894
5,12,2011,ATM Cash Withdrawal,General,20,6874
6,12,2011,Caffe Nero,Eating Out,2,6872
6,12,2011,Paying back Julie,,7,6865
7,12,2011,Cubit and West rent,Rent,400,6465
7,12,2011,Caffe Nero,Eating Out,1,6464
8,12,2011,Chicken Cottage,Eating Out,6,6458
8,12,2011,ATM Cash Withdrawal,General,20,6438
9,12,2011,Waitrose,Groceries,57,6381
9,12,2011,Starbucks Coffee,Eating Out,2,6379
9,12,2011,Greggs,Eating Out,4,6375
9,12,2011,Ministry of Sound ClubXOYO Club,Eating Out,11,6364
9,12,2011,Ministry of Sound ClubXOYO Club,Eating Out,11,6353
9,12,2011,Ministry of Sound ClubXOYO Club,Eating Out,12,6341
9,12,2011,Ministry of Sound ClubXOYO Club,Eating Out,6,6335
9,12,2011,Ministry of Sound ClubXOYO Club,Eating Out,7,6328
9,12,2011,Ministry of Sound ClubXOYO Club,Eating Out,15,6313
9,12,2011,Scott's Restaurant,Eating Out,37,6276
9,12,2011,ATM Cash Withdrawal,General,10,6266
10,12,2011,The Grand Pub,Eating Out,12,6254
10,12,2011,Pizza Express,Eating Out,56,6198
10,12,2011,ATM Cash Withdrawal,General,10,6188
11,12,2011,Pizza Express,Eating Out,39,6149
11,12,2011,ATM Cash Withdrawal,General,20,6129
11,12,2011,Paying back James,,9,6120
12,12,2011,South West Trains,Transport,23,6097
12,12,2011,Caffe Nero,Eating Out,1,6096
12,12,2011,McDonalds,Eating Out,6,6090
12,12,2011,ATM Cash Withdrawal,General,10,6080
13,12,2011,Costa Coffee,Eating Out,2,6078
13,12,2011,Pret A Manger,Eating Out,8,6070
13,12,2011,ATM Cash Withdrawal,General,10,6060
14,12,2011,Caffe Nero,Eating Out,2,6058
14,12,2011,ATM Cash Withdrawal,General,10,6048
14,12,2011,Cheam Service Station,,1,6047
15,12,2011,BRGAS-Electricity,Bills,25,6022
15,12,2011,BRGAS-Gas,Bills,18,6004
15,12,2011,Wild Bean Cafe,Eating Out,1,6003
16,12,2011,LBS Council Tax,Bills,20,5983
16,12,2011,Sainsburys,Groceries,48,5935
16,12,2011,Wild Bean Cafe,Eating Out,2,5933
16,12,2011,Pret A Manger,Eating Out,8,5925
16,12,2011,ATM Cash Withdrawal,General,20,5905
17,12,2011,ATM Cash Withdrawal,General,20,5885
18,12,2011,Scott's Restaurant,Eating Out,40,5845
18,12,2011,Paying back Julie,,9,5836
19,12,2011,South West Trains,Transport,21,5815
19,12,2011,Costa Coffee,Eating Out,1,5814
19,12,2011,Subway,Eating Out,6,5808
19,12,2011,Paying back James,,5,5803
20,12,2011,VIRGIN MEDIA PYMTS,Bills,14,5789
20,12,2011,Starbucks Coffee,Eating Out,2,5787
21,12,2011,Caffe Nero,Eating Out,2,5785
21,12,2011,The West Cornwall Pasty Company,Eating Out,5,5780
22,12,2011,The West Cornwall Pasty Company,Eating Out,5,5775
23,12,2011,Morrisons,Groceries,60,5715
23,12,2011,Costa Coffee,Eating Out,2,5713
23,12,2011,Pizza Express,Eating Out,38,5675
24,12,2011,O2,Bills,24,5651
24,12,2011,ATM Cash Withdrawal,General,10,5641
24,12,2011,Red Shop,,6,5635
26,12,2011,South West Trains,Transport,23,5612
26,12,2011,Costa Coffee,Eating Out,1,5611
27,12,2011,McDonalds,Eating Out,5,5606
27,12,2011,ATM Cash Withdrawal,General,20,5586
28,12,2011,Starbucks Coffee,Eating Out,2,5584
28,12,2011,Chicken Cottage,Eating Out,5,5579
29,12,2011,Subway,Eating Out,5,5574
29,12,2011,Tool Shop,,6,5568
30,12,2011,Morrisons,Groceries,35,5533
30,12,2011,Starbucks Coffee,Eating Out,2,5531
31,12,2011,ATM Cash Withdrawal,General,10,5521
1,1,2012,Rhino Sports salary,General,1600,7121
1,1,2012,Restaurant Gordon RamsayPortland Restaurant,Eating Out,29,7092
2,1,2012,South West Trains,Transport,22,7070
2,1,2012,Starbucks Coffee,Eating Out,2,7068
2,1,2012,Chicken Cottage,Eating Out,5,7063
2,1,2012,ATM Cash Withdrawal,General,10,7053
3,1,2012,Starbucks Coffee,Eating Out,2,7051
3,1,2012,The West Cornwall Pasty Company,Eating Out,6,7045
4,1,2012,Costa Coffee,Eating Out,1,7044
5,1,2012,Starbucks Coffee,Eating Out,1,7043
5,1,2012,ATM Cash Withdrawal,General,20,7023
6,1,2012,Waitrose,Groceries,51,6972
6,1,2012,Costa Coffee,Eating Out,2,6970
6,1,2012,Pret A Manger,Eating Out,5,6965
6,1,2012,Scott's Restaurant,Eating Out,48,6917
7,1,2012,Cubit and West rent,Rent,400,6517
8,1,2012,Pizza Express,Eating Out,55,6462
9,1,2012,South West Trains,Transport,23,6439
10,1,2012,Caffe Nero,Eating Out,1,6438
11,1,2012,Pret A Manger,Eating Out,8,6430
12,1,2012,Starbucks Coffee,Eating Out,2,6428
12,1,2012,Pret A Manger,Eating Out,7,6421
12,1,2012,Tool Tec,,1,6420
13,1,2012,Morrisons,Groceries,52,6368
13,1,2012,Wild Bean Cafe,Eating Out,1,6367
13,1,2012,Subway,Eating Out,6,6361
13,1,2012,The Grand Pub,Eating Out,12,6349
13,1,2012,Scott's Restaurant,Eating Out,24,6325
13,1,2012,Cheam Service Station,,9,6316
14,1,2012,Anglo restaurant,Eating Out,42,6274
15,1,2012,BRGAS-Electricity,Bills,34,6240
15,1,2012,BRGAS-Gas,Bills,43,6197
15,1,2012,Dominos Pizza,Eating Out,59,6138
15,1,2012,Tool Shop,,1,6137
16,1,2012,LBS Council Tax,Bills,20,6117
16,1,2012,South West Trains,Transport,20,6097
16,1,2012,ATM Cash Withdrawal,General,10,6087
17,1,2012,Caffe Nero,Eating Out,2,6085
17,1,2012,Subway,Eating Out,5,6080
17,1,2012,Cheam Service Station,,2,6078
18,1,2012,Wild Bean Cafe,Eating Out,2,6076
18,1,2012,ATM Cash Withdrawal,General,20,6056
19,1,2012,Starbucks Coffee,Eating Out,2,6054
20,1,2012,VIRGIN MEDIA PYMTS,Bills,25,6029
20,1,2012,ASDA,Groceries,58,5971
20,1,2012,Starbucks Coffee,Eating Out,2,5969
20,1,2012,The West Cornwall Pasty Company,Eating Out,5,5964
21,1,2012,Dominos Pizza,Eating Out,28,5936
21,1,2012,ATM Cash Withdrawal,General,10,5926
23,1,2012,South West Trains,Transport,22,5904
23,1,2012,Caffe Nero,Eating Out,2,5902
23,1,2012,Chicken Cottage,Eating Out,7,5895
24,1,2012,O2,Bills,24,5871
24,1,2012,ATM Cash Withdrawal,General,10,5861
25,1,2012,Costa Coffee,Eating Out,2,5859
25,1,2012,Pret A Manger,Eating Out,8,5851
26,1,2012,Caffe Nero,Eating Out,2,5849
26,1,2012,ATM Cash Withdrawal,General,20,5829
27,1,2012,Tescos,Groceries,37,5792
27,1,2012,Chicken Cottage,Eating Out,4,5788
27,1,2012,Anglo restaurant,Eating Out,58,5730
29,1,2012,ATM Cash Withdrawal,General,10,5720
30,1,2012,South West Trains,Transport,25,5695
30,1,2012,Greggs,Eating Out,8,5687
30,1,2012,ATM Cash Withdrawal,General,20,5667
31,1,2012,Caffe Nero,Eating Out,2,5665
31,1,2012,The West Cornwall Pasty Company,Eating Out,5,5660
1,2,2012,Rhino Sports salary,General,1600,7260
1,2,2012,Costa Coffee,Eating Out,1,7259
1,2,2012,Subway,Eating Out,4,7255
2,2,2012,Wild Bean Cafe,Eating Out,2,7253
2,2,2012,Pret A Manger,Eating Out,8,7245
3,2,2012,Tescos,Groceries,71,7174
3,2,2012,Wild Bean Cafe,Eating Out,1,7173
3,2,2012,Pret A Manger,Eating Out,7,7166
3,2,2012,Anglo restaurant,Eating Out,35,7131
6,2,2012,South West Trains,Transport,24,7107
6,2,2012,Starbucks Coffee,Eating Out,2,7105
6,2,2012,Subway,Eating Out,5,7100
7,2,2012,Cubit and West rent,Rent,400,6700
8,2,2012,Starbucks Coffee,Eating Out,2,6698
8,2,2012,ATM Cash Withdrawal,General,10,6688
9,2,2012,Costa Coffee,Eating Out,2,6686
9,2,2012,Subway,Eating Out,6,6680
10,2,2012,Morrisons,Groceries,64,6616
10,2,2012,Costa Coffee,Eating Out,2,6614
10,2,2012,Dominos Pizza,Eating Out,27,6587
10,2,2012,ATM Cash Withdrawal,General,20,6567
11,2,2012,Dominos Pizza,Eating Out,49,6518
12,2,2012,Restaurant Gordon RamsayPortland Restaurant,Eating Out,49,6469
13,2,2012,South West Trains,Transport,25,6444
13,2,2012,Wild Bean Cafe,Eating Out,2,6442
13,2,2012,ATM Cash Withdrawal,General,20,6422
13,2,2012,Civic Shop,,3,6419
14,2,2012,ATM Cash Withdrawal,General,20,6399
15,2,2012,BRGAS-Electricity,Bills,29,6370
15,2,2012,BRGAS-Gas,Bills,24,6346
15,2,2012,Caffe Nero,Eating Out,1,6345
15,2,2012,Pret A Manger,Eating Out,8,6337
16,2,2012,LBS Council Tax,Bills,20,6317
16,2,2012,Costa Coffee,Eating Out,1,6316
16,2,2012,ATM Cash Withdrawal,General,20,6296
16,2,2012,Red Shop,,4,6292
17,2,2012,Morrisons,Groceries,72,6220
17,2,2012,Wild Bean Cafe,Eating Out,1,6219
18,2,2012,The Grand Pub,Eating Out,8,6211
18,2,2012,The Grand Pub,Eating Out,6,6205
18,2,2012,Anglo restaurant,Eating Out,26,6179
19,2,2012,Restaurant Gordon RamsayPortland Restaurant,Eating Out,26,6153
20,2,2012,VIRGIN MEDIA PYMTS,Bills,17,6136
20,2,2012,South West Trains,Transport,23,6113
20,2,2012,ATM Cash Withdrawal,General,20,6093
21,2,2012,Wild Bean Cafe,Eating Out,2,6091
21,2,2012,Subway,Eating Out,6,6085
22,2,2012,Starbucks Coffee,Eating Out,2,6083
22,2,2012,ATM Cash Withdrawal,General,20,6063
23,2,2012,Caffe Nero,Eating Out,2,6061
23,2,2012,McDonalds,Eating Out,6,6055
24,2,2012,O2,Bills,20,6035
24,2,2012,ASDA,Groceries,69,5966
24,2,2012,Starbucks Coffee,Eating Out,2,5964
24,2,2012,Greggs,Eating Out,6,5958
24,2,2012,Anglo restaurant,Eating Out,41,5917
24,2,2012,ATM Cash Withdrawal,General,10,5907
26,2,2012,Pizza Express,Eating Out,26,5881
26,2,2012,ATM Cash Withdrawal,General,10,5871
27,2,2012,South West Trains,Transport,23,5848
27,2,2012,Costa Coffee,Eating Out,2,5846
27,2,2012,Greggs,Eating Out,8,5838
28,2,2012,Caffe Nero,Eating Out,1,5837
29,2,2012,Costa Coffee,Eating Out,2,5835
29,2,2012,The West Cornwall Pasty Company,Eating Out,7,5828
29,2,2012,ATM Cash Withdrawal,General,10,5818
1,3,2012,Rhino Sports salary,General,1600,7418
1,3,2012,Wild Bean Cafe,Eating Out,2,7416
1,3,2012,ATM Cash Withdrawal,General,20,7396
2,3,2012,Waitrose,Groceries,50,7346
2,3,2012,Starbucks Coffee,Eating Out,2,7344
2,3,2012,Greggs,Eating Out,5,7339
3,3,2012,ATM Cash Withdrawal,General,10,7329
3,3,2012,Paying back James,,5,7324
5,3,2012,South West Trains,Transport,24,7300
5,3,2012,Pret A Manger,Eating Out,6,7294
5,3,2012,ATM Cash Withdrawal,General,20,7274
5,3,2012,Cheam Service Station,,5,7269
6,3,2012,Caffe Nero,Eating Out,1,7268
7,3,2012,Cubit and West rent,Rent,400,6868
7,3,2012,Wild Bean Cafe,Eating Out,2,6866
7,3,2012,Greggs,Eating Out,6,6860
8,3,2012,Costa Coffee,Eating Out,1,6859
9,3,2012,ASDA,Groceries,74,6785
9,3,2012,Caffe Nero,Eating Out,2,6783
9,3,2012,Scott's Restaurant,Eating Out,49,6734
10,3,2012,Scott's Restaurant,Eating Out,51,6683
12,3,2012,South West Trains,Transport,22,6661
12,3,2012,Greggs,Eating Out,4,6657
12,3,2012,ATM Cash Withdrawal,General,10,6647
13,3,2012,Costa Coffee,Eating Out,2,6645
14,3,2012,McDonalds,Eating Out,4,6641
14,3,2012,ATM Cash Withdrawal,General,20,6621
15,3,2012,BRGAS-Electricity,Bills,18,6603
15,3,2012,BRGAS-Gas,Bills,26,6577
15,3,2012,Caffe Nero,Eating Out,2,6575
15,3,2012,Subway,Eating Out,6,6569
16,3,2012,LBS Council Tax,Bills,20,6549
16,3,2012,Tescos,Groceries,53,6496
16,3,2012,Costa Coffee,Eating Out,2,6494
16,3,2012,The West Cornwall Pasty Company,Eating Out,4,6490
16,3,2012,Restaurant Gordon RamsayPortland Restaurant,Eating Out,27,6463
16,3,2012,ATM Cash Withdrawal,General,20,6443
17,3,2012,Restaurant Gordon RamsayPortland Restaurant,Eating Out,40,6403
18,3,2012,Anglo restaurant,Eating Out,29,6374
19,3,2012,South West Trains,Transport,24,6350
19,3,2012,Starbucks Coffee,Eating Out,2,6348
20,3,2012,VIRGIN MEDIA PYMTS,Bills,21,6327
20,3,2012,Caffe Nero,Eating Out,2,6325
20,3,2012,Subway,Eating Out,7,6318
21,3,2012,Wild Bean Cafe,Eating Out,1,6317
21,3,2012,McDonalds,Eating Out,4,6313
22,3,2012,Caffe Nero,Eating Out,2,6311
22,3,2012,McDonalds,Eating Out,8,6303
23,3,2012,Tescos,Groceries,73,6230
24,3,2012,O2,Bills,24,6206
24,3,2012,Scott's Restaurant,Eating Out,37,6169
25,3,2012,Pizza Express,Eating Out,52,6117
26,3,2012,South West Trains,Transport,25,6092
26,3,2012,Pret A Manger,Eating Out,7,6085
26,3,2012,Tool Shop,,9,6076
27,3,2012,Caffe Nero,Eating Out,2,6074
27,3,2012,Greggs,Eating Out,5,6069
28,3,2012,Caffe Nero,Eating Out,1,6068
28,3,2012,Paying back Julie,,8,6060
29,3,2012,Costa Coffee,Eating Out,2,6058
29,3,2012,Subway,Eating Out,4,6054
29,3,2012,ATM Cash Withdrawal,General,10,6044
30,3,2012,Sainsburys,Groceries,65,5979
30,3,2012,Caffe Nero,Eating Out,1,5978
30,3,2012,Pret A Manger,Eating Out,5,5973
30,3,2012,ATM Cash Withdrawal,General,10,5963
31,3,2012,Dominos Pizza,Eating Out,24,5939
31,3,2012,ATM Cash Withdrawal,General,20,5919
1,4,2012,Rhino Sports salary,General,1600,7519
1,4,2012,ATM Cash Withdrawal,General,10,7509
2,4,2012,South West Trains,Transport,23,7486
2,4,2012,Wild Bean Cafe,Eating Out,2,7484
2,4,2012,ATM Cash Withdrawal,General,10,7474
3,4,2012,Caffe Nero,Eating Out,2,7472
3,4,2012,Chicken Cottage,Eating Out,8,7464
4,4,2012,Caffe Nero,Eating Out,2,7462
4,4,2012,Chicken Cottage,Eating Out,8,7454
5,4,2012,Caffe Nero,Eating Out,2,7452
5,4,2012,Chicken Cottage,Eating Out,5,7447
5,4,2012,ATM Cash Withdrawal,General,10,7437
5,4,2012,Civic Shop,,6,7431
6,4,2012,ASDA,Groceries,44,7387
6,4,2012,Wild Bean Cafe,Eating Out,1,7386
6,4,2012,Subway,Eating Out,7,7379
6,4,2012,Pizza Express,Eating Out,53,7326
7,4,2012,Cubit and West rent,Rent,400,6926
7,4,2012,Dominos Pizza,Eating Out,35,6891
7,4,2012,ATM Cash Withdrawal,General,10,6881
8,4,2012,ATM Cash Withdrawal,General,20,6861
9,4,2012,South West Trains,Transport,19,6842
9,4,2012,Starbucks Coffee,Eating Out,2,6840
9,4,2012,Greggs,Eating Out,7,6833
10,4,2012,Starbucks Coffee,Eating Out,2,6831
11,4,2012,Caffe Nero,Eating Out,1,6830
11,4,2012,Greggs,Eating Out,8,6822
11,4,2012,ATM Cash Withdrawal,General,20,6802
12,4,2012,Costa Coffee,Eating Out,2,6800
12,4,2012,McDonalds,Eating Out,5,6795
13,4,2012,Sainsburys,Groceries,74,6721
13,4,2012,Wild Bean Cafe,Eating Out,2,6719
13,4,2012,Chicken Cottage,Eating Out,5,6714
13,4,2012,Scott's Restaurant,Eating Out,45,6669
15,4,2012,BRGAS-Electricity,Bills,26,6643
15,4,2012,BRGAS-Gas,Bills,22,6621
16,4,2012,LBS Council Tax,Bills,20,6601
16,4,2012,South West Trains,Transport,24,6577
16,4,2012,Costa Coffee,Eating Out,2,6575
16,4,2012,Pret A Manger,Eating Out,8,6567
17,4,2012,McDonalds,Eating Out,4,6563
18,4,2012,Caffe Nero,Eating Out,2,6561
18,4,2012,The West Cornwall Pasty Company,Eating Out,5,6556
18,4,2012,ATM Cash Withdrawal,General,10,6546
18,4,2012,Red Shop,,6,6540
19,4,2012,Caffe Nero,Eating Out,2,6538
19,4,2012,Pret A Manger,Eating Out,7,6531
20,4,2012,VIRGIN MEDIA PYMTS,Bills,19,6512
20,4,2012,ASDA,Groceries,46,6466
20,4,2012,Caffe Nero,Eating Out,1,6465
20,4,2012,McDonalds,Eating Out,6,6459
20,4,2012,Pizza Express,Eating Out,25,6434
21,4,2012,Scott's Restaurant,Eating Out,34,6400
22,4,2012,ATM Cash Withdrawal,General,10,6390
23,4,2012,South West Trains,Transport,16,6374
23,4,2012,Pret A Manger,Eating Out,6,6368
23,4,2012,ATM Cash Withdrawal,General,10,6358
24,4,2012,O2,Bills,23,6335
24,4,2012,Caffe Nero,Eating Out,1,6334
24,4,2012,Subway,Eating Out,8,6326
25,4,2012,Subway,Eating Out,6,6320
25,4,2012,ATM Cash Withdrawal,General,20,6300
26,4,2012,Pret A Manger,Eating Out,5,6295
27,4,2012,Morrisons,Groceries,54,6241
27,4,2012,Caffe Nero,Eating Out,2,6239
27,4,2012,The West Cornwall Pasty Company,Eating Out,5,6234
27,4,2012,Anglo restaurant,Eating Out,35,6199
27,4,2012,Red Shop,,1,6198
28,4,2012,Pizza Express,Eating Out,42,6156
28,4,2012,ATM Cash Withdrawal,General,20,6136
29,4,2012,Anglo restaurant,Eating Out,41,6095
29,4,2012,ATM Cash Withdrawal,General,10,6085
30,4,2012,South West Trains,Transport,25,6060
30,4,2012,Wild Bean Cafe,Eating Out,1,6059
30,4,2012,Subway,Eating Out,7,6052
30,4,2012,ATM Cash Withdrawal,General,10,6042
1,5,2012,Rhino Sports salary,General,1600,7642
1,5,2012,Subway,Eating Out,4,7638
1,5,2012,ATM Cash Withdrawal,General,10,7628
2,5,2012,Caffe Nero,Eating Out,2,7626
2,5,2012,The West Cornwall Pasty Company,Eating Out,6,7620
2,5,2012,ATM Cash Withdrawal,General,10,7610
3,5,2012,Costa Coffee,Eating Out,2,7608
3,5,2012,Chicken Cottage,Eating Out,8,7600
4,5,2012,Waitrose,Groceries,63,7537
4,5,2012,Greggs,Eating Out,8,7529
4,5,2012,Restaurant Gordon RamsayPortland Restaurant,Eating Out,25,7504
4,5,2012,ATM Cash Withdrawal,General,10,7494
5,5,2012,The Grand Pub,Eating Out,10,7484
5,5,2012,The Grand Pub,Eating Out,16,7468
6,5,2012,Restaurant Gordon RamsayPortland Restaurant,Eating Out,30,7438
6,5,2012,Cheam Service Station,,3,7435
7,5,2012,Cubit and West rent,Rent,400,7035
7,5,2012,South West Trains,Transport,20,7015
7,5,2012,Costa Coffee,Eating Out,2,7013
7,5,2012,McDonalds,Eating Out,4,7009
7,5,2012,ATM Cash Withdrawal,General,20,6989
8,5,2012,Starbucks Coffee,Eating Out,2,6987
9,5,2012,Wild Bean Cafe,Eating Out,2,6985
9,5,2012,Pret A Manger,Eating Out,6,6979
9,5,2012,ATM Cash Withdrawal,General,20,6959
10,5,2012,Subway,Eating Out,8,6951
11,5,2012,Tescos,Groceries,74,6877
11,5,2012,Wild Bean Cafe,Eating Out,2,6875
12,5,2012,Anglo restaurant,Eating Out,33,6842
14,5,2012,South West Trains,Transport,20,6822
14,5,2012,Wild Bean Cafe,Eating Out,2,6820
14,5,2012,ATM Cash Withdrawal,General,20,6800
14,5,2012,Cheam Service Station,,9,6791
15,5,2012,BRGAS-Electricity,Bills,21,6770
15,5,2012,BRGAS-Gas,Bills,19,6751
15,5,2012,Starbucks Coffee,Eating Out,2,6749
15,5,2012,ATM Cash Withdrawal,General,10,6739
16,5,2012,LBS Council Tax,Bills,20,6719
16,5,2012,Wild Bean Cafe,Eating Out,2,6717
16,5,2012,McDonalds,Eating Out,8,6709
16,5,2012,ATM Cash Withdrawal,General,10,6699
17,5,2012,Wild Bean Cafe,Eating Out,1,6698
17,5,2012,Greggs,Eating Out,5,6693
17,5,2012,ATM Cash Withdrawal,General,20,6673
18,5,2012,Sainsburys,Groceries,52,6621
18,5,2012,ATM Cash Withdrawal,General,20,6601
20,5,2012,VIRGIN MEDIA PYMTS,Bills,17,6584
21,5,2012,South West Trains,Transport,21,6563
21,5,2012,Costa Coffee,Eating Out,1,6562
21,5,2012,McDonalds,Eating Out,4,6558
22,5,2012,Caffe Nero,Eating Out,2,6556
22,5,2012,ATM Cash Withdrawal,General,10,6546
23,5,2012,Costa Coffee,Eating Out,2,6544
23,5,2012,Chicken Cottage,Eating Out,4,6540
23,5,2012,Tool Shop,,9,6531
24,5,2012,O2,Bills,24,6507
24,5,2012,Costa Coffee,Eating Out,2,6505
24,5,2012,The West Cornwall Pasty Company,Eating Out,6,6499
25,5,2012,Waitrose,Groceries,44,6455
25,5,2012,Starbucks Coffee,Eating Out,2,6453
26,5,2012,The Grand Pub,Eating Out,16,6437
26,5,2012,The Grand Pub,Eating Out,11,6426
27,5,2012,Pizza Express,Eating Out,32,6394
27,5,2012,ATM Cash Withdrawal,General,10,6384
28,5,2012,South West Trains,Transport,25,6359
28,5,2012,Costa Coffee,Eating Out,2,6357
28,5,2012,Pret A Manger,Eating Out,8,6349
28,5,2012,Tool Shop,,8,6341
29,5,2012,Starbucks Coffee,Eating Out,1,6340
29,5,2012,McDonalds,Eating Out,7,6333
30,5,2012,Wild Bean Cafe,Eating Out,1,6332
30,5,2012,ATM Cash Withdrawal,General,10,6322
30,5,2012,Paying back Julie,,3,6319
31,5,2012,Wild Bean Cafe,Eating Out,2,6317
31,5,2012,Subway,Eating Out,4,6313
31,5,2012,ATM Cash Withdrawal,General,20,6293
1,6,2012,Rhino Sports salary,General,1600,7893
1,6,2012,Sainsburys,Groceries,53,7840
1,6,2012,Starbucks Coffee,Eating Out,2,7838
1,6,2012,Dominos Pizza,Eating Out,43,7795
3,6,2012,Scott's Restaurant,Eating Out,39,7756
3,6,2012,ATM Cash Withdrawal,General,10,7746
3,6,2012,Cheam Service Station,,1,7745
4,6,2012,South West Trains,Transport,19,7726
4,6,2012,The West Cornwall Pasty Company,Eating Out,5,7721
5,6,2012,Starbucks Coffee,Eating Out,2,7719
5,6,2012,The West Cornwall Pasty Company,Eating Out,8,7711
6,6,2012,Starbucks Coffee,Eating Out,2,7709
6,6,2012,ATM Cash Withdrawal,General,20,7689
7,6,2012,Cubit and West rent,Rent,400,7289
7,6,2012,Costa Coffee,Eating Out,1,7288
7,6,2012,Subway,Eating Out,4,7284
8,6,2012,Waitrose,Groceries,41,7243
8,6,2012,Starbucks Coffee,Eating Out,2,7241
8,6,2012,Pret A Manger,Eating Out,5,7236
8,6,2012,ATM Cash Withdrawal,General,20,7216
11,6,2012,South West Trains,Transport,18,7198
11,6,2012,Greggs,Eating Out,8,7190
12,6,2012,Starbucks Coffee,Eating Out,1,7189
13,6,2012,Caffe Nero,Eating Out,2,7187
13,6,2012,ATM Cash Withdrawal,General,20,7167
14,6,2012,Wild Bean Cafe,Eating Out,1,7166
14,6,2012,Subway,Eating Out,8,7158
14,6,2012,Tool Shop,,4,7154
15,6,2012,BRGAS-Electricity,Bills,25,7129
15,6,2012,BRGAS-Gas,Bills,16,7113
15,6,2012,Morrisons,Groceries,73,7040
15,6,2012,Ministry of Sound ClubXOYO Club,Eating Out,10,7030
15,6,2012,Ministry of Sound ClubXOYO Club,Eating Out,13,7017
15,6,2012,Ministry of Sound ClubXOYO Club,Eating Out,10,7007
15,6,2012,Ministry of Sound ClubXOYO Club,Eating Out,10,6997
15,6,2012,Ministry of Sound ClubXOYO Club,Eating Out,12,6985
16,6,2012,LBS Council Tax,Bills,20,6965
18,6,2012,South West Trains,Transport,18,6947
18,6,2012,The West Cornwall Pasty Company,Eating Out,5,6942
19,6,2012,Starbucks Coffee,Eating Out,2,6940
19,6,2012,The West Cornwall Pasty Company,Eating Out,6,6934
20,6,2012,VIRGIN MEDIA PYMTS,Bills,28,6906
20,6,2012,Starbucks Coffee,Eating Out,2,6904
21,6,2012,Caffe Nero,Eating Out,2,6902
21,6,2012,ATM Cash Withdrawal,General,10,6892
22,6,2012,Sainsburys,Groceries,59,6833
22,6,2012,Costa Coffee,Eating Out,1,6832
23,6,2012,Civic Shop,,4,6828
24,6,2012,O2,Bills,23,6805
24,6,2012,ATM Cash Withdrawal,General,10,6795
25,6,2012,South West Trains,Transport,20,6775
25,6,2012,Caffe Nero,Eating Out,1,6774
25,6,2012,Greggs,Eating Out,8,6766
25,6,2012,ATM Cash Withdrawal,General,20,6746
26,6,2012,Pret A Manger,Eating Out,8,6738
27,6,2012,ATM Cash Withdrawal,General,10,6728
29,6,2012,Waitrose,Groceries,59,6669
29,6,2012,Costa Coffee,Eating Out,2,6667
29,6,2012,Chicken Cottage,Eating Out,5,6662
30,6,2012,Scott's Restaurant,Eating Out,26,6636
1,7,2012,Rhino Sports salary,General,1600,8236
1,7,2012,ATM Cash Withdrawal,General,10,8226
2,7,2012,South West Trains,Transport,18,8208
2,7,2012,The West Cornwall Pasty Company,Eating Out,7,8201
2,7,2012,ATM Cash Withdrawal,General,20,8181
3,7,2012,Costa Coffee,Eating Out,2,8179
4,7,2012,Caffe Nero,Eating Out,2,8177
4,7,2012,The West Cornwall Pasty Company,Eating Out,6,8171
5,7,2012,Greggs,Eating Out,4,8167
6,7,2012,Tescos,Groceries,36,8131
6,7,2012,Fabric Club,Eating Out,12,8119
6,7,2012,Fabric Club,Eating Out,12,8107
6,7,2012,Fabric Club,Eating Out,11,8096
6,7,2012,Fabric Club,Eating Out,12,8084
6,7,2012,Fabric Club,Eating Out,10,8074
6,7,2012,Fabric Club,Eating Out,5,8069
6,7,2012,ATM Cash Withdrawal,General,10,8059
6,7,2012,Red Shop,,9,8050
7,7,2012,Cubit and West rent,Rent,400,7650
8,7,2012,ATM Cash Withdrawal,General,20,7630
9,7,2012,South West Trains,Transport,20,7610
9,7,2012,Caffe Nero,Eating Out,2,7608
9,7,2012,Pret A Manger,Eating Out,8,7600
10,7,2012,Wild Bean Cafe,Eating Out,2,7598
10,7,2012,Subway,Eating Out,7,7591
11,7,2012,Costa Coffee,Eating Out,2,7589
11,7,2012,McDonalds,Eating Out,6,7583
11,7,2012,ATM Cash Withdrawal,General,10,7573
12,7,2012,Starbucks Coffee,Eating Out,1,7572
12,7,2012,Greggs,Eating Out,5,7567
13,7,2012,Tescos,Groceries,46,7521
13,7,2012,Wild Bean Cafe,Eating Out,2,7519
13,7,2012,Restaurant Gordon RamsayPortland Restaurant,Eating Out,27,7492
13,7,2012,ATM Cash Withdrawal,General,20,7472
15,7,2012,BRGAS-Electricity,Bills,27,7445
15,7,2012,BRGAS-Gas,Bills,16,7429
15,7,2012,ATM Cash Withdrawal,General,20,7409
16,7,2012,LBS Council Tax,Bills,20,7389
16,7,2012,South West Trains,Transport,22,7367
17,7,2012,Subway,Eating Out,5,7362
17,7,2012,Cheam Service Station,,6,7356
18,7,2012,Costa Coffee,Eating Out,2,7354
18,7,2012,McDonalds,Eating Out,5,7349
19,7,2012,The West Cornwall Pasty Company,Eating Out,8,7341
19,7,2012,ATM Cash Withdrawal,General,20,7321
20,7,2012,VIRGIN MEDIA PYMTS,Bills,29,7292
20,7,2012,Waitrose,Groceries,69,7223
20,7,2012,Wild Bean Cafe,Eating Out,2,7221
20,7,2012,Ministry of Sound ClubXOYO Club,Eating Out,13,7208
20,7,2012,Paying back James,,4,7204
22,7,2012,ATM Cash Withdrawal,General,20,7184
23,7,2012,South West Trains,Transport,19,7165
23,7,2012,Starbucks Coffee,Eating Out,1,7164
23,7,2012,McDonalds,Eating Out,6,7158
23,7,2012,ATM Cash Withdrawal,General,20,7138
24,7,2012,O2,Bills,22,7116
24,7,2012,Costa Coffee,Eating Out,2,7114
24,7,2012,Chicken Cottage,Eating Out,5,7109
25,7,2012,Wild Bean Cafe,Eating Out,2,7107
25,7,2012,ATM Cash Withdrawal,General,10,7097
26,7,2012,Costa Coffee,Eating Out,2,7095
26,7,2012,The West Cornwall Pasty Company,Eating Out,8,7087
27,7,2012,Sainsburys,Groceries,37,7050
27,7,2012,Costa Coffee,Eating Out,1,7049
27,7,2012,Pret A Manger,Eating Out,4,7045
27,7,2012,Restaurant Gordon RamsayPortland Restaurant,Eating Out,27,7018
29,7,2012,ATM Cash Withdrawal,General,10,7008
30,7,2012,South West Trains,Transport,18,6990
30,7,2012,Costa Coffee,Eating Out,1,6989
31,7,2012,Starbucks Coffee,Eating Out,2,6987
31,7,2012,ATM Cash Withdrawal,General,20,6967
1,8,2012,Rhino Sports salary,General,1600,8567
1,8,2012,Wild Bean Cafe,Eating Out,2,8565
1,8,2012,Pret A Manger,Eating Out,5,8560
1,8,2012,ATM Cash Withdrawal,General,10,8550
1,8,2012,Tool Shop,,9,8541
2,8,2012,Wild Bean Cafe,Eating Out,2,8539
2,8,2012,The West Cornwall Pasty Company,Eating Out,5,8534
2,8,2012,ATM Cash Withdrawal,General,10,8524
3,8,2012,ASDA,Groceries,48,8476
3,8,2012,McDonalds,Eating Out,6,8470
4,8,2012,Fabric Club,Eating Out,16,8454
4,8,2012,Fabric Club,Eating Out,15,8439
4,8,2012,Fabric Club,Eating Out,16,8423
4,8,2012,Fabric Club,Eating Out,8,8415
4,8,2012,Anglo restaurant,Eating Out,51,8364
4,8,2012,ATM Cash Withdrawal,General,10,8354
6,8,2012,South West Trains,Transport,16,8338
6,8,2012,Caffe Nero,Eating Out,2,8336
6,8,2012,Chicken Cottage,Eating Out,7,8329
6,8,2012,ATM Cash Withdrawal,General,10,8319
7,8,2012,Cubit and West rent,Rent,400,7919
7,8,2012,Costa Coffee,Eating Out,2,7917
7,8,2012,Chicken Cottage,Eating Out,4,7913
8,8,2012,Caffe Nero,Eating Out,1,7912
8,8,2012,ATM Cash Withdrawal,General,20,7892
9,8,2012,Caffe Nero,Eating Out,2,7890
9,8,2012,Pret A Manger,Eating Out,6,7884
10,8,2012,Tescos,Groceries,42,7842
10,8,2012,Caffe Nero,Eating Out,1,7841
10,8,2012,Chicken Cottage,Eating Out,6,7835
11,8,2012,Restaurant Gordon RamsayPortland Restaurant,Eating Out,48,7787
12,8,2012,Anglo restaurant,Eating Out,27,7760
13,8,2012,South West Trains,Transport,25,7735
13,8,2012,Starbucks Coffee,Eating Out,1,7734
13,8,2012,Pret A Manger,Eating Out,4,7730
14,8,2012,Costa Coffee,Eating Out,2,7728
14,8,2012,Greggs,Eating Out,7,7721
14,8,2012,ATM Cash Withdrawal,General,10,7711
15,8,2012,BRGAS-Electricity,Bills,14,7697
15,8,2012,BRGAS-Gas,Bills,17,7680
15,8,2012,Wild Bean Cafe,Eating Out,2,7678
16,8,2012,LBS Council Tax,Bills,20,7658
16,8,2012,Starbucks Coffee,Eating Out,1,7657
16,8,2012,ATM Cash Withdrawal,General,10,7647
16,8,2012,Cheam Service Station,,5,7642
17,8,2012,Morrisons,Groceries,70,7572
17,8,2012,Wild Bean Cafe,Eating Out,2,7570
17,8,2012,Greggs,Eating Out,4,7566
19,8,2012,Dominos Pizza,Eating Out,54,7512
20,8,2012,VIRGIN MEDIA PYMTS,Bills,17,7495
20,8,2012,South West Trains,Transport,19,7476
20,8,2012,Starbucks Coffee,Eating Out,2,7474
21,8,2012,Starbucks Coffee,Eating Out,2,7472
21,8,2012,Pret A Manger,Eating Out,8,7464
22,8,2012,Caffe Nero,Eating Out,1,7463
22,8,2012,Greggs,Eating Out,8,7455
23,8,2012,Greggs,Eating Out,4,7451
24,8,2012,O2,Bills,21,7430
24,8,2012,Waitrose,Groceries,48,7382
24,8,2012,Wild Bean Cafe,Eating Out,2,7380
24,8,2012,Chicken Cottage,Eating Out,8,7372
24,8,2012,Heaven Club,Eating Out,16,7356
24,8,2012,Anglo restaurant,Eating Out,39,7317
24,8,2012,Paying back James,,4,7313
26,8,2012,ATM Cash Withdrawal,General,20,7293
27,8,2012,South West Trains,Transport,23,7270
27,8,2012,Starbucks Coffee,Eating Out,1,7269
27,8,2012,The West Cornwall Pasty Company,Eating Out,7,7262
28,8,2012,Wild Bean Cafe,Eating Out,1,7261
29,8,2012,Caffe Nero,Eating Out,1,7260
29,8,2012,Greggs,Eating Out,4,7256
29,8,2012,ATM Cash Withdrawal,General,10,7246
30,8,2012,Wild Bean Cafe,Eating Out,1,7245
30,8,2012,Subway,Eating Out,7,7238
31,8,2012,Sainsburys,Groceries,36,7202
31,8,2012,Starbucks Coffee,Eating Out,2,7200
31,8,2012,Greggs,Eating Out,6,7194
31,8,2012,Ministry of Sound ClubXOYO Club,Eating Out,6,7188
31,8,2012,Ministry of Sound ClubXOYO Club,Eating Out,5,7183
31,8,2012,Scott's Restaurant,Eating Out,53,7130
1,9,2012,Rhino Sports salary,General,1600,8730
1,9,2012,ATM Cash Withdrawal,General,20,8710
1,9,2012,Cheam Service Station,,4,8706
2,9,2012,Restaurant Gordon RamsayPortland Restaurant,Eating Out,35,8671
2,9,2012,Red Shop,,5,8666
3,9,2012,South West Trains,Transport,23,8643
4,9,2012,Starbucks Coffee,Eating Out,1,8642
4,9,2012,Greggs,Eating Out,8,8634
5,9,2012,Caffe Nero,Eating Out,1,8633
5,9,2012,Chicken Cottage,Eating Out,6,8627
5,9,2012,ATM Cash Withdrawal,General,20,8607
5,9,2012,Paying back James,,9,8598
6,9,2012,Chicken Cottage,Eating Out,7,8591
7,9,2012,Cubit and West rent,Rent,400,8191
7,9,2012,Waitrose,Groceries,57,8134
7,9,2012,Caffe Nero,Eating Out,2,8132
7,9,2012,ATM Cash Withdrawal,General,20,8112
8,9,2012,The Grand Pub,Eating Out,14,8098
8,9,2012,The Grand Pub,Eating Out,14,8084
8,9,2012,The Grand Pub,Eating Out,7,8077
9,9,2012,Restaurant Gordon RamsayPortland Restaurant,Eating Out,57,8020
9,9,2012,ATM Cash Withdrawal,General,10,8010
10,9,2012,South West Trains,Transport,21,7989
10,9,2012,Caffe Nero,Eating Out,2,7987
10,9,2012,Subway,Eating Out,5,7982
11,9,2012,The West Cornwall Pasty Company,Eating Out,8,7974
12,9,2012,Starbucks Coffee,Eating Out,2,7972
12,9,2012,Greggs,Eating Out,4,7968
14,9,2012,ASDA,Groceries,49,7919
14,9,2012,Costa Coffee,Eating Out,1,7918
14,9,2012,Greggs,Eating Out,6,7912
14,9,2012,Ministry of Sound ClubXOYO Club,Eating Out,13,7899
14,9,2012,Ministry of Sound ClubXOYO Club,Eating Out,13,7886
14,9,2012,Ministry of Sound ClubXOYO Club,Eating Out,13,7873
14,9,2012,Ministry of Sound ClubXOYO Club,Eating Out,13,7860
14,9,2012,ATM Cash Withdrawal,General,20,7840
15,9,2012,BRGAS-Electricity,Bills,26,7814
15,9,2012,BRGAS-Gas,Bills,20,7794
16,9,2012,LBS Council Tax,Bills,20,7774
16,9,2012,Dominos Pizza,Eating Out,34,7740
16,9,2012,ATM Cash Withdrawal,General,10,7730
17,9,2012,South West Trains,Transport,25,7705
17,9,2012,Starbucks Coffee,Eating Out,2,7703
17,9,2012,Subway,Eating Out,8,7695
17,9,2012,Tool Tec,,1,7694
18,9,2012,Starbucks Coffee,Eating Out,2,7692
18,9,2012,The West Cornwall Pasty Company,Eating Out,8,7684
18,9,2012,ATM Cash Withdrawal,General,10,7674
19,9,2012,Wild Bean Cafe,Eating Out,2,7672
19,9,2012,Chicken Cottage,Eating Out,8,7664
20,9,2012,VIRGIN MEDIA PYMTS,Bills,14,7650
20,9,2012,Starbucks Coffee,Eating Out,1,7649
20,9,2012,McDonalds,Eating Out,5,7644
21,9,2012,ASDA,Groceries,70,7574
21,9,2012,Wild Bean Cafe,Eating Out,2,7572
21,9,2012,Chicken Cottage,Eating Out,4,7568
21,9,2012,ATM Cash Withdrawal,General,10,7558
22,9,2012,The Grand Pub,Eating Out,7,7551
22,9,2012,The Grand Pub,Eating Out,15,7536
22,9,2012,The Grand Pub,Eating Out,13,7523
22,9,2012,The Grand Pub,Eating Out,12,7511
22,9,2012,The Grand Pub,Eating Out,9,7502
22,9,2012,ATM Cash Withdrawal,General,20,7482
24,9,2012,O2,Bills,24,7458
24,9,2012,South West Trains,Transport,20,7438
24,9,2012,The West Cornwall Pasty Company,Eating Out,7,7431
25,9,2012,Starbucks Coffee,Eating Out,2,7429
25,9,2012,ATM Cash Withdrawal,General,10,7419
26,9,2012,Chicken Cottage,Eating Out,4,7415
27,9,2012,The West Cornwall Pasty Company,Eating Out,7,7408
28,9,2012,Sainsburys,Groceries,35,7373
28,9,2012,Caffe Nero,Eating Out,2,7371
28,9,2012,Scott's Restaurant,Eating Out,35,7336
30,9,2012,Scott's Restaurant,Eating Out,44,7292
1,10,2012,Rhino Sports salary,General,1600,8892
1,10,2012,South West Trains,Transport,21,8871
1,10,2012,Pret A Manger,Eating Out,6,8865
2,10,2012,The West Cornwall Pasty Company,Eating Out,4,8861
3,10,2012,Costa Coffee,Eating Out,1,8860
4,10,2012,ATM Cash Withdrawal,General,10,8850
4,10,2012,Tool Tec,,8,8842
5,10,2012,Morrisons,Groceries,52,8790
5,10,2012,Starbucks Coffee,Eating Out,2,8788
5,10,2012,McDonalds,Eating Out,6,8782
5,10,2012,Paying back Julie,,1,8781
7,10,2012,Cubit and West rent,Rent,400,8381
8,10,2012,South West Trains,Transport,17,8364
8,10,2012,Wild Bean Cafe,Eating Out,1,8363
8,10,2012,The West Cornwall Pasty Company,Eating Out,5,8358
8,10,2012,ATM Cash Withdrawal,General,10,8348
9,10,2012,Starbucks Coffee,Eating Out,2,8346
9,10,2012,Greggs,Eating Out,5,8341
9,10,2012,Paying back James,,5,8336
10,10,2012,Starbucks Coffee,Eating Out,1,8335
10,10,2012,ATM Cash Withdrawal,General,10,8325
11,10,2012,Wild Bean Cafe,Eating Out,1,8324
11,10,2012,Subway,Eating Out,5,8319
12,10,2012,Tescos,Groceries,62,8257
12,10,2012,Wild Bean Cafe,Eating Out,2,8255
12,10,2012,Subway,Eating Out,5,8250
14,10,2012,ATM Cash Withdrawal,General,20,8230
14,10,2012,Paying back Julie,,5,8225
15,10,2012,BRGAS-Electricity,Bills,20,8205
15,10,2012,BRGAS-Gas,Bills,27,8178
15,10,2012,South West Trains,Transport,18,8160
15,10,2012,Starbucks Coffee,Eating Out,2,8158
15,10,2012,McDonalds,Eating Out,7,8151
16,10,2012,LBS Council Tax,Bills,20,8131
16,10,2012,Starbucks Coffee,Eating Out,1,8130
16,10,2012,Pret A Manger,Eating Out,6,8124
16,10,2012,ATM Cash Withdrawal,General,20,8104
17,10,2012,Caffe Nero,Eating Out,2,8102
17,10,2012,Subway,Eating Out,5,8097
18,10,2012,Wild Bean Cafe,Eating Out,2,8095
18,10,2012,Subway,Eating Out,8,8087
18,10,2012,ATM Cash Withdrawal,General,10,8077
18,10,2012,Red Shop,,8,8069
19,10,2012,Sainsburys,Groceries,74,7995
19,10,2012,McDonalds,Eating Out,8,7987
19,10,2012,The Grand Pub,Eating Out,5,7982
19,10,2012,The Grand Pub,Eating Out,5,7977
19,10,2012,The Grand Pub,Eating Out,5,7972
19,10,2012,The Grand Pub,Eating Out,12,7960
19,10,2012,ATM Cash Withdrawal,General,10,7950
20,10,2012,VIRGIN MEDIA PYMTS,Bills,18,7932
20,10,2012,The Grand Pub,Eating Out,9,7923
20,10,2012,The Grand Pub,Eating Out,11,7912
21,10,2012,ATM Cash Withdrawal,General,10,7902
22,10,2012,South West Trains,Transport,25,7877
22,10,2012,Starbucks Coffee,Eating Out,2,7875
22,10,2012,Pret A Manger,Eating Out,6,7869
23,10,2012,Wild Bean Cafe,Eating Out,2,7867
23,10,2012,Chicken Cottage,Eating Out,8,7859
24,10,2012,O2,Bills,22,7837
24,10,2012,Wild Bean Cafe,Eating Out,1,7836
25,10,2012,McDonalds,Eating Out,6,7830
26,10,2012,Sainsburys,Groceries,48,7782
26,10,2012,Starbucks Coffee,Eating Out,2,7780
27,10,2012,Fabric Club,Eating Out,10,7770
27,10,2012,Fabric Club,Eating Out,15,7755
27,10,2012,Fabric Club,Eating Out,11,7744
27,10,2012,Anglo restaurant,Eating Out,43,7701
28,10,2012,Restaurant Gordon RamsayPortland Restaurant,Eating Out,56,7645
29,10,2012,South West Trains,Transport,18,7627
29,10,2012,Starbucks Coffee,Eating Out,2,7625
30,10,2012,Wild Bean Cafe,Eating Out,2,7623
30,10,2012,Pret A Manger,Eating Out,8,7615
31,10,2012,Costa Coffee,Eating Out,2,7613
1,11,2012,Rhino Sports salary,General,1600,9213
1,11,2012,Caffe Nero,Eating Out,2,9211
1,11,2012,Greggs,Eating Out,8,9203
1,11,2012,ATM Cash Withdrawal,General,10,9193
2,11,2012,Waitrose,Groceries,37,9156
2,11,2012,Costa Coffee,Eating Out,2,9154
2,11,2012,Chicken Cottage,Eating Out,4,9150
2,11,2012,ATM Cash Withdrawal,General,10,9140
3,11,2012,Scott's Restaurant,Eating Out,51,9089
3,11,2012,ATM Cash Withdrawal,General,20,9069
3,11,2012,Cheam Service Station,,4,9065
5,11,2012,South West Trains,Transport,18,9047
5,11,2012,Pret A Manger,Eating Out,8,9039
5,11,2012,Tool Tec,,9,9030
6,11,2012,Greggs,Eating Out,4,9026
7,11,2012,Cubit and West rent,Rent,400,8626
7,11,2012,Costa Coffee,Eating Out,2,8624
7,11,2012,McDonalds,Eating Out,4,8620
7,11,2012,Paying back Julie,,6,8614
8,11,2012,Costa Coffee,Eating Out,2,8612
9,11,2012,Sainsburys,Groceries,59,8553
9,11,2012,Starbucks Coffee,Eating Out,2,8551
9,11,2012,ATM Cash Withdrawal,General,10,8541
10,11,2012,Scott's Restaurant,Eating Out,24,8517
12,11,2012,South West Trains,Transport,17,8500
12,11,2012,Wild Bean Cafe,Eating Out,1,8499
12,11,2012,Pret A Manger,Eating Out,7,8492
13,11,2012,Starbucks Coffee,Eating Out,1,8491
13,11,2012,The West Cornwall Pasty Company,Eating Out,7,8484
14,11,2012,Wild Bean Cafe,Eating Out,1,8483
15,11,2012,BRGAS-Electricity,Bills,23,8460
15,11,2012,BRGAS-Gas,Bills,27,8433
15,11,2012,Wild Bean Cafe,Eating Out,1,8432
16,11,2012,LBS Council Tax,Bills,20,8412
16,11,2012,Tescos,Groceries,61,8351
16,11,2012,Starbucks Coffee,Eating Out,2,8349
16,11,2012,The West Cornwall Pasty Company,Eating Out,5,8344
16,11,2012,Scott's Restaurant,Eating Out,58,8286
17,11,2012,Scott's Restaurant,Eating Out,55,8231
17,11,2012,ATM Cash Withdrawal,General,10,8221
19,11,2012,South West Trains,Transport,25,8196
19,11,2012,Caffe Nero,Eating Out,2,8194
19,11,2012,Greggs,Eating Out,7,8187
19,11,2012,ATM Cash Withdrawal,General,20,8167
20,11,2012,VIRGIN MEDIA PYMTS,Bills,26,8141
20,11,2012,Wild Bean Cafe,Eating Out,1,8140
23,11,2012,Morrisons,Groceries,63,8077
23,11,2012,Costa Coffee,Eating Out,1,8076
24,11,2012,O2,Bills,25,8051
26,11,2012,South West Trains,Transport,16,8035
26,11,2012,Pret A Manger,Eating Out,7,8028
27,11,2012,Starbucks Coffee,Eating Out,2,8026
28,11,2012,Costa Coffee,Eating Out,2,8024
28,11,2012,Subway,Eating Out,6,8018
29,11,2012,Wild Bean Cafe,Eating Out,2,8016
29,11,2012,Greggs,Eating Out,5,8011
29,11,2012,Paying back Julie,,7,8004
30,11,2012,Sainsburys,Groceries,40,7964
30,11,2012,Starbucks Coffee,Eating Out,2,7962
30,11,2012,The West Cornwall Pasty Company,Eating Out,5,7957
1,12,2012,Rhino Sports salary,General,1600,9557
1,12,2012,Restaurant Gordon RamsayPortland Restaurant,Eating Out,57,9500
1,12,2012,ATM Cash Withdrawal,General,10,9490
2,12,2012,ATM Cash Withdrawal,General,20,9470
3,12,2012,South West Trains,Transport,19,9451
3,12,2012,Wild Bean Cafe,Eating Out,1,9450
4,12,2012,Wild Bean Cafe,Eating Out,1,9449
4,12,2012,The West Cornwall Pasty Company,Eating Out,6,9443
5,12,2012,McDonalds,Eating Out,8,9435
6,12,2012,Costa Coffee,Eating Out,1,9434
6,12,2012,Subway,Eating Out,6,9428
7,12,2012,Cubit and West rent,Rent,400,9028
7,12,2012,Sainsburys,Groceries,74,8954
7,12,2012,Caffe Nero,Eating Out,2,8952
7,12,2012,Subway,Eating Out,7,8945
8,12,2012,ATM Cash Withdrawal,General,20,8925
9,12,2012,ATM Cash Withdrawal,General,10,8915
10,12,2012,South West Trains,Transport,22,8893
10,12,2012,McDonalds,Eating Out,4,8889
11,12,2012,Costa Coffee,Eating Out,1,8888
11,12,2012,McDonalds,Eating Out,4,8884
12,12,2012,Starbucks Coffee,Eating Out,2,8882
13,12,2012,Starbucks Coffee,Eating Out,1,8881
13,12,2012,ATM Cash Withdrawal,General,10,8871
14,12,2012,Morrisons,Groceries,56,8815
14,12,2012,Starbucks Coffee,Eating Out,2,8813
14,12,2012,Chicken Cottage,Eating Out,8,8805
14,12,2012,ATM Cash Withdrawal,General,20,8785
15,12,2012,BRGAS-Electricity,Bills,29,8756
15,12,2012,BRGAS-Gas,Bills,25,8731
15,12,2012,Ministry of Sound ClubXOYO Club,Eating Out,15,8716
15,12,2012,Ministry of Sound ClubXOYO Club,Eating Out,9,8707
16,12,2012,LBS Council Tax,Bills,20,8687
16,12,2012,ATM Cash Withdrawal,General,10,8677
17,12,2012,South West Trains,Transport,24,8653
17,12,2012,Wild Bean Cafe,Eating Out,1,8652
17,12,2012,Chicken Cottage,Eating Out,7,8645
17,12,2012,Tool Shop,,1,8644
18,12,2012,Caffe Nero,Eating Out,2,8642
18,12,2012,McDonalds,Eating Out,8,8634
19,12,2012,Costa Coffee,Eating Out,2,8632
19,12,2012,Chicken Cottage,Eating Out,7,8625
19,12,2012,ATM Cash Withdrawal,General,10,8615
19,12,2012,Civic Shop,,3,8612
20,12,2012,VIRGIN MEDIA PYMTS,Bills,23,8589
20,12,2012,Costa Coffee,Eating Out,1,8588
20,12,2012,The West Cornwall Pasty Company,Eating Out,7,8581
20,12,2012,ATM Cash Withdrawal,General,10,8571
21,12,2012,Tescos,Groceries,59,8512
21,12,2012,Caffe Nero,Eating Out,2,8510
21,12,2012,Pret A Manger,Eating Out,7,8503
23,12,2012,Pizza Express,Eating Out,38,8465
24,12,2012,O2,Bills,24,8441
24,12,2012,South West Trains,Transport,24,8417
24,12,2012,Greggs,Eating Out,6,8411
25,12,2012,Costa Coffee,Eating Out,2,8409
26,12,2012,Caffe Nero,Eating Out,2,8407
26,12,2012,ATM Cash Withdrawal,General,10,8397
27,12,2012,McDonalds,Eating Out,7,8390
28,12,2012,ASDA,Groceries,59,8331
28,12,2012,Caffe Nero,Eating Out,2,8329
28,12,2012,Greggs,Eating Out,4,8325
28,12,2012,Heaven Club,Eating Out,15,8310
31,12,2012,South West Trains,Transport,25,8285
31,12,2012,Caffe Nero,Eating Out,2,8283
31,12,2012,Chicken Cottage,Eating Out,5,8278
31,12,2012,ATM Cash Withdrawal,General,10,8268
1,1,2013,Rhino Sports salary,General,1600,9868
1,1,2013,Wild Bean Cafe,Eating Out,2,9866
1,1,2013,Greggs,Eating Out,4,9862
2,1,2013,The West Cornwall Pasty Company,Eating Out,5,9857
2,1,2013,ATM Cash Withdrawal,General,10,9847
3,1,2013,Costa Coffee,Eating Out,1,9846
3,1,2013,The West Cornwall Pasty Company,Eating Out,4,9842
3,1,2013,ATM Cash Withdrawal,General,20,9822
4,1,2013,Tescos,Groceries,73,9749
5,1,2013,Ministry of Sound ClubXOYO Club,Eating Out,6,9743
5,1,2013,Ministry of Sound ClubXOYO Club,Eating Out,11,9732
5,1,2013,Ministry of Sound ClubXOYO Club,Eating Out,9,9723
5,1,2013,Ministry of Sound ClubXOYO Club,Eating Out,10,9713
5,1,2013,Ministry of Sound ClubXOYO Club,Eating Out,6,9707
5,1,2013,Ministry of Sound ClubXOYO Club,Eating Out,15,9692
7,1,2013,Cubit and West rent,Rent,400,9292
7,1,2013,South West Trains,Transport,21,9271
7,1,2013,Pret A Manger,Eating Out,5,9266
8,1,2013,Subway,Eating Out,7,9259
8,1,2013,ATM Cash Withdrawal,General,20,9239
9,1,2013,Costa Coffee,Eating Out,1,9238
9,1,2013,McDonalds,Eating Out,6,9232
10,1,2013,Starbucks Coffee,Eating Out,2,9230
11,1,2013,ASDA,Groceries,73,9157
11,1,2013,Caffe Nero,Eating Out,2,9155
11,1,2013,ATM Cash Withdrawal,General,20,9135
14,1,2013,South West Trains,Transport,22,9113
14,1,2013,Wild Bean Cafe,Eating Out,2,9111
14,1,2013,Subway,Eating Out,6,9105
15,1,2013,BRGAS-Electricity,Bills,43,9062
15,1,2013,BRGAS-Gas,Bills,37,9025
15,1,2013,Greggs,Eating Out,5,9020
15,1,2013,ATM Cash Withdrawal,General,10,9010
16,1,2013,LBS Council Tax,Bills,20,8990
16,1,2013,Starbucks Coffee,Eating Out,1,8989
16,1,2013,The West Cornwall Pasty Company,Eating Out,6,8983
16,1,2013,ATM Cash Withdrawal,General,10,8973
16,1,2013,Civic Shop,,9,8964
17,1,2013,Starbucks Coffee,Eating Out,2,8962
17,1,2013,The West Cornwall Pasty Company,Eating Out,8,8954
18,1,2013,Waitrose,Groceries,41,8913
18,1,2013,Costa Coffee,Eating Out,1,8912
18,1,2013,Pret A Manger,Eating Out,7,8905
18,1,2013,Cheam Service Station,,5,8900
19,1,2013,Dominos Pizza,Eating Out,46,8854
20,1,2013,VIRGIN MEDIA PYMTS,Bills,25,8829
21,1,2013,South West Trains,Transport,18,8811
21,1,2013,Chicken Cottage,Eating Out,5,8806
21,1,2013,ATM Cash Withdrawal,General,20,8786
21,1,2013,Red Shop,,8,8778
22,1,2013,Starbucks Coffee,Eating Out,2,8776
22,1,2013,Cheam Service Station,,7,8769
23,1,2013,Greggs,Eating Out,6,8763
24,1,2013,O2,Bills,23,8740
24,1,2013,Caffe Nero,Eating Out,2,8738
24,1,2013,McDonalds,Eating Out,8,8730
25,1,2013,Morrisons,Groceries,57,8673
25,1,2013,Caffe Nero,Eating Out,2,8671
25,1,2013,Scott's Restaurant,Eating Out,43,8628
28,1,2013,South West Trains,Transport,22,8606
28,1,2013,Caffe Nero,Eating Out,1,8605
29,1,2013,Subway,Eating Out,6,8599
30,1,2013,Starbucks Coffee,Eating Out,1,8598
30,1,2013,Chicken Cottage,Eating Out,8,8590
30,1,2013,ATM Cash Withdrawal,General,20,8570
30,1,2013,Paying back James,,4,8566
31,1,2013,Caffe Nero,Eating Out,2,8564
31,1,2013,The West Cornwall Pasty Company,Eating Out,4,8560
1,2,2013,Rhino Sports salary,General,1600,10160
1,2,2013,Morrisons,Groceries,63,10097
1,2,2013,Pret A Manger,Eating Out,4,10093
1,2,2013,Restaurant Gordon RamsayPortland Restaurant,Eating Out,30,10063
4,2,2013,South West Trains,Transport,23,10040
4,2,2013,Costa Coffee,Eating Out,1,10039
4,2,2013,McDonalds,Eating Out,7,10032
5,2,2013,Costa Coffee,Eating Out,1,10031
6,2,2013,Wild Bean Cafe,Eating Out,2,10029
7,2,2013,Cubit and West rent,Rent,400,9629
7,2,2013,Caffe Nero,Eating Out,2,9627
7,2,2013,Chicken Cottage,Eating Out,8,9619
8,2,2013,ASDA,Groceries,54,9565
8,2,2013,Caffe Nero,Eating Out,1,9564
8,2,2013,Greggs,Eating Out,6,9558
9,2,2013,Dominos Pizza,Eating Out,41,9517
11,2,2013,South West Trains,Transport,23,9494
11,2,2013,Caffe Nero,Eating Out,1,9493
11,2,2013,Subway,Eating Out,6,9487
12,2,2013,Starbucks Coffee,Eating Out,2,9485
12,2,2013,The West Cornwall Pasty Company,Eating Out,8,9477
13,2,2013,Caffe Nero,Eating Out,2,9475
13,2,2013,Pret A Manger,Eating Out,4,9471
13,2,2013,ATM Cash Withdrawal,General,20,9451
14,2,2013,Costa Coffee,Eating Out,2,9449
14,2,2013,McDonalds,Eating Out,8,9441
14,2,2013,ATM Cash Withdrawal,General,20,9421
15,2,2013,BRGAS-Electricity,Bills,25,9396
15,2,2013,BRGAS-Gas,Bills,25,9371
15,2,2013,Morrisons,Groceries,36,9335
15,2,2013,Anglo restaurant,Eating Out,24,9311
16,2,2013,LBS Council Tax,Bills,20,9291
16,2,2013,Fabric Club,Eating Out,8,9283
16,2,2013,Fabric Club,Eating Out,7,9276
16,2,2013,Fabric Club,Eating Out,9,9267
16,2,2013,Fabric Club,Eating Out,16,9251
16,2,2013,Fabric Club,Eating Out,5,9246
16,2,2013,Fabric Club,Eating Out,12,9234
16,2,2013,Restaurant Gordon RamsayPortland Restaurant,Eating Out,47,9187
17,2,2013,Anglo restaurant,Eating Out,35,9152
18,2,2013,South West Trains,Transport,23,9129
18,2,2013,Costa Coffee,Eating Out,1,9128
18,2,2013,Greggs,Eating Out,5,9123
18,2,2013,Paying back James,,9,9114
19,2,2013,Costa Coffee,Eating Out,2,9112
20,2,2013,VIRGIN MEDIA PYMTS,Bills,20,9092
20,2,2013,Costa Coffee,Eating Out,1,9091
20,2,2013,Pret A Manger,Eating Out,6,9085
20,2,2013,Civic Shop,,4,9081
21,2,2013,Chicken Cottage,Eating Out,4,9077
21,2,2013,ATM Cash Withdrawal,General,10,9067
22,2,2013,Morrisons,Groceries,68,8999
22,2,2013,Costa Coffee,Eating Out,1,8998
24,2,2013,O2,Bills,22,8976
24,2,2013,Scott's Restaurant,Eating Out,28,8948
25,2,2013,South West Trains,Transport,24,8924
26,2,2013,Wild Bean Cafe,Eating Out,2,8922
26,2,2013,ATM Cash Withdrawal,General,20,8902
26,2,2013,Paying back James,,5,8897
27,2,2013,Wild Bean Cafe,Eating Out,2,8895
27,2,2013,Subway,Eating Out,6,8889
27,2,2013,ATM Cash Withdrawal,General,20,8869
28,2,2013,Costa Coffee,Eating Out,2,8867
28,2,2013,The West Cornwall Pasty Company,Eating Out,8,8859
1,3,2013,Rhino Sports salary,General,1600,10459
1,3,2013,Morrisons,Groceries,46,10413
1,3,2013,Costa Coffee,Eating Out,1,10412
1,3,2013,Subway,Eating Out,6,10406
1,3,2013,Heaven Club,Eating Out,11,10395
1,3,2013,Heaven Club,Eating Out,16,10379
1,3,2013,Heaven Club,Eating Out,7,10372
1,3,2013,Heaven Club,Eating Out,5,10367
1,3,2013,Scott's Restaurant,Eating Out,31,10336
3,3,2013,Restaurant Gordon RamsayPortland Restaurant,Eating Out,25,10311
3,3,2013,ATM Cash Withdrawal,General,20,10291
4,3,2013,South West Trains,Transport,24,10267
4,3,2013,Caffe Nero,Eating Out,1,10266
4,3,2013,The West Cornwall Pasty Company,Eating Out,5,10261
5,3,2013,Subway,Eating Out,6,10255
5,3,2013,ATM Cash Withdrawal,General,10,10245
6,3,2013,Caffe Nero,Eating Out,1,10244
7,3,2013,Cubit and West rent,Rent,400,9844
7,3,2013,Pret A Manger,Eating Out,4,9840
8,3,2013,Morrisons,Groceries,50,9790
8,3,2013,The Grand Pub,Eating Out,16,9774
8,3,2013,The Grand Pub,Eating Out,7,9767
9,3,2013,ATM Cash Withdrawal,General,20,9747
10,3,2013,ATM Cash Withdrawal,General,10,9737
11,3,2013,South West Trains,Transport,21,9716
11,3,2013,Starbucks Coffee,Eating Out,2,9714
12,3,2013,Caffe Nero,Eating Out,1,9713
12,3,2013,Chicken Cottage,Eating Out,6,9707
13,3,2013,Wild Bean Cafe,Eating Out,1,9706
14,3,2013,Caffe Nero,Eating Out,2,9704
14,3,2013,Paying back James,,5,9699
15,3,2013,BRGAS-Electricity,Bills,14,9685
15,3,2013,BRGAS-Gas,Bills,22,9663
15,3,2013,Sainsburys,Groceries,49,9614
15,3,2013,Subway,Eating Out,5,9609
16,3,2013,LBS Council Tax,Bills,20,9589
18,3,2013,South West Trains,Transport,23,9566
18,3,2013,Starbucks Coffee,Eating Out,2,9564
19,3,2013,Costa Coffee,Eating Out,1,9563
19,3,2013,McDonalds,Eating Out,6,9557
19,3,2013,Paying back Julie,,9,9548
20,3,2013,VIRGIN MEDIA PYMTS,Bills,23,9525
20,3,2013,McDonalds,Eating Out,5,9520
22,3,2013,Sainsburys,Groceries,56,9464
22,3,2013,Costa Coffee,Eating Out,2,9462
22,3,2013,ATM Cash Withdrawal,General,20,9442
23,3,2013,Dominos Pizza,Eating Out,41,9401
24,3,2013,O2,Bills,21,9380
25,3,2013,South West Trains,Transport,16,9364
25,3,2013,Wild Bean Cafe,Eating Out,1,9363
25,3,2013,Greggs,Eating Out,4,9359
25,3,2013,ATM Cash Withdrawal,General,10,9349
26,3,2013,Costa Coffee,Eating Out,2,9347
27,3,2013,Caffe Nero,Eating Out,2,9345
27,3,2013,Greggs,Eating Out,4,9341
27,3,2013,Cheam Service Station,,2,9339
28,3,2013,Costa Coffee,Eating Out,2,9337
28,3,2013,McDonalds,Eating Out,8,9329
29,3,2013,Sainsburys,Groceries,62,9267
29,3,2013,Subway,Eating Out,8,9259
1,4,2013,Rhino Sports salary,General,1600,10859
1,4,2013,South West Trains,Transport,21,10838
1,4,2013,Wild Bean Cafe,Eating Out,1,10837
1,4,2013,Greggs,Eating Out,7,10830
2,4,2013,Starbucks Coffee,Eating Out,2,10828
2,4,2013,Greggs,Eating Out,7,10821
3,4,2013,Costa Coffee,Eating Out,2,10819
3,4,2013,McDonalds,Eating Out,6,10813
4,4,2013,Wild Bean Cafe,Eating Out,1,10812
4,4,2013,ATM Cash Withdrawal,General,20,10792
5,4,2013,ASDA,Groceries,46,10746
5,4,2013,Caffe Nero,Eating Out,2,10744
5,4,2013,Pret A Manger,Eating Out,4,10740
6,4,2013,Ministry of Sound ClubXOYO Club,Eating Out,9,10731
6,4,2013,Ministry of Sound ClubXOYO Club,Eating Out,16,10715
6,4,2013,Ministry of Sound ClubXOYO Club,Eating Out,9,10706
7,4,2013,Cubit and West rent,Rent,400,10306
7,4,2013,Pizza Express,Eating Out,51,10255
7,4,2013,ATM Cash Withdrawal,General,20,10235
8,4,2013,South West Trains,Transport,16,10219
8,4,2013,McDonalds,Eating Out,6,10213
9,4,2013,Caffe Nero,Eating Out,2,10211
9,4,2013,ATM Cash Withdrawal,General,20,10191
10,4,2013,Starbucks Coffee,Eating Out,2,10189
10,4,2013,McDonalds,Eating Out,7,10182
10,4,2013,ATM Cash Withdrawal,General,20,10162
12,4,2013,Morrisons,Groceries,39,10123
12,4,2013,Starbucks Coffee,Eating Out,1,10122
12,4,2013,Subway,Eating Out,8,10114
12,4,2013,Scott's Restaurant,Eating Out,46,10068
13,4,2013,Fabric Club,Eating Out,11,10057
13,4,2013,Fabric Club,Eating Out,14,10043
13,4,2013,Tool Tec,,5,10038
14,4,2013,Dominos Pizza,Eating Out,39,9999
15,4,2013,BRGAS-Electricity,Bills,16,9983
15,4,2013,BRGAS-Gas,Bills,29,9954
15,4,2013,South West Trains,Transport,19,9935
15,4,2013,Costa Coffee,Eating Out,2,9933
15,4,2013,Greggs,Eating Out,7,9926
16,4,2013,LBS Council Tax,Bills,20,9906
16,4,2013,Caffe Nero,Eating Out,2,9904
16,4,2013,Paying back Julie,,6,9898
17,4,2013,Starbucks Coffee,Eating Out,1,9897
17,4,2013,McDonalds,Eating Out,5,9892
18,4,2013,Wild Bean Cafe,Eating Out,2,9890
19,4,2013,Waitrose,Groceries,49,9841
19,4,2013,Costa Coffee,Eating Out,2,9839
20,4,2013,VIRGIN MEDIA PYMTS,Bills,25,9814
22,4,2013,South West Trains,Transport,20,9794
22,4,2013,Wild Bean Cafe,Eating Out,1,9793
22,4,2013,McDonalds,Eating Out,5,9788
23,4,2013,Wild Bean Cafe,Eating Out,2,9786
23,4,2013,The West Cornwall Pasty Company,Eating Out,4,9782
24,4,2013,O2,Bills,23,9759
24,4,2013,Starbucks Coffee,Eating Out,1,9758
25,4,2013,Wild Bean Cafe,Eating Out,2,9756
25,4,2013,Chicken Cottage,Eating Out,8,9748
26,4,2013,Waitrose,Groceries,55,9693
26,4,2013,The West Cornwall Pasty Company,Eating Out,6,9687
28,4,2013,Pizza Express,Eating Out,55,9632
29,4,2013,South West Trains,Transport,25,9607
29,4,2013,Costa Coffee,Eating Out,2,9605
29,4,2013,McDonalds,Eating Out,5,9600
30,4,2013,Starbucks Coffee,Eating Out,1,9599
30,4,2013,Chicken Cottage,Eating Out,7,9592
1,5,2013,Rhino Sports salary,General,1600,11192
1,5,2013,Starbucks Coffee,Eating Out,1,11191
1,5,2013,McDonalds,Eating Out,6,11185
2,5,2013,Costa Coffee,Eating Out,1,11184
3,5,2013,Morrisons,Groceries,42,11142
3,5,2013,Caffe Nero,Eating Out,1,11141
3,5,2013,The West Cornwall Pasty Company,Eating Out,4,11137
4,5,2013,Restaurant Gordon RamsayPortland Restaurant,Eating Out,26,11111
4,5,2013,ATM Cash Withdrawal,General,20,11091
6,5,2013,South West Trains,Transport,16,11075
6,5,2013,Caffe Nero,Eating Out,1,11074
6,5,2013,McDonalds,Eating Out,6,11068
6,5,2013,ATM Cash Withdrawal,General,20,11048
6,5,2013,Cheam Service Station,,3,11045
7,5,2013,Cubit and West rent,Rent,400,10645
7,5,2013,Wild Bean Cafe,Eating Out,2,10643
7,5,2013,Greggs,Eating Out,8,10635
8,5,2013,Costa Coffee,Eating Out,2,10633
8,5,2013,ATM Cash Withdrawal,General,20,10613
9,5,2013,Caffe Nero,Eating Out,1,10612
10,5,2013,Sainsburys,Groceries,49,10563
10,5,2013,Caffe Nero,Eating Out,1,10562
10,5,2013,Chicken Cottage,Eating Out,6,10556
10,5,2013,Paying back Julie,,3,10553
12,5,2013,Anglo restaurant,Eating Out,36,10517
12,5,2013,Red Shop,,8,10509
13,5,2013,South West Trains,Transport,19,10490
13,5,2013,Costa Coffee,Eating Out,1,10489
13,5,2013,Subway,Eating Out,7,10482
14,5,2013,Wild Bean Cafe,Eating Out,1,10481
14,5,2013,Subway,Eating Out,6,10475
15,5,2013,BRGAS-Electricity,Bills,18,10457
15,5,2013,BRGAS-Gas,Bills,15,10442
15,5,2013,Caffe Nero,Eating Out,2,10440
15,5,2013,Chicken Cottage,Eating Out,8,10432
16,5,2013,LBS Council Tax,Bills,20,10412
16,5,2013,Wild Bean Cafe,Eating Out,2,10410
16,5,2013,Paying back James,,1,10409
17,5,2013,Morrisons,Groceries,38,10371
17,5,2013,Pret A Manger,Eating Out,6,10365
17,5,2013,Ministry of Sound ClubXOYO Club,Eating Out,15,10350
17,5,2013,Ministry of Sound ClubXOYO Club,Eating Out,8,10342
17,5,2013,Anglo restaurant,Eating Out,27,10315
17,5,2013,ATM Cash Withdrawal,General,20,10295
19,5,2013,Anglo restaurant,Eating Out,39,10256
20,5,2013,VIRGIN MEDIA PYMTS,Bills,15,10241
20,5,2013,South West Trains,Transport,19,10222
20,5,2013,Caffe Nero,Eating Out,2,10220
20,5,2013,Paying back Julie,,9,10211
21,5,2013,Caffe Nero,Eating Out,2,10209
21,5,2013,Tool Tec,,7,10202
22,5,2013,Costa Coffee,Eating Out,1,10201
22,5,2013,Greggs,Eating Out,6,10195
22,5,2013,ATM Cash Withdrawal,General,20,10175
23,5,2013,Wild Bean Cafe,Eating Out,2,10173
23,5,2013,Chicken Cottage,Eating Out,6,10167
23,5,2013,ATM Cash Withdrawal,General,20,10147
23,5,2013,Cheam Service Station,,3,10144
24,5,2013,O2,Bills,21,10123
24,5,2013,ASDA,Groceries,54,10069
24,5,2013,Subway,Eating Out,5,10064
25,5,2013,Scott's Restaurant,Eating Out,57,10007
27,5,2013,South West Trains,Transport,20,9987
27,5,2013,Wild Bean Cafe,Eating Out,1,9986
27,5,2013,Chicken Cottage,Eating Out,7,9979
27,5,2013,ATM Cash Withdrawal,General,20,9959
27,5,2013,Paying back James,,8,9951
28,5,2013,Costa Coffee,Eating Out,2,9949
28,5,2013,The West Cornwall Pasty Company,Eating Out,5,9944
28,5,2013,ATM Cash Withdrawal,General,20,9924
29,5,2013,Wild Bean Cafe,Eating Out,2,9922
29,5,2013,ATM Cash Withdrawal,General,10,9912
29,5,2013,Red Shop,,9,9903
30,5,2013,Greggs,Eating Out,7,9896
30,5,2013,ATM Cash Withdrawal,General,20,9876
31,5,2013,Morrisons,Groceries,43,9833
31,5,2013,Starbucks Coffee,Eating Out,2,9831
31,5,2013,The West Cornwall Pasty Company,Eating Out,5,9826
31,5,2013,Anglo restaurant,Eating Out,25,9801
1,6,2013,Rhino Sports salary,General,1600,11401
1,6,2013,Scott's Restaurant,Eating Out,28,11373
3,6,2013,South West Trains,Transport,19,11354
3,6,2013,Costa Coffee,Eating Out,2,11352
3,6,2013,Subway,Eating Out,7,11345
4,6,2013,Costa Coffee,Eating Out,1,11344
4,6,2013,Civic Shop,,6,11338
5,6,2013,Starbucks Coffee,Eating Out,1,11337
5,6,2013,McDonalds,Eating Out,5,11332
6,6,2013,Wild Bean Cafe,Eating Out,2,11330
6,6,2013,Chicken Cottage,Eating Out,8,11322
7,6,2013,Cubit and West rent,Rent,400,10922
7,6,2013,Tescos,Groceries,36,10886
7,6,2013,Starbucks Coffee,Eating Out,2,10884
7,6,2013,Chicken Cottage,Eating Out,7,10877
7,6,2013,ATM Cash Withdrawal,General,20,10857
8,6,2013,Restaurant Gordon RamsayPortland Restaurant,Eating Out,43,10814
10,6,2013,South West Trains,Transport,19,10795
10,6,2013,Costa Coffee,Eating Out,1,10794
10,6,2013,The West Cornwall Pasty Company,Eating Out,6,10788
11,6,2013,Paying back Julie,,6,10782
12,6,2013,Caffe Nero,Eating Out,2,10780
13,6,2013,Wild Bean Cafe,Eating Out,1,10779
13,6,2013,Greggs,Eating Out,6,10773
14,6,2013,ASDA,Groceries,47,10726
14,6,2013,Starbucks Coffee,Eating Out,2,10724
14,6,2013,Chicken Cottage,Eating Out,5,10719
14,6,2013,The Grand Pub,Eating Out,12,10707
14,6,2013,Pizza Express,Eating Out,39,10668
15,6,2013,BRGAS-Electricity,Bills,29,10639
15,6,2013,BRGAS-Gas,Bills,16,10623
15,6,2013,Restaurant Gordon RamsayPortland Restaurant,Eating Out,48,10575
15,6,2013,ATM Cash Withdrawal,General,10,10565
16,6,2013,LBS Council Tax,Bills,20,10545
17,6,2013,South West Trains,Transport,23,10522
17,6,2013,Pret A Manger,Eating Out,8,10514
18,6,2013,Wild Bean Cafe,Eating Out,1,10513
19,6,2013,Subway,Eating Out,5,10508
20,6,2013,VIRGIN MEDIA PYMTS,Bills,25,10483
20,6,2013,Wild Bean Cafe,Eating Out,1,10482
21,6,2013,ASDA,Groceries,36,10446
21,6,2013,Starbucks Coffee,Eating Out,1,10445
22,6,2013,The Grand Pub,Eating Out,15,10430
22,6,2013,The Grand Pub,Eating Out,8,10422
22,6,2013,Pizza Express,Eating Out,52,10370
23,6,2013,Scott's Restaurant,Eating Out,44,10326
24,6,2013,O2,Bills,24,10302
24,6,2013,South West Trains,Transport,16,10286
24,6,2013,Starbucks Coffee,Eating Out,1,10285
25,6,2013,Caffe Nero,Eating Out,1,10284
25,6,2013,Subway,Eating Out,4,10280
25,6,2013,ATM Cash Withdrawal,General,20,10260
26,6,2013,Starbucks Coffee,Eating Out,2,10258
26,6,2013,McDonalds,Eating Out,6,10252
27,6,2013,Wild Bean Cafe,Eating Out,1,10251
27,6,2013,Pret A Manger,Eating Out,6,10245
28,6,2013,Tescos,Groceries,49,10196
28,6,2013,Caffe Nero,Eating Out,2,10194
28,6,2013,Chicken Cottage,Eating Out,5,10189
28,6,2013,Fabric Club,Eating Out,6,10183
28,6,2013,Fabric Club,Eating Out,5,10178
28,6,2013,Fabric Club,Eating Out,6,10172
28,6,2013,Fabric Club,Eating Out,12,10160
28,6,2013,Fabric Club,Eating Out,16,10144
28,6,2013,Fabric Club,Eating Out,11,10133
28,6,2013,Restaurant Gordon RamsayPortland Restaurant,Eating Out,50,10083
29,6,2013,Anglo restaurant,Eating Out,48,10035
29,6,2013,ATM Cash Withdrawal,General,20,10015
30,6,2013,Anglo restaurant,Eating Out,36,9979
1,7,2013,Rhino Sports salary,General,1600,11579
1,7,2013,South West Trains,Transport,21,11558
1,7,2013,Caffe Nero,Eating Out,1,11557
1,7,2013,Pret A Manger,Eating Out,7,11550
2,7,2013,Wild Bean Cafe,Eating Out,1,11549
2,7,2013,Greggs,Eating Out,6,11543
3,7,2013,Wild Bean Cafe,Eating Out,2,11541
3,7,2013,Greggs,Eating Out,8,11533
4,7,2013,Caffe Nero,Eating Out,2,11531
4,7,2013,Greggs,Eating Out,8,11523
4,7,2013,ATM Cash Withdrawal,General,20,11503
4,7,2013,Paying back James,,7,11496
5,7,2013,Waitrose,Groceries,66,11430
5,7,2013,Caffe Nero,Eating Out,2,11428
5,7,2013,Chicken Cottage,Eating Out,7,11421
5,7,2013,Pizza Express,Eating Out,36,11385
5,7,2013,Cheam Service Station,,5,11380
6,7,2013,Restaurant Gordon RamsayPortland Restaurant,Eating Out,31,11349
7,7,2013,Cubit and West rent,Rent,400,10949
7,7,2013,Civic Shop,,9,10940
8,7,2013,South West Trains,Transport,24,10916
8,7,2013,Wild Bean Cafe,Eating Out,2,10914
8,7,2013,The West Cornwall Pasty Company,Eating Out,5,10909
9,7,2013,Wild Bean Cafe,Eating Out,2,10907
9,7,2013,The West Cornwall Pasty Company,Eating Out,4,10903
9,7,2013,Paying back Julie,,4,10899
10,7,2013,Wild Bean Cafe,Eating Out,1,10898
10,7,2013,The West Cornwall Pasty Company,Eating Out,5,10893
11,7,2013,Starbucks Coffee,Eating Out,1,10892
11,7,2013,The West Cornwall Pasty Company,Eating Out,6,10886
12,7,2013,Waitrose,Groceries,70,10816
12,7,2013,Starbucks Coffee,Eating Out,1,10815
12,7,2013,Greggs,Eating Out,8,10807
13,7,2013,Dominos Pizza,Eating Out,37,10770
14,7,2013,Dominos Pizza,Eating Out,58,10712
14,7,2013,ATM Cash Withdrawal,General,10,10702
15,7,2013,BRGAS-Electricity,Bills,27,10675
15,7,2013,BRGAS-Gas,Bills,15,10660
15,7,2013,South West Trains,Transport,19,10641
15,7,2013,Starbucks Coffee,Eating Out,1,10640
15,7,2013,Pret A Manger,Eating Out,8,10632
15,7,2013,ATM Cash Withdrawal,General,10,10622
16,7,2013,LBS Council Tax,Bills,20,10602
16,7,2013,Caffe Nero,Eating Out,2,10600
16,7,2013,Subway,Eating Out,7,10593
16,7,2013,ATM Cash Withdrawal,General,20,10573
17,7,2013,Costa Coffee,Eating Out,2,10571
17,7,2013,McDonalds,Eating Out,6,10565
17,7,2013,ATM Cash Withdrawal,General,20,10545
18,7,2013,Starbucks Coffee,Eating Out,2,10543
18,7,2013,ATM Cash Withdrawal,General,10,10533
19,7,2013,Tescos,Groceries,54,10479
19,7,2013,Caffe Nero,Eating Out,1,10478
19,7,2013,Chicken Cottage,Eating Out,5,10473
19,7,2013,Anglo restaurant,Eating Out,26,10447
20,7,2013,VIRGIN MEDIA PYMTS,Bills,16,10431
22,7,2013,South West Trains,Transport,21,10410
22,7,2013,Caffe Nero,Eating Out,1,10409
22,7,2013,Pret A Manger,Eating Out,8,10401
23,7,2013,Costa Coffee,Eating Out,2,10399
23,7,2013,McDonalds,Eating Out,8,10391
24,7,2013,O2,Bills,20,10371
24,7,2013,Costa Coffee,Eating Out,2,10369
25,7,2013,Pret A Manger,Eating Out,8,10361
26,7,2013,Waitrose,Groceries,60,10301
26,7,2013,Subway,Eating Out,8,10293
27,7,2013,Scott's Restaurant,Eating Out,56,10237
29,7,2013,South West Trains,Transport,23,10214
29,7,2013,Caffe Nero,Eating Out,1,10213
29,7,2013,ATM Cash Withdrawal,General,10,10203
30,7,2013,Wild Bean Cafe,Eating Out,2,10201
30,7,2013,Greggs,Eating Out,4,10197
31,7,2013,Wild Bean Cafe,Eating Out,1,10196
31,7,2013,The West Cornwall Pasty Company,Eating Out,8,10188
1,8,2013,Rhino Sports salary,General,1600,11788
1,8,2013,Subway,Eating Out,4,11784
2,8,2013,Morrisons,Groceries,62,11722
2,8,2013,Costa Coffee,Eating Out,1,11721
2,8,2013,The West Cornwall Pasty Company,Eating Out,7,11714
2,8,2013,Pizza Express,Eating Out,27,11687
2,8,2013,ATM Cash Withdrawal,General,10,11677
2,8,2013,Tool Shop,,6,11671
3,8,2013,The Grand Pub,Eating Out,6,11665
3,8,2013,The Grand Pub,Eating Out,13,11652
3,8,2013,The Grand Pub,Eating Out,6,11646
3,8,2013,The Grand Pub,Eating Out,14,11632
3,8,2013,The Grand Pub,Eating Out,12,11620
3,8,2013,ATM Cash Withdrawal,General,10,11610
5,8,2013,South West Trains,Transport,16,11594
5,8,2013,McDonalds,Eating Out,8,11586
6,8,2013,Starbucks Coffee,Eating Out,2,11584
6,8,2013,Subway,Eating Out,5,11579
6,8,2013,ATM Cash Withdrawal,General,10,11569
7,8,2013,Cubit and West rent,Rent,400,11169
7,8,2013,ATM Cash Withdrawal,General,10,11159
8,8,2013,McDonalds,Eating Out,6,11153
9,8,2013,ASDA,Groceries,46,11107
9,8,2013,Costa Coffee,Eating Out,2,11105
11,8,2013,ATM Cash Withdrawal,General,20,11085
12,8,2013,South West Trains,Transport,20,11065
12,8,2013,Caffe Nero,Eating Out,2,11063
12,8,2013,The West Cornwall Pasty Company,Eating Out,8,11055
12,8,2013,ATM Cash Withdrawal,General,20,11035
13,8,2013,Caffe Nero,Eating Out,2,11033
13,8,2013,Subway,Eating Out,5,11028
13,8,2013,Civic Shop,,1,11027
14,8,2013,Wild Bean Cafe,Eating Out,2,11025
14,8,2013,Chicken Cottage,Eating Out,6,11019
15,8,2013,BRGAS-Electricity,Bills,16,11003
15,8,2013,BRGAS-Gas,Bills,28,10975
15,8,2013,McDonalds,Eating Out,6,10969
16,8,2013,LBS Council Tax,Bills,20,10949
16,8,2013,Sainsburys,Groceries,50,10899
16,8,2013,Civic Shop,,9,10890
17,8,2013,ATM Cash Withdrawal,General,20,10870
19,8,2013,South West Trains,Transport,16,10854
19,8,2013,Costa Coffee,Eating Out,2,10852
19,8,2013,Subway,Eating Out,8,10844
20,8,2013,VIRGIN MEDIA PYMTS,Bills,28,10816
20,8,2013,Starbucks Coffee,Eating Out,2,10814
21,8,2013,Wild Bean Cafe,Eating Out,2,10812
21,8,2013,Pret A Manger,Eating Out,5,10807
21,8,2013,Civic Shop,,9,10798
22,8,2013,McDonalds,Eating Out,8,10790
23,8,2013,Sainsburys,Groceries,69,10721
23,8,2013,Costa Coffee,Eating Out,2,10719
23,8,2013,Chicken Cottage,Eating Out,7,10712
24,8,2013,O2,Bills,24,10688
26,8,2013,South West Trains,Transport,24,10664
26,8,2013,Starbucks Coffee,Eating Out,2,10662
26,8,2013,Subway,Eating Out,6,10656
27,8,2013,Starbucks Coffee,Eating Out,2,10654
27,8,2013,Pret A Manger,Eating Out,7,10647
28,8,2013,Chicken Cottage,Eating Out,5,10642
29,8,2013,Starbucks Coffee,Eating Out,2,10640
29,8,2013,Greggs,Eating Out,8,10632
30,8,2013,ASDA,Groceries,69,10563
30,8,2013,Costa Coffee,Eating Out,2,10561
30,8,2013,The West Cornwall Pasty Company,Eating Out,7,10554
31,8,2013,ATM Cash Withdrawal,General,20,10534
1,9,2013,Rhino Sports salary,General,1600,12134
2,9,2013,South West Trains,Transport,19,12115
2,9,2013,ATM Cash Withdrawal,General,10,12105
3,9,2013,Costa Coffee,Eating Out,1,12104
3,9,2013,Pret A Manger,Eating Out,4,12100
4,9,2013,Costa Coffee,Eating Out,2,12098
4,9,2013,Pret A Manger,Eating Out,7,12091
5,9,2013,Wild Bean Cafe,Eating Out,1,12090
6,9,2013,Morrisons,Groceries,60,12030
6,9,2013,Costa Coffee,Eating Out,1,12029
6,9,2013,Dominos Pizza,Eating Out,51,11978
7,9,2013,Cubit and West rent,Rent,400,11578
7,9,2013,Fabric Club,Eating Out,15,11563
7,9,2013,Fabric Club,Eating Out,11,11552
7,9,2013,Dominos Pizza,Eating Out,45,11507
9,9,2013,South West Trains,Transport,25,11482
9,9,2013,Costa Coffee,Eating Out,1,11481
10,9,2013,Wild Bean Cafe,Eating Out,1,11480
11,9,2013,Costa Coffee,Eating Out,2,11478
11,9,2013,McDonalds,Eating Out,6,11472
11,9,2013,ATM Cash Withdrawal,General,20,11452
12,9,2013,The West Cornwall Pasty Company,Eating Out,7,11445
12,9,2013,ATM Cash Withdrawal,General,10,11435
13,9,2013,ASDA,Groceries,52,11383
13,9,2013,Starbucks Coffee,Eating Out,2,11381
13,9,2013,The West Cornwall Pasty Company,Eating Out,5,11376
13,9,2013,Dominos Pizza,Eating Out,40,11336
13,9,2013,Paying back James,,3,11333
14,9,2013,Dominos Pizza,Eating Out,30,11303
14,9,2013,ATM Cash Withdrawal,General,10,11293
15,9,2013,BRGAS-Electricity,Bills,20,11273
15,9,2013,BRGAS-Gas,Bills,24,11249
15,9,2013,Restaurant Gordon RamsayPortland Restaurant,Eating Out,50,11199
16,9,2013,LBS Council Tax,Bills,20,11179
16,9,2013,South West Trains,Transport,17,11162
17,9,2013,ATM Cash Withdrawal,General,10,11152
17,9,2013,Red Shop,,4,11148
18,9,2013,Costa Coffee,Eating Out,1,11147
18,9,2013,Subway,Eating Out,8,11139
18,9,2013,ATM Cash Withdrawal,General,20,11119
19,9,2013,Starbucks Coffee,Eating Out,2,11117
19,9,2013,Pret A Manger,Eating Out,5,11112
20,9,2013,VIRGIN MEDIA PYMTS,Bills,27,11085
20,9,2013,Sainsburys,Groceries,47,11038
20,9,2013,Starbucks Coffee,Eating Out,2,11036
20,9,2013,Dominos Pizza,Eating Out,54,10982
21,9,2013,ATM Cash Withdrawal,General,10,10972
22,9,2013,Scott's Restaurant,Eating Out,37,10935
22,9,2013,ATM Cash Withdrawal,General,20,10915
22,9,2013,Paying back James,,5,10910
23,9,2013,South West Trains,Transport,24,10886
23,9,2013,Subway,Eating Out,8,10878
24,9,2013,O2,Bills,22,10856
24,9,2013,Costa Coffee,Eating Out,2,10854
24,9,2013,Subway,Eating Out,8,10846
25,9,2013,Starbucks Coffee,Eating Out,1,10845
25,9,2013,Greggs,Eating Out,5,10840
27,9,2013,Waitrose,Groceries,72,10768
27,9,2013,Wild Bean Cafe,Eating Out,2,10766
27,9,2013,ATM Cash Withdrawal,General,10,10756
27,9,2013,Civic Shop,,4,10752
30,9,2013,South West Trains,Transport,22,10730
30,9,2013,Caffe Nero,Eating Out,2,10728
30,9,2013,The West Cornwall Pasty Company,Eating Out,6,10722
1,10,2013,Rhino Sports salary,General,1600,12322
2,10,2013,Wild Bean Cafe,Eating Out,2,12320
3,10,2013,McDonalds,Eating Out,6,12314
3,10,2013,ATM Cash Withdrawal,General,20,12294
4,10,2013,ASDA,Groceries,66,12228
4,10,2013,Caffe Nero,Eating Out,2,12226
4,10,2013,Chicken Cottage,Eating Out,8,12218
4,10,2013,Anglo restaurant,Eating Out,26,12192
5,10,2013,Civic Shop,,3,12189
6,10,2013,Scott's Restaurant,Eating Out,29,12160
7,10,2013,Cubit and West rent,Rent,400,11760
7,10,2013,South West Trains,Transport,22,11738
7,10,2013,Starbucks Coffee,Eating Out,2,11736
7,10,2013,Chicken Cottage,Eating Out,4,11732
8,10,2013,Caffe Nero,Eating Out,2,11730
8,10,2013,Chicken Cottage,Eating Out,8,11722
8,10,2013,ATM Cash Withdrawal,General,20,11702
9,10,2013,Caffe Nero,Eating Out,2,11700
9,10,2013,Chicken Cottage,Eating Out,4,11696
10,10,2013,Starbucks Coffee,Eating Out,2,11694
11,10,2013,Waitrose,Groceries,70,11624
11,10,2013,Wild Bean Cafe,Eating Out,1,11623
11,10,2013,Greggs,Eating Out,7,11616
11,10,2013,ATM Cash Withdrawal,General,20,11596
11,10,2013,Red Shop,,1,11595
13,10,2013,Restaurant Gordon RamsayPortland Restaurant,Eating Out,57,11538
14,10,2013,South West Trains,Transport,18,11520
14,10,2013,Starbucks Coffee,Eating Out,2,11518
14,10,2013,Pret A Manger,Eating Out,7,11511
15,10,2013,BRGAS-Electricity,Bills,21,11490
15,10,2013,BRGAS-Gas,Bills,25,11465
15,10,2013,Chicken Cottage,Eating Out,5,11460
15,10,2013,Tool Shop,,7,11453
16,10,2013,LBS Council Tax,Bills,20,11433
16,10,2013,Greggs,Eating Out,4,11429
17,10,2013,Costa Coffee,Eating Out,2,11427
17,10,2013,McDonalds,Eating Out,5,11422
17,10,2013,ATM Cash Withdrawal,General,20,11402
18,10,2013,Morrisons,Groceries,70,11332
18,10,2013,Caffe Nero,Eating Out,1,11331
18,10,2013,The West Cornwall Pasty Company,Eating Out,7,11324
20,10,2013,VIRGIN MEDIA PYMTS,Bills,26,11298
20,10,2013,Pizza Express,Eating Out,34,11264
21,10,2013,South West Trains,Transport,25,11239
21,10,2013,Starbucks Coffee,Eating Out,2,11237
22,10,2013,Wild Bean Cafe,Eating Out,1,11236
22,10,2013,Greggs,Eating Out,5,11231
22,10,2013,ATM Cash Withdrawal,General,10,11221
23,10,2013,Caffe Nero,Eating Out,2,11219
23,10,2013,Pret A Manger,Eating Out,5,11214
24,10,2013,O2,Bills,20,11194
24,10,2013,Starbucks Coffee,Eating Out,2,11192
24,10,2013,The West Cornwall Pasty Company,Eating Out,6,11186
25,10,2013,Morrisons,Groceries,74,11112
25,10,2013,Costa Coffee,Eating Out,1,11111
28,10,2013,South West Trains,Transport,19,11092
28,10,2013,Caffe Nero,Eating Out,1,11091
28,10,2013,Subway,Eating Out,5,11086
29,10,2013,Costa Coffee,Eating Out,1,11085
29,10,2013,The West Cornwall Pasty Company,Eating Out,8,11077
29,10,2013,ATM Cash Withdrawal,General,20,11057
30,10,2013,Caffe Nero,Eating Out,2,11055
30,10,2013,ATM Cash Withdrawal,General,20,11035
31,10,2013,Greggs,Eating Out,5,11030
1,11,2013,Rhino Sports salary,General,1600,12630
1,11,2013,Morrisons,Groceries,61,12569
1,11,2013,Wild Bean Cafe,Eating Out,2,12567
1,11,2013,Subway,Eating Out,7,12560
1,11,2013,ATM Cash Withdrawal,General,10,12550
2,11,2013,Pizza Express,Eating Out,41,12509
3,11,2013,Anglo restaurant,Eating Out,25,12484
4,11,2013,South West Trains,Transport,21,12463
4,11,2013,Starbucks Coffee,Eating Out,1,12462
4,11,2013,ATM Cash Withdrawal,General,10,12452
5,11,2013,Costa Coffee,Eating Out,2,12450
6,11,2013,Starbucks Coffee,Eating Out,2,12448
7,11,2013,Cubit and West rent,Rent,400,12048
7,11,2013,Costa Coffee,Eating Out,2,12046
8,11,2013,Morrisons,Groceries,41,12005
8,11,2013,Caffe Nero,Eating Out,2,12003
8,11,2013,Pizza Express,Eating Out,28,11975
9,11,2013,Fabric Club,Eating Out,13,11962
9,11,2013,Fabric Club,Eating Out,16,11946
9,11,2013,Fabric Club,Eating Out,15,11931
9,11,2013,Dominos Pizza,Eating Out,45,11886
9,11,2013,ATM Cash Withdrawal,General,10,11876
10,11,2013,ATM Cash Withdrawal,General,20,11856
11,11,2013,South West Trains,Transport,25,11831
11,11,2013,McDonalds,Eating Out,5,11826
11,11,2013,ATM Cash Withdrawal,General,20,11806
12,11,2013,McDonalds,Eating Out,6,11800
12,11,2013,ATM Cash Withdrawal,General,20,11780
13,11,2013,Wild Bean Cafe,Eating Out,1,11779
13,11,2013,Chicken Cottage,Eating Out,7,11772
14,11,2013,Starbucks Coffee,Eating Out,2,11770
14,11,2013,Subway,Eating Out,5,11765
14,11,2013,Tool Tec,,9,11756
15,11,2013,BRGAS-Electricity,Bills,48,11708
15,11,2013,BRGAS-Gas,Bills,30,11678
15,11,2013,Waitrose,Groceries,55,11623
15,11,2013,Caffe Nero,Eating Out,1,11622
15,11,2013,Subway,Eating Out,6,11616
15,11,2013,Heaven Club,Eating Out,5,11611
15,11,2013,Heaven Club,Eating Out,9,11602
15,11,2013,Heaven Club,Eating Out,6,11596
15,11,2013,Heaven Club,Eating Out,12,11584
16,11,2013,LBS Council Tax,Bills,20,11564
16,11,2013,ATM Cash Withdrawal,General,20,11544
17,11,2013,ATM Cash Withdrawal,General,10,11534
18,11,2013,South West Trains,Transport,16,11518
18,11,2013,Starbucks Coffee,Eating Out,1,11517
18,11,2013,The West Cornwall Pasty Company,Eating Out,5,11512
18,11,2013,Paying back James,,6,11506
19,11,2013,Subway,Eating Out,4,11502
19,11,2013,ATM Cash Withdrawal,General,20,11482
20,11,2013,VIRGIN MEDIA PYMTS,Bills,17,11465
20,11,2013,Costa Coffee,Eating Out,1,11464
20,11,2013,Chicken Cottage,Eating Out,8,11456
21,11,2013,Caffe Nero,Eating Out,1,11455
21,11,2013,Chicken Cottage,Eating Out,6,11449
22,11,2013,Sainsburys,Groceries,41,11408
22,11,2013,Caffe Nero,Eating Out,1,11407
22,11,2013,Pizza Express,Eating Out,44,11363
24,11,2013,O2,Bills,22,11341
24,11,2013,Anglo restaurant,Eating Out,52,11289
25,11,2013,South West Trains,Transport,23,11266
25,11,2013,Starbucks Coffee,Eating Out,2,11264
25,11,2013,McDonalds,Eating Out,4,11260
25,11,2013,ATM Cash Withdrawal,General,20,11240
26,11,2013,Caffe Nero,Eating Out,1,11239
26,11,2013,Subway,Eating Out,8,11231
27,11,2013,The West Cornwall Pasty Company,Eating Out,5,11226
28,11,2013,Subway,Eating Out,4,11222
29,11,2013,Morrisons,Groceries,69,11153
29,11,2013,Caffe Nero,Eating Out,2,11151
29,11,2013,Greggs,Eating Out,7,11144
30,11,2013,ATM Cash Withdrawal,General,10,11134
1,12,2013,Rhino Sports salary,General,1600,12734
1,12,2013,ATM Cash Withdrawal,General,20,12714
2,12,2013,South West Trains,Transport,16,12698
2,12,2013,Costa Coffee,Eating Out,1,12697
2,12,2013,Pret A Manger,Eating Out,4,12693
3,12,2013,Wild Bean Cafe,Eating Out,2,12691
3,12,2013,Pret A Manger,Eating Out,5,12686
3,12,2013,ATM Cash Withdrawal,General,20,12666
4,12,2013,Wild Bean Cafe,Eating Out,1,12665
5,12,2013,Costa Coffee,Eating Out,2,12663
5,12,2013,Subway,Eating Out,6,12657
6,12,2013,Sainsburys,Groceries,37,12620
6,12,2013,Caffe Nero,Eating Out,2,12618
7,12,2013,Cubit and West rent,Rent,400,12218
8,12,2013,Scott's Restaurant,Eating Out,32,12186
9,12,2013,South West Trains,Transport,23,12163
9,12,2013,Costa Coffee,Eating Out,2,12161
10,12,2013,Costa Coffee,Eating Out,2,12159
10,12,2013,The West Cornwall Pasty Company,Eating Out,7,12152
11,12,2013,Costa Coffee,Eating Out,2,12150
11,12,2013,Chicken Cottage,Eating Out,7,12143
12,12,2013,Caffe Nero,Eating Out,1,12142
12,12,2013,Greggs,Eating Out,7,12135
13,12,2013,Sainsburys,Groceries,45,12090
13,12,2013,Starbucks Coffee,Eating Out,2,12088
13,12,2013,The West Cornwall Pasty Company,Eating Out,7,12081
15,12,2013,BRGAS-Electricity,Bills,18,12063
15,12,2013,BRGAS-Gas,Bills,16,12047
16,12,2013,LBS Council Tax,Bills,20,12027
16,12,2013,South West Trains,Transport,25,12002
16,12,2013,Costa Coffee,Eating Out,2,12000
16,12,2013,McDonalds,Eating Out,8,11992
17,12,2013,Costa Coffee,Eating Out,1,11991
17,12,2013,Greggs,Eating Out,8,11983
18,12,2013,Caffe Nero,Eating Out,1,11982
18,12,2013,The West Cornwall Pasty Company,Eating Out,7,11975
19,12,2013,Wild Bean Cafe,Eating Out,1,11974
19,12,2013,Pret A Manger,Eating Out,4,11970
19,12,2013,ATM Cash Withdrawal,General,10,11960
20,12,2013,VIRGIN MEDIA PYMTS,Bills,23,11937
20,12,2013,ASDA,Groceries,43,11894
20,12,2013,Wild Bean Cafe,Eating Out,1,11893
21,12,2013,Ministry of Sound ClubXOYO Club,Eating Out,11,11882
21,12,2013,Ministry of Sound ClubXOYO Club,Eating Out,14,11868
21,12,2013,Ministry of Sound ClubXOYO Club,Eating Out,14,11854
21,12,2013,Ministry of Sound ClubXOYO Club,Eating Out,9,11845
21,12,2013,Ministry of Sound ClubXOYO Club,Eating Out,5,11840
21,12,2013,Scott's Restaurant,Eating Out,38,11802
22,12,2013,Dominos Pizza,Eating Out,35,11767
23,12,2013,South West Trains,Transport,25,11742
23,12,2013,McDonalds,Eating Out,6,11736
23,12,2013,ATM Cash Withdrawal,General,10,11726
24,12,2013,O2,Bills,20,11706
24,12,2013,Wild Bean Cafe,Eating Out,2,11704
24,12,2013,ATM Cash Withdrawal,General,20,11684
25,12,2013,Wild Bean Cafe,Eating Out,2,11682
26,12,2013,Caffe Nero,Eating Out,2,11680
26,12,2013,McDonalds,Eating Out,4,11676
26,12,2013,ATM Cash Withdrawal,General,20,11656
27,12,2013,Tescos,Groceries,36,11620
27,12,2013,Costa Coffee,Eating Out,1,11619
27,12,2013,The West Cornwall Pasty Company,Eating Out,5,11614
27,12,2013,Restaurant Gordon RamsayPortland Restaurant,Eating Out,37,11577
28,12,2013,Scott's Restaurant,Eating Out,30,11547
28,12,2013,ATM Cash Withdrawal,General,10,11537
29,12,2013,Restaurant Gordon RamsayPortland Restaurant,Eating Out,24,11513
29,12,2013,Civic Shop,,3,11510
30,12,2013,South West Trains,Transport,18,11492
30,12,2013,Starbucks Coffee,Eating Out,1,11491
30,12,2013,McDonalds,Eating Out,6,11485
30,12,2013,ATM Cash Withdrawal,General,10,11475
31,12,2013,Costa Coffee,Eating Out,2,11473
31,12,2013,Greggs,Eating Out,7,11466
1,1,2014,Rhino Sports salary,General,1600,13066
1,1,2014,Costa Coffee,Eating Out,2,13064
1,1,2014,Chicken Cottage,Eating Out,5,13059
1,1,2014,Tool Shop,,4,13055
2,1,2014,Caffe Nero,Eating Out,2,13053
3,1,2014,ASDA,Groceries,40,13013
3,1,2014,Costa Coffee,Eating Out,1,13012
3,1,2014,Pret A Manger,Eating Out,6,13006
4,1,2014,Anglo restaurant,Eating Out,59,12947
4,1,2014,ATM Cash Withdrawal,General,10,12937
5,1,2014,ATM Cash Withdrawal,General,20,12917
6,1,2014,South West Trains,Transport,23,12894
6,1,2014,Subway,Eating Out,6,12888
6,1,2014,ATM Cash Withdrawal,General,10,12878
7,1,2014,Cubit and West rent,Rent,400,12478
7,1,2014,Caffe Nero,Eating Out,1,12477
7,1,2014,Greggs,Eating Out,7,12470
9,1,2014,Greggs,Eating Out,4,12466
10,1,2014,Tescos,Groceries,58,12408
10,1,2014,Caffe Nero,Eating Out,2,12406
10,1,2014,ATM Cash Withdrawal,General,10,12396
11,1,2014,ATM Cash Withdrawal,General,10,12386
12,1,2014,Anglo restaurant,Eating Out,28,12358
13,1,2014,South West Trains,Transport,22,12336
13,1,2014,Costa Coffee,Eating Out,2,12334
13,1,2014,Pret A Manger,Eating Out,5,12329
13,1,2014,ATM Cash Withdrawal,General,20,12309
14,1,2014,Starbucks Coffee,Eating Out,1,12308
14,1,2014,Chicken Cottage,Eating Out,6,12302
15,1,2014,BRGAS-Electricity,Bills,66,12236
15,1,2014,BRGAS-Gas,Bills,35,12201
15,1,2014,Starbucks Coffee,Eating Out,1,12200
15,1,2014,McDonalds,Eating Out,4,12196
15,1,2014,ATM Cash Withdrawal,General,10,12186
16,1,2014,LBS Council Tax,Bills,20,12166
16,1,2014,Starbucks Coffee,Eating Out,1,12165
17,1,2014,Morrisons,Groceries,73,12092
17,1,2014,Starbucks Coffee,Eating Out,2,12090
17,1,2014,Chicken Cottage,Eating Out,5,12085
17,1,2014,Anglo restaurant,Eating Out,57,12028
18,1,2014,Restaurant Gordon RamsayPortland Restaurant,Eating Out,44,11984
18,1,2014,ATM Cash Withdrawal,General,20,11964
19,1,2014,Pizza Express,Eating Out,38,11926
20,1,2014,VIRGIN MEDIA PYMTS,Bills,24,11902
20,1,2014,South West Trains,Transport,21,11881
20,1,2014,Starbucks Coffee,Eating Out,2,11879
20,1,2014,The West Cornwall Pasty Company,Eating Out,5,11874
21,1,2014,Cheam Service Station,,4,11870
22,1,2014,Starbucks Coffee,Eating Out,2,11868
22,1,2014,Pret A Manger,Eating Out,7,11861
23,1,2014,Starbucks Coffee,Eating Out,1,11860
23,1,2014,The West Cornwall Pasty Company,Eating Out,5,11855
24,1,2014,O2,Bills,25,11830
24,1,2014,Sainsburys,Groceries,35,11795
24,1,2014,Anglo restaurant,Eating Out,45,11750
26,1,2014,ATM Cash Withdrawal,General,20,11730
27,1,2014,South West Trains,Transport,24,11706
27,1,2014,Wild Bean Cafe,Eating Out,1,11705
27,1,2014,Subway,Eating Out,4,11701
28,1,2014,Starbucks Coffee,Eating Out,2,11699
28,1,2014,Subway,Eating Out,7,11692
29,1,2014,Greggs,Eating Out,5,11687
29,1,2014,Red Shop,,1,11686
30,1,2014,Starbucks Coffee,Eating Out,1,11685
31,1,2014,ASDA,Groceries,66,11619
31,1,2014,Starbucks Coffee,Eating Out,1,11618
31,1,2014,McDonalds,Eating Out,5,11613
31,1,2014,Ministry of Sound ClubXOYO Club,Eating Out,9,11604
31,1,2014,Pizza Express,Eating Out,46,11558
1,2,2014,Rhino Sports salary,General,1600,13158
1,2,2014,Pizza Express,Eating Out,51,13107
2,2,2014,Scott's Restaurant,Eating Out,38,13069
2,2,2014,ATM Cash Withdrawal,General,20,13049
3,2,2014,South West Trains,Transport,16,13033
3,2,2014,Starbucks Coffee,Eating Out,2,13031
3,2,2014,Chicken Cottage,Eating Out,5,13026
4,2,2014,Caffe Nero,Eating Out,1,13025
5,2,2014,Starbucks Coffee,Eating Out,2,13023
5,2,2014,Pret A Manger,Eating Out,7,13016
5,2,2014,Paying back Julie,,9,13007
6,2,2014,Wild Bean Cafe,Eating Out,2,13005
7,2,2014,Cubit and West rent,Rent,400,12605
7,2,2014,Tescos,Groceries,50,12555
7,2,2014,Costa Coffee,Eating Out,1,12554
7,2,2014,Chicken Cottage,Eating Out,7,12547
9,2,2014,ATM Cash Withdrawal,General,10,12537
10,2,2014,South West Trains,Transport,24,12513
10,2,2014,Subway,Eating Out,7,12506
11,2,2014,Starbucks Coffee,Eating Out,2,12504
12,2,2014,Starbucks Coffee,Eating Out,2,12502
12,2,2014,Chicken Cottage,Eating Out,5,12497
12,2,2014,Tool Tec,,9,12488
13,2,2014,Starbucks Coffee,Eating Out,2,12486
13,2,2014,Subway,Eating Out,4,12482
13,2,2014,ATM Cash Withdrawal,General,10,12472
14,2,2014,Sainsburys,Groceries,67,12405
14,2,2014,Caffe Nero,Eating Out,2,12403
14,2,2014,The West Cornwall Pasty Company,Eating Out,4,12399
15,2,2014,BRGAS-Electricity,Bills,18,12381
15,2,2014,BRGAS-Gas,Bills,18,12363
15,2,2014,ATM Cash Withdrawal,General,10,12353
16,2,2014,LBS Council Tax,Bills,20,12333
17,2,2014,South West Trains,Transport,16,12317
17,2,2014,Starbucks Coffee,Eating Out,2,12315
18,2,2014,Costa Coffee,Eating Out,1,12314
18,2,2014,McDonalds,Eating Out,5,12309
19,2,2014,Costa Coffee,Eating Out,2,12307
20,2,2014,VIRGIN MEDIA PYMTS,Bills,18,12289
20,2,2014,Wild Bean Cafe,Eating Out,1,12288
20,2,2014,Pret A Manger,Eating Out,7,12281
20,2,2014,ATM Cash Withdrawal,General,10,12271
21,2,2014,ASDA,Groceries,54,12217
21,2,2014,Costa Coffee,Eating Out,1,12216
24,2,2014,O2,Bills,20,12196
24,2,2014,South West Trains,Transport,19,12177
25,2,2014,Caffe Nero,Eating Out,1,12176
25,2,2014,McDonalds,Eating Out,6,12170
25,2,2014,ATM Cash Withdrawal,General,10,12160
26,2,2014,Caffe Nero,Eating Out,1,12159
27,2,2014,Starbucks Coffee,Eating Out,1,12158
27,2,2014,Subway,Eating Out,6,12152
27,2,2014,ATM Cash Withdrawal,General,20,12132
28,2,2014,Waitrose,Groceries,56,12076
28,2,2014,Costa Coffee,Eating Out,2,12074
1,3,2014,Rhino Sports salary,General,1600,13674
1,3,2014,ATM Cash Withdrawal,General,20,13654
2,3,2014,Anglo restaurant,Eating Out,30,13624
3,3,2014,South West Trains,Transport,17,13607
3,3,2014,Wild Bean Cafe,Eating Out,2,13605
3,3,2014,Chicken Cottage,Eating Out,7,13598
4,3,2014,Wild Bean Cafe,Eating Out,1,13597
4,3,2014,ATM Cash Withdrawal,General,10,13587
5,3,2014,The West Cornwall Pasty Company,Eating Out,6,13581
6,3,2014,Costa Coffee,Eating Out,1,13580
6,3,2014,Chicken Cottage,Eating Out,4,13576
7,3,2014,Cubit and West rent,Rent,400,13176
7,3,2014,Morrisons,Groceries,41,13135
7,3,2014,Chicken Cottage,Eating Out,7,13128
8,3,2014,Dominos Pizza,Eating Out,32,13096
9,3,2014,Scott's Restaurant,Eating Out,26,13070
9,3,2014,Civic Shop,,6,13064
10,3,2014,South West Trains,Transport,18,13046
10,3,2014,Subway,Eating Out,8,13038
11,3,2014,Caffe Nero,Eating Out,1,13037
11,3,2014,The West Cornwall Pasty Company,Eating Out,8,13029
11,3,2014,ATM Cash Withdrawal,General,10,13019
11,3,2014,Tool Shop,,1,13018
12,3,2014,Wild Bean Cafe,Eating Out,2,13016
12,3,2014,Pret A Manger,Eating Out,6,13010
12,3,2014,ATM Cash Withdrawal,General,20,12990
13,3,2014,Pret A Manger,Eating Out,8,12982
14,3,2014,Waitrose,Groceries,70,12912
14,3,2014,Chicken Cottage,Eating Out,8,12904
14,3,2014,ATM Cash Withdrawal,General,20,12884
15,3,2014,BRGAS-Electricity,Bills,29,12855
15,3,2014,BRGAS-Gas,Bills,26,12829
15,3,2014,Dominos Pizza,Eating Out,34,12795
15,3,2014,Civic Shop,,9,12786
16,3,2014,LBS Council Tax,Bills,20,12766
17,3,2014,South West Trains,Transport,20,12746
17,3,2014,Caffe Nero,Eating Out,2,12744
18,3,2014,Wild Bean Cafe,Eating Out,1,12743
19,3,2014,Costa Coffee,Eating Out,2,12741
19,3,2014,Pret A Manger,Eating Out,6,12735
20,3,2014,VIRGIN MEDIA PYMTS,Bills,21,12714
20,3,2014,Costa Coffee,Eating Out,2,12712
21,3,2014,Sainsburys,Groceries,52,12660
21,3,2014,Costa Coffee,Eating Out,1,12659
21,3,2014,McDonalds,Eating Out,7,12652
22,3,2014,Heaven Club,Eating Out,13,12639
22,3,2014,Heaven Club,Eating Out,6,12633
22,3,2014,Heaven Club,Eating Out,13,12620
22,3,2014,Heaven Club,Eating Out,6,12614
22,3,2014,Heaven Club,Eating Out,16,12598
22,3,2014,Heaven Club,Eating Out,13,12585
22,3,2014,ATM Cash Withdrawal,General,10,12575
23,3,2014,ATM Cash Withdrawal,General,10,12565
24,3,2014,O2,Bills,25,12540
24,3,2014,South West Trains,Transport,23,12517
24,3,2014,Caffe Nero,Eating Out,2,12515
24,3,2014,McDonalds,Eating Out,6,12509
25,3,2014,Costa Coffee,Eating Out,2,12507
25,3,2014,Chicken Cottage,Eating Out,7,12500
26,3,2014,Costa Coffee,Eating Out,2,12498
27,3,2014,Pret A Manger,Eating Out,4,12494
28,3,2014,ASDA,Groceries,71,12423
28,3,2014,Caffe Nero,Eating Out,1,12422
28,3,2014,Pizza Express,Eating Out,45,12377
31,3,2014,South West Trains,Transport,16,12361
31,3,2014,McDonalds,Eating Out,7,12354
1,4,2014,Rhino Sports salary,General,1600,13954
1,4,2014,Costa Coffee,Eating Out,2,13952
2,4,2014,Subway,Eating Out,4,13948
2,4,2014,ATM Cash Withdrawal,General,20,13928
2,4,2014,Tool Shop,,9,13919
3,4,2014,Costa Coffee,Eating Out,1,13918
3,4,2014,Pret A Manger,Eating Out,7,13911
4,4,2014,Tescos,Groceries,46,13865
4,4,2014,Starbucks Coffee,Eating Out,1,13864
4,4,2014,McDonalds,Eating Out,5,13859
4,4,2014,ATM Cash Withdrawal,General,10,13849
5,4,2014,Pizza Express,Eating Out,45,13804
7,4,2014,Cubit and West rent,Rent,400,13404
7,4,2014,South West Trains,Transport,16,13388
8,4,2014,Wild Bean Cafe,Eating Out,2,13386
9,4,2014,Caffe Nero,Eating Out,1,13385
9,4,2014,Greggs,Eating Out,5,13380
10,4,2014,Wild Bean Cafe,Eating Out,1,13379
11,4,2014,ASDA,Groceries,65,13314
11,4,2014,Costa Coffee,Eating Out,2,13312
11,4,2014,Chicken Cottage,Eating Out,5,13307
12,4,2014,Pizza Express,Eating Out,26,13281
13,4,2014,Pizza Express,Eating Out,54,13227
14,4,2014,South West Trains,Transport,17,13210
14,4,2014,Starbucks Coffee,Eating Out,2,13208
14,4,2014,Greggs,Eating Out,5,13203
15,4,2014,BRGAS-Electricity,Bills,25,13178
15,4,2014,BRGAS-Gas,Bills,16,13162
15,4,2014,Caffe Nero,Eating Out,1,13161
16,4,2014,LBS Council Tax,Bills,20,13141
16,4,2014,Pret A Manger,Eating Out,5,13136
16,4,2014,ATM Cash Withdrawal,General,20,13116
17,4,2014,ATM Cash Withdrawal,General,20,13096
18,4,2014,Morrisons,Groceries,60,13036
18,4,2014,The West Cornwall Pasty Company,Eating Out,6,13030
18,4,2014,ATM Cash Withdrawal,General,20,13010
19,4,2014,Pizza Express,Eating Out,42,12968
20,4,2014,VIRGIN MEDIA PYMTS,Bills,15,12953
20,4,2014,Dominos Pizza,Eating Out,32,12921
21,4,2014,South West Trains,Transport,18,12903
21,4,2014,Starbucks Coffee,Eating Out,2,12901
22,4,2014,Wild Bean Cafe,Eating Out,2,12899
22,4,2014,Chicken Cottage,Eating Out,5,12894
22,4,2014,ATM Cash Withdrawal,General,10,12884
23,4,2014,Chicken Cottage,Eating Out,5,12879
24,4,2014,O2,Bills,21,12858
24,4,2014,Pret A Manger,Eating Out,8,12850
25,4,2014,Morrisons,Groceries,74,12776
25,4,2014,McDonalds,Eating Out,5,12771
25,4,2014,Fabric Club,Eating Out,12,12759
25,4,2014,Fabric Club,Eating Out,13,12746
25,4,2014,Fabric Club,Eating Out,9,12737
25,4,2014,Fabric Club,Eating Out,16,12721
26,4,2014,Heaven Club,Eating Out,8,12713
26,4,2014,Heaven Club,Eating Out,10,12703
26,4,2014,ATM Cash Withdrawal,General,20,12683
27,4,2014,Tool Shop,,8,12675
28,4,2014,South West Trains,Transport,21,12654
28,4,2014,Costa Coffee,Eating Out,2,12652
30,4,2014,Wild Bean Cafe,Eating Out,1,12651
30,4,2014,Tool Shop,,9,12642
1,5,2014,Rhino Sports salary,General,1600,14242
1,5,2014,Wild Bean Cafe,Eating Out,2,14240
1,5,2014,ATM Cash Withdrawal,General,20,14220
2,5,2014,Sainsburys,Groceries,67,14153
2,5,2014,ATM Cash Withdrawal,General,20,14133
3,5,2014,Heaven Club,Eating Out,7,14126
3,5,2014,Heaven Club,Eating Out,6,14120
3,5,2014,Heaven Club,Eating Out,11,14109
3,5,2014,Heaven Club,Eating Out,6,14103
3,5,2014,Restaurant Gordon RamsayPortland Restaurant,Eating Out,42,14061
4,5,2014,ATM Cash Withdrawal,General,20,14041
5,5,2014,South West Trains,Transport,23,14018
6,5,2014,Wild Bean Cafe,Eating Out,1,14017
6,5,2014,McDonalds,Eating Out,5,14012
7,5,2014,Cubit and West rent,Rent,400,13612
7,5,2014,Caffe Nero,Eating Out,2,13610
7,5,2014,Greggs,Eating Out,5,13605
7,5,2014,ATM Cash Withdrawal,General,20,13585
8,5,2014,Costa Coffee,Eating Out,1,13584
8,5,2014,Pret A Manger,Eating Out,4,13580
9,5,2014,ASDA,Groceries,72,13508
9,5,2014,Costa Coffee,Eating Out,2,13506
9,5,2014,Greggs,Eating Out,7,13499
9,5,2014,ATM Cash Withdrawal,General,20,13479
10,5,2014,Ministry of Sound ClubXOYO Club,Eating Out,12,13467
10,5,2014,Ministry of Sound ClubXOYO Club,Eating Out,9,13458
10,5,2014,ATM Cash Withdrawal,General,20,13438
11,5,2014,Dominos Pizza,Eating Out,48,13390
11,5,2014,Tool Tec,,6,13384
12,5,2014,South West Trains,Transport,18,13366
12,5,2014,Costa Coffee,Eating Out,2,13364
12,5,2014,Chicken Cottage,Eating Out,8,13356
12,5,2014,ATM Cash Withdrawal,General,20,13336
13,5,2014,Caffe Nero,Eating Out,2,13334
14,5,2014,Caffe Nero,Eating Out,2,13332
14,5,2014,Greggs,Eating Out,5,13327
15,5,2014,BRGAS-Electricity,Bills,17,13310
15,5,2014,BRGAS-Gas,Bills,16,13294
15,5,2014,ATM Cash Withdrawal,General,20,13274
16,5,2014,LBS Council Tax,Bills,20,13254
16,5,2014,Sainsburys,Groceries,38,13216
16,5,2014,Starbucks Coffee,Eating Out,2,13214
17,5,2014,ATM Cash Withdrawal,General,20,13194
18,5,2014,Dominos Pizza,Eating Out,43,13151
18,5,2014,ATM Cash Withdrawal,General,10,13141
19,5,2014,South West Trains,Transport,21,13120
19,5,2014,Costa Coffee,Eating Out,2,13118
20,5,2014,VIRGIN MEDIA PYMTS,Bills,19,13099
20,5,2014,Wild Bean Cafe,Eating Out,1,13098
20,5,2014,McDonalds,Eating Out,4,13094
21,5,2014,Costa Coffee,Eating Out,1,13093
21,5,2014,Greggs,Eating Out,8,13085
22,5,2014,Costa Coffee,Eating Out,2,13083
22,5,2014,Chicken Cottage,Eating Out,6,13077
22,5,2014,ATM Cash Withdrawal,General,10,13067
23,5,2014,Waitrose,Groceries,47,13020
23,5,2014,Wild Bean Cafe,Eating Out,1,13019
23,5,2014,Greggs,Eating Out,4,13015
23,5,2014,Scott's Restaurant,Eating Out,33,12982
24,5,2014,O2,Bills,21,12961
25,5,2014,Red Shop,,8,12953
26,5,2014,South West Trains,Transport,16,12937
26,5,2014,Costa Coffee,Eating Out,2,12935
26,5,2014,Subway,Eating Out,7,12928
27,5,2014,Starbucks Coffee,Eating Out,1,12927
27,5,2014,ATM Cash Withdrawal,General,20,12907
28,5,2014,Costa Coffee,Eating Out,2,12905
29,5,2014,ATM Cash Withdrawal,General,20,12885
30,5,2014,Morrisons,Groceries,38,12847
30,5,2014,Starbucks Coffee,Eating Out,1,12846
30,5,2014,Subway,Eating Out,6,12840
30,5,2014,Dominos Pizza,Eating Out,38,12802
1,6,2014,Rhino Sports salary,General,1600,14402
2,6,2014,South West Trains,Transport,17,14385
2,6,2014,Starbucks Coffee,Eating Out,2,14383
2,6,2014,Greggs,Eating Out,7,14376
3,6,2014,Costa Coffee,Eating Out,1,14375
3,6,2014,Subway,Eating Out,4,14371
3,6,2014,ATM Cash Withdrawal,General,10,14361
4,6,2014,Subway,Eating Out,4,14357
5,6,2014,ATM Cash Withdrawal,General,10,14347
6,6,2014,Waitrose,Groceries,47,14300
6,6,2014,Wild Bean Cafe,Eating Out,2,14298
6,6,2014,Anglo restaurant,Eating Out,39,14259
7,6,2014,Cubit and West rent,Rent,400,13859
7,6,2014,Fabric Club,Eating Out,15,13844
7,6,2014,Fabric Club,Eating Out,11,13833
7,6,2014,Fabric Club,Eating Out,7,13826
7,6,2014,Fabric Club,Eating Out,10,13816
7,6,2014,Fabric Club,Eating Out,8,13808
7,6,2014,Fabric Club,Eating Out,11,13797
7,6,2014,ATM Cash Withdrawal,General,20,13777
8,6,2014,Anglo restaurant,Eating Out,34,13743
9,6,2014,South West Trains,Transport,20,13723
9,6,2014,Starbucks Coffee,Eating Out,1,13722
9,6,2014,Greggs,Eating Out,4,13718
10,6,2014,Caffe Nero,Eating Out,1,13717
11,6,2014,Wild Bean Cafe,Eating Out,1,13716
11,6,2014,Tool Shop,,2,13714
12,6,2014,Wild Bean Cafe,Eating Out,1,13713
12,6,2014,ATM Cash Withdrawal,General,10,13703
13,6,2014,Morrisons,Groceries,43,13660
13,6,2014,Caffe Nero,Eating Out,1,13659
13,6,2014,Dominos Pizza,Eating Out,48,13611
14,6,2014,ATM Cash Withdrawal,General,10,13601
15,6,2014,BRGAS-Electricity,Bills,27,13574
15,6,2014,BRGAS-Gas,Bills,23,13551
16,6,2014,LBS Council Tax,Bills,20,13531
16,6,2014,South West Trains,Transport,23,13508
16,6,2014,Chicken Cottage,Eating Out,8,13500
17,6,2014,Pret A Manger,Eating Out,5,13495
18,6,2014,Starbucks Coffee,Eating Out,1,13494
18,6,2014,Pret A Manger,Eating Out,7,13487
19,6,2014,Starbucks Coffee,Eating Out,2,13485
19,6,2014,McDonalds,Eating Out,8,13477
20,6,2014,VIRGIN MEDIA PYMTS,Bills,25,13452
20,6,2014,ASDA,Groceries,59,13393
20,6,2014,Costa Coffee,Eating Out,2,13391
20,6,2014,McDonalds,Eating Out,6,13385
21,6,2014,Red Shop,,1,13384
23,6,2014,South West Trains,Transport,22,13362
23,6,2014,Starbucks Coffee,Eating Out,1,13361
24,6,2014,O2,Bills,21,13340
24,6,2014,Pret A Manger,Eating Out,7,13333
24,6,2014,ATM Cash Withdrawal,General,20,13313
25,6,2014,Caffe Nero,Eating Out,2,13311
26,6,2014,Wild Bean Cafe,Eating Out,2,13309
26,6,2014,Subway,Eating Out,6,13303
26,6,2014,ATM Cash Withdrawal,General,20,13283
26,6,2014,Red Shop,,7,13276
27,6,2014,Tescos,Groceries,50,13226
27,6,2014,Caffe Nero,Eating Out,2,13224
27,6,2014,McDonalds,Eating Out,4,13220
27,6,2014,Anglo restaurant,Eating Out,52,13168
28,6,2014,ATM Cash Withdrawal,General,20,13148
30,6,2014,South West Trains,Transport,20,13128
30,6,2014,Costa Coffee,Eating Out,2,13126
1,7,2014,Rhino Sports salary,General,1600,14726
1,7,2014,Costa Coffee,Eating Out,2,14724
2,7,2014,Wild Bean Cafe,Eating Out,1,14723
2,7,2014,ATM Cash Withdrawal,General,10,14713
4,7,2014,Sainsburys,Groceries,53,14660
4,7,2014,Chicken Cottage,Eating Out,6,14654
4,7,2014,Anglo restaurant,Eating Out,50,14604
4,7,2014,ATM Cash Withdrawal,General,10,14594
7,7,2014,Cubit and West rent,Rent,400,14194
7,7,2014,South West Trains,Transport,16,14178
7,7,2014,Costa Coffee,Eating Out,2,14176
8,7,2014,Caffe Nero,Eating Out,1,14175
8,7,2014,Subway,Eating Out,4,14171
8,7,2014,ATM Cash Withdrawal,General,20,14151
9,7,2014,Costa Coffee,Eating Out,2,14149
9,7,2014,McDonalds,Eating Out,7,14142
9,7,2014,ATM Cash Withdrawal,General,10,14132
10,7,2014,Caffe Nero,Eating Out,1,14131
10,7,2014,Pret A Manger,Eating Out,8,14123
10,7,2014,ATM Cash Withdrawal,General,10,14113
11,7,2014,Waitrose,Groceries,55,14058
11,7,2014,Costa Coffee,Eating Out,2,14056
11,7,2014,McDonalds,Eating Out,5,14051
11,7,2014,Scott's Restaurant,Eating Out,40,14011
14,7,2014,South West Trains,Transport,25,13986
14,7,2014,Caffe Nero,Eating Out,2,13984
14,7,2014,The West Cornwall Pasty Company,Eating Out,8,13976
15,7,2014,BRGAS-Electricity,Bills,17,13959
15,7,2014,BRGAS-Gas,Bills,16,13943
15,7,2014,Starbucks Coffee,Eating Out,2,13941
15,7,2014,McDonalds,Eating Out,6,13935
16,7,2014,LBS Council Tax,Bills,20,13915
16,7,2014,McDonalds,Eating Out,8,13907
17,7,2014,Starbucks Coffee,Eating Out,2,13905
18,7,2014,Waitrose,Groceries,43,13862
18,7,2014,Costa Coffee,Eating Out,2,13860
18,7,2014,ATM Cash Withdrawal,General,20,13840
19,7,2014,Dominos Pizza,Eating Out,44,13796
20,7,2014,VIRGIN MEDIA PYMTS,Bills,21,13775
20,7,2014,Anglo restaurant,Eating Out,37,13738
20,7,2014,ATM Cash Withdrawal,General,10,13728
21,7,2014,South West Trains,Transport,18,13710
21,7,2014,Caffe Nero,Eating Out,2,13708
21,7,2014,Paying back Julie,,6,13702
22,7,2014,Wild Bean Cafe,Eating Out,1,13701
23,7,2014,Costa Coffee,Eating Out,1,13700
23,7,2014,McDonalds,Eating Out,4,13696
24,7,2014,O2,Bills,23,13673
24,7,2014,Caffe Nero,Eating Out,2,13671
24,7,2014,The West Cornwall Pasty Company,Eating Out,8,13663
24,7,2014,ATM Cash Withdrawal,General,10,13653
25,7,2014,Sainsburys,Groceries,69,13584
25,7,2014,Starbucks Coffee,Eating Out,2,13582
25,7,2014,Dominos Pizza,Eating Out,27,13555
26,7,2014,Pizza Express,Eating Out,36,13519
27,7,2014,ATM Cash Withdrawal,General,10,13509
27,7,2014,Red Shop,,1,13508
28,7,2014,South West Trains,Transport,20,13488
28,7,2014,Starbucks Coffee,Eating Out,2,13486
29,7,2014,Costa Coffee,Eating Out,1,13485
30,7,2014,Greggs,Eating Out,4,13481
31,7,2014,Starbucks Coffee,Eating Out,2,13479
31,7,2014,McDonalds,Eating Out,8,13471
1,8,2014,Rhino Sports salary,General,1600,15071
1,8,2014,Sainsburys,Groceries,73,14998
1,8,2014,Caffe Nero,Eating Out,2,14996
1,8,2014,The West Cornwall Pasty Company,Eating Out,8,14988
1,8,2014,ATM Cash Withdrawal,General,20,14968
3,8,2014,ATM Cash Withdrawal,General,20,14948
3,8,2014,Red Shop,,8,14940
4,8,2014,South West Trains,Transport,21,14919
4,8,2014,Wild Bean Cafe,Eating Out,2,14917
4,8,2014,Greggs,Eating Out,8,14909
5,8,2014,Caffe Nero,Eating Out,1,14908
5,8,2014,Chicken Cottage,Eating Out,8,14900
6,8,2014,Wild Bean Cafe,Eating Out,1,14899
6,8,2014,Pret A Manger,Eating Out,5,14894
7,8,2014,Cubit and West rent,Rent,400,14494
7,8,2014,Wild Bean Cafe,Eating Out,1,14493
7,8,2014,Greggs,Eating Out,4,14489
8,8,2014,Morrisons,Groceries,50,14439
8,8,2014,Caffe Nero,Eating Out,2,14437
8,8,2014,Fabric Club,Eating Out,9,14428
8,8,2014,Pizza Express,Eating Out,52,14376
8,8,2014,ATM Cash Withdrawal,General,20,14356
9,8,2014,ATM Cash Withdrawal,General,10,14346
11,8,2014,South West Trains,Transport,18,14328
11,8,2014,Costa Coffee,Eating Out,2,14326
12,8,2014,Starbucks Coffee,Eating Out,2,14324
12,8,2014,Chicken Cottage,Eating Out,5,14319
12,8,2014,ATM Cash Withdrawal,General,20,14299
13,8,2014,Pret A Manger,Eating Out,4,14295
14,8,2014,Starbucks Coffee,Eating Out,1,14294
14,8,2014,Pret A Manger,Eating Out,5,14289
15,8,2014,BRGAS-Electricity,Bills,17,14272
15,8,2014,BRGAS-Gas,Bills,24,14248
15,8,2014,Sainsburys,Groceries,66,14182
15,8,2014,Caffe Nero,Eating Out,1,14181
15,8,2014,Subway,Eating Out,8,14173
16,8,2014,LBS Council Tax,Bills,20,14153
17,8,2014,Tool Tec,,5,14148
18,8,2014,South West Trains,Transport,19,14129
18,8,2014,Wild Bean Cafe,Eating Out,2,14127
18,8,2014,Greggs,Eating Out,8,14119
19,8,2014,Starbucks Coffee,Eating Out,1,14118
19,8,2014,Pret A Manger,Eating Out,7,14111
20,8,2014,VIRGIN MEDIA PYMTS,Bills,18,14093
20,8,2014,Caffe Nero,Eating Out,2,14091
21,8,2014,McDonalds,Eating Out,5,14086
22,8,2014,Waitrose,Groceries,40,14046
22,8,2014,The West Cornwall Pasty Company,Eating Out,7,14039
22,8,2014,ATM Cash Withdrawal,General,10,14029
23,8,2014,Ministry of Sound ClubXOYO Club,Eating Out,7,14022
23,8,2014,Ministry of Sound ClubXOYO Club,Eating Out,16,14006
23,8,2014,Dominos Pizza,Eating Out,41,13965
24,8,2014,O2,Bills,24,13941
25,8,2014,South West Trains,Transport,19,13922
25,8,2014,Wild Bean Cafe,Eating Out,2,13920
25,8,2014,Chicken Cottage,Eating Out,8,13912
25,8,2014,ATM Cash Withdrawal,General,10,13902
25,8,2014,Cheam Service Station,,4,13898
26,8,2014,Wild Bean Cafe,Eating Out,2,13896
27,8,2014,Caffe Nero,Eating Out,2,13894
27,8,2014,McDonalds,Eating Out,6,13888
28,8,2014,Starbucks Coffee,Eating Out,2,13886
28,8,2014,Subway,Eating Out,6,13880
29,8,2014,ASDA,Groceries,72,13808
29,8,2014,Wild Bean Cafe,Eating Out,2,13806
1,9,2014,Rhino Sports salary,General,1600,15406
1,9,2014,South West Trains,Transport,20,15386
1,9,2014,Pret A Manger,Eating Out,8,15378
2,9,2014,Caffe Nero,Eating Out,2,15376
3,9,2014,Wild Bean Cafe,Eating Out,2,15374
3,9,2014,The West Cornwall Pasty Company,Eating Out,7,15367
4,9,2014,Starbucks Coffee,Eating Out,2,15365
4,9,2014,Pret A Manger,Eating Out,5,15360
4,9,2014,Cheam Service Station,,8,15352
5,9,2014,Morrisons,Groceries,44,15308
5,9,2014,Greggs,Eating Out,5,15303
5,9,2014,ATM Cash Withdrawal,General,20,15283
6,9,2014,Dominos Pizza,Eating Out,55,15228
7,9,2014,Cubit and West rent,Rent,400,14828
7,9,2014,ATM Cash Withdrawal,General,20,14808
8,9,2014,South West Trains,Transport,21,14787
8,9,2014,Starbucks Coffee,Eating Out,1,14786
9,9,2014,Chicken Cottage,Eating Out,6,14780
10,9,2014,Costa Coffee,Eating Out,1,14779
10,9,2014,The West Cornwall Pasty Company,Eating Out,8,14771
11,9,2014,Caffe Nero,Eating Out,1,14770
11,9,2014,Civic Shop,,9,14761
12,9,2014,Waitrose,Groceries,44,14717
12,9,2014,Starbucks Coffee,Eating Out,2,14715
12,9,2014,Greggs,Eating Out,6,14709
12,9,2014,Scott's Restaurant,Eating Out,58,14651
12,9,2014,ATM Cash Withdrawal,General,20,14631
13,9,2014,Fabric Club,Eating Out,16,14615
13,9,2014,Fabric Club,Eating Out,15,14600
13,9,2014,Fabric Club,Eating Out,15,14585
13,9,2014,Fabric Club,Eating Out,14,14571
13,9,2014,Anglo restaurant,Eating Out,29,14542
13,9,2014,ATM Cash Withdrawal,General,20,14522
14,9,2014,Restaurant Gordon RamsayPortland Restaurant,Eating Out,32,14490
15,9,2014,BRGAS-Electricity,Bills,21,14469
15,9,2014,BRGAS-Gas,Bills,16,14453
15,9,2014,South West Trains,Transport,21,14432
15,9,2014,Caffe Nero,Eating Out,1,14431
16,9,2014,LBS Council Tax,Bills,20,14411
16,9,2014,Costa Coffee,Eating Out,1,14410
17,9,2014,Starbucks Coffee,Eating Out,2,14408
17,9,2014,McDonalds,Eating Out,7,14401
18,9,2014,Subway,Eating Out,8,14393
19,9,2014,Morrisons,Groceries,47,14346
19,9,2014,Wild Bean Cafe,Eating Out,2,14344
19,9,2014,Chicken Cottage,Eating Out,6,14338
19,9,2014,Ministry of Sound ClubXOYO Club,Eating Out,5,14333
19,9,2014,Ministry of Sound ClubXOYO Club,Eating Out,11,14322
19,9,2014,Ministry of Sound ClubXOYO Club,Eating Out,14,14308
19,9,2014,Ministry of Sound ClubXOYO Club,Eating Out,16,14292
19,9,2014,ATM Cash Withdrawal,General,20,14272
20,9,2014,VIRGIN MEDIA PYMTS,Bills,28,14244
20,9,2014,Pizza Express,Eating Out,47,14197
20,9,2014,ATM Cash Withdrawal,General,20,14177
22,9,2014,South West Trains,Transport,25,14152
22,9,2014,Starbucks Coffee,Eating Out,2,14150
22,9,2014,Greggs,Eating Out,7,14143
22,9,2014,Tool Tec,,3,14140
23,9,2014,Wild Bean Cafe,Eating Out,2,14138
23,9,2014,Greggs,Eating Out,6,14132
24,9,2014,O2,Bills,24,14108
24,9,2014,Pret A Manger,Eating Out,6,14102
25,9,2014,Costa Coffee,Eating Out,1,14101
25,9,2014,Greggs,Eating Out,4,14097
26,9,2014,Tescos,Groceries,69,14028
26,9,2014,Caffe Nero,Eating Out,2,14026
26,9,2014,McDonalds,Eating Out,8,14018
27,9,2014,Red Shop,,6,14012
28,9,2014,Red Shop,,5,14007
29,9,2014,South West Trains,Transport,22,13985
29,9,2014,Subway,Eating Out,8,13977
29,9,2014,ATM Cash Withdrawal,General,20,13957
30,9,2014,Starbucks Coffee,Eating Out,2,13955
30,9,2014,Chicken Cottage,Eating Out,6,13949
1,10,2014,Rhino Sports salary,General,1600,15549
1,10,2014,Costa Coffee,Eating Out,1,15548
2,10,2014,Wild Bean Cafe,Eating Out,2,15546
2,10,2014,ATM Cash Withdrawal,General,10,15536
3,10,2014,Sainsburys,Groceries,73,15463
4,10,2014,Restaurant Gordon RamsayPortland Restaurant,Eating Out,59,15404
5,10,2014,Anglo restaurant,Eating Out,43,15361
6,10,2014,South West Trains,Transport,23,15338
6,10,2014,Starbucks Coffee,Eating Out,2,15336
7,10,2014,Cubit and West rent,Rent,400,14936
7,10,2014,Caffe Nero,Eating Out,2,14934
7,10,2014,Chicken Cottage,Eating Out,6,14928
8,10,2014,Wild Bean Cafe,Eating Out,2,14926
8,10,2014,Subway,Eating Out,8,14918
8,10,2014,ATM Cash Withdrawal,General,10,14908
9,10,2014,Caffe Nero,Eating Out,2,14906
9,10,2014,Subway,Eating Out,5,14901
10,10,2014,Tescos,Groceries,72,14829
10,10,2014,Starbucks Coffee,Eating Out,2,14827
10,10,2014,Pizza Express,Eating Out,39,14788
11,10,2014,Dominos Pizza,Eating Out,38,14750
11,10,2014,ATM Cash Withdrawal,General,10,14740
11,10,2014,Paying back James,,4,14736
12,10,2014,Dominos Pizza,Eating Out,34,14702
12,10,2014,ATM Cash Withdrawal,General,20,14682
13,10,2014,South West Trains,Transport,22,14660
13,10,2014,McDonalds,Eating Out,5,14655
14,10,2014,Wild Bean Cafe,Eating Out,2,14653
14,10,2014,Greggs,Eating Out,8,14645
15,10,2014,BRGAS-Electricity,Bills,26,14619
15,10,2014,BRGAS-Gas,Bills,16,14603
15,10,2014,Starbucks Coffee,Eating Out,2,14601
16,10,2014,LBS Council Tax,Bills,20,14581
16,10,2014,Costa Coffee,Eating Out,2,14579
16,10,2014,The West Cornwall Pasty Company,Eating Out,5,14574
17,10,2014,Waitrose,Groceries,47,14527
17,10,2014,Costa Coffee,Eating Out,2,14525
17,10,2014,The West Cornwall Pasty Company,Eating Out,7,14518
18,10,2014,ATM Cash Withdrawal,General,10,14508
19,10,2014,Tool Shop,,4,14504
20,10,2014,VIRGIN MEDIA PYMTS,Bills,28,14476
20,10,2014,South West Trains,Transport,19,14457
21,10,2014,Subway,Eating Out,7,14450
21,10,2014,ATM Cash Withdrawal,General,10,14440
22,10,2014,Pret A Manger,Eating Out,5,14435
23,10,2014,Pret A Manger,Eating Out,6,14429
24,10,2014,O2,Bills,22,14407
24,10,2014,Waitrose,Groceries,51,14356
24,10,2014,Wild Bean Cafe,Eating Out,1,14355
24,10,2014,The West Cornwall Pasty Company,Eating Out,5,14350
27,10,2014,South West Trains,Transport,16,14334
27,10,2014,Pret A Manger,Eating Out,5,14329
28,10,2014,Costa Coffee,Eating Out,2,14327
28,10,2014,ATM Cash Withdrawal,General,10,14317
29,10,2014,Caffe Nero,Eating Out,2,14315
29,10,2014,Chicken Cottage,Eating Out,7,14308
30,10,2014,Caffe Nero,Eating Out,1,14307
31,10,2014,ASDA,Groceries,69,14238
31,10,2014,Caffe Nero,Eating Out,2,14236
31,10,2014,ATM Cash Withdrawal,General,10,14226
1,11,2014,Rhino Sports salary,General,1600,15826
1,11,2014,Anglo restaurant,Eating Out,27,15799
3,11,2014,South West Trains,Transport,17,15782
3,11,2014,Costa Coffee,Eating Out,1,15781
3,11,2014,McDonalds,Eating Out,8,15773
4,11,2014,Wild Bean Cafe,Eating Out,1,15772
4,11,2014,ATM Cash Withdrawal,General,10,15762
5,11,2014,Starbucks Coffee,Eating Out,1,15761
5,11,2014,McDonalds,Eating Out,6,15755
6,11,2014,Caffe Nero,Eating Out,2,15753
6,11,2014,Greggs,Eating Out,4,15749
6,11,2014,ATM Cash Withdrawal,General,20,15729
7,11,2014,Cubit and West rent,Rent,400,15329
7,11,2014,Sainsburys,Groceries,64,15265
7,11,2014,Starbucks Coffee,Eating Out,1,15264
7,11,2014,Pizza Express,Eating Out,43,15221
7,11,2014,Tool Tec,,2,15219
10,11,2014,South West Trains,Transport,22,15197
10,11,2014,Wild Bean Cafe,Eating Out,1,15196
10,11,2014,Chicken Cottage,Eating Out,7,15189
11,11,2014,Caffe Nero,Eating Out,2,15187
11,11,2014,Chicken Cottage,Eating Out,7,15180
12,11,2014,Costa Coffee,Eating Out,2,15178
12,11,2014,Pret A Manger,Eating Out,6,15172
12,11,2014,Red Shop,,3,15169
13,11,2014,Chicken Cottage,Eating Out,5,15164
14,11,2014,Sainsburys,Groceries,47,15117
14,11,2014,Costa Coffee,Eating Out,2,15115
14,11,2014,The West Cornwall Pasty Company,Eating Out,5,15110
14,11,2014,Anglo restaurant,Eating Out,48,15062
15,11,2014,BRGAS-Electricity,Bills,51,15011
15,11,2014,BRGAS-Gas,Bills,39,14972
15,11,2014,Fabric Club,Eating Out,16,14956
15,11,2014,Fabric Club,Eating Out,6,14950
15,11,2014,Fabric Club,Eating Out,11,14939
15,11,2014,Fabric Club,Eating Out,8,14931
15,11,2014,Fabric Club,Eating Out,14,14917
16,11,2014,LBS Council Tax,Bills,20,14897
16,11,2014,Civic Shop,,7,14890
17,11,2014,South West Trains,Transport,21,14869
17,11,2014,Wild Bean Cafe,Eating Out,1,14868
17,11,2014,ATM Cash Withdrawal,General,20,14848
18,11,2014,Caffe Nero,Eating Out,2,14846
18,11,2014,The West Cornwall Pasty Company,Eating Out,4,14842
18,11,2014,Paying back James,,7,14835
19,11,2014,Caffe Nero,Eating Out,2,14833
19,11,2014,McDonalds,Eating Out,6,14827
19,11,2014,Tool Tec,,4,14823
20,11,2014,VIRGIN MEDIA PYMTS,Bills,14,14809
20,11,2014,Starbucks Coffee,Eating Out,2,14807
20,11,2014,Chicken Cottage,Eating Out,4,14803
21,11,2014,Waitrose,Groceries,69,14734
21,11,2014,Costa Coffee,Eating Out,2,14732
21,11,2014,McDonalds,Eating Out,4,14728
22,11,2014,Scott's Restaurant,Eating Out,24,14704
23,11,2014,Anglo restaurant,Eating Out,52,14652
24,11,2014,O2,Bills,21,14631
24,11,2014,South West Trains,Transport,22,14609
24,11,2014,Wild Bean Cafe,Eating Out,1,14608
25,11,2014,Greggs,Eating Out,8,14600
25,11,2014,ATM Cash Withdrawal,General,10,14590
26,11,2014,Wild Bean Cafe,Eating Out,2,14588
26,11,2014,McDonalds,Eating Out,6,14582
26,11,2014,Cheam Service Station,,2,14580
27,11,2014,Caffe Nero,Eating Out,2,14578
28,11,2014,ASDA,Groceries,66,14512
28,11,2014,The West Cornwall Pasty Company,Eating Out,8,14504
29,11,2014,Fabric Club,Eating Out,5,14499
29,11,2014,Fabric Club,Eating Out,12,14487
29,11,2014,Fabric Club,Eating Out,9,14478
29,11,2014,Fabric Club,Eating Out,5,14473
29,11,2014,Fabric Club,Eating Out,12,14461
29,11,2014,Fabric Club,Eating Out,14,14447
30,11,2014,Anglo restaurant,Eating Out,36,14411
30,11,2014,Paying back James,,1,14410
1,12,2014,Rhino Sports salary,General,1600,16010
1,12,2014,South West Trains,Transport,22,15988
1,12,2014,Caffe Nero,Eating Out,2,15986
1,12,2014,Pret A Manger,Eating Out,8,15978
2,12,2014,Chicken Cottage,Eating Out,5,15973
2,12,2014,ATM Cash Withdrawal,General,20,15953
4,12,2014,Wild Bean Cafe,Eating Out,2,15951
4,12,2014,Pret A Manger,Eating Out,6,15945
5,12,2014,Waitrose,Groceries,56,15889
5,12,2014,Wild Bean Cafe,Eating Out,2,15887
5,12,2014,Greggs,Eating Out,8,15879
5,12,2014,Restaurant Gordon RamsayPortland Restaurant,Eating Out,42,15837
5,12,2014,ATM Cash Withdrawal,General,20,15817
5,12,2014,Civic Shop,,6,15811
6,12,2014,Fabric Club,Eating Out,5,15806
6,12,2014,Fabric Club,Eating Out,15,15791
6,12,2014,Fabric Club,Eating Out,9,15782
7,12,2014,Cubit and West rent,Rent,400,15382
8,12,2014,South West Trains,Transport,20,15362
8,12,2014,Wild Bean Cafe,Eating Out,2,15360
9,12,2014,Chicken Cottage,Eating Out,8,15352
9,12,2014,ATM Cash Withdrawal,General,20,15332
10,12,2014,Chicken Cottage,Eating Out,5,15327
11,12,2014,Costa Coffee,Eating Out,2,15325
11,12,2014,McDonalds,Eating Out,7,15318
11,12,2014,ATM Cash Withdrawal,General,10,15308
12,12,2014,Morrisons,Groceries,64,15244
12,12,2014,Caffe Nero,Eating Out,1,15243
13,12,2014,Anglo restaurant,Eating Out,33,15210
13,12,2014,ATM Cash Withdrawal,General,10,15200
15,12,2014,BRGAS-Electricity,Bills,29,15171
15,12,2014,BRGAS-Gas,Bills,27,15144
15,12,2014,South West Trains,Transport,25,15119
16,12,2014,LBS Council Tax,Bills,20,15099
16,12,2014,Wild Bean Cafe,Eating Out,2,15097
16,12,2014,Subway,Eating Out,8,15089
16,12,2014,ATM Cash Withdrawal,General,20,15069
17,12,2014,Pret A Manger,Eating Out,7,15062
17,12,2014,ATM Cash Withdrawal,General,10,15052
17,12,2014,Tool Tec,,4,15048
18,12,2014,Caffe Nero,Eating Out,2,15046
18,12,2014,Pret A Manger,Eating Out,8,15038
19,12,2014,Tescos,Groceries,55,14983
19,12,2014,Pret A Manger,Eating Out,8,14975
20,12,2014,VIRGIN MEDIA PYMTS,Bills,29,14946
20,12,2014,The Grand Pub,Eating Out,6,14940
20,12,2014,The Grand Pub,Eating Out,9,14931
20,12,2014,The Grand Pub,Eating Out,5,14926
21,12,2014,Restaurant Gordon RamsayPortland Restaurant,Eating Out,34,14892
21,12,2014,ATM Cash Withdrawal,General,10,14882
22,12,2014,South West Trains,Transport,18,14864
22,12,2014,Caffe Nero,Eating Out,1,14863
23,12,2014,Caffe Nero,Eating Out,2,14861
24,12,2014,O2,Bills,25,14836
24,12,2014,Wild Bean Cafe,Eating Out,2,14834
25,12,2014,Caffe Nero,Eating Out,1,14833
25,12,2014,ATM Cash Withdrawal,General,10,14823
26,12,2014,Morrisons,Groceries,55,14768
26,12,2014,Caffe Nero,Eating Out,1,14767
26,12,2014,Ministry of Sound ClubXOYO Club,Eating Out,6,14761
26,12,2014,Ministry of Sound ClubXOYO Club,Eating Out,16,14745
26,12,2014,Ministry of Sound ClubXOYO Club,Eating Out,13,14732
26,12,2014,Ministry of Sound ClubXOYO Club,Eating Out,13,14719
26,12,2014,Restaurant Gordon RamsayPortland Restaurant,Eating Out,56,14663
29,12,2014,South West Trains,Transport,20,14643
29,12,2014,Starbucks Coffee,Eating Out,2,14641
29,12,2014,Chicken Cottage,Eating Out,6,14635
30,12,2014,Wild Bean Cafe,Eating Out,1,14634
30,12,2014,ATM Cash Withdrawal,General,10,14624
1,1,2015,Rhino Sports salary,General,1600,16224
1,1,2015,Caffe Nero,Eating Out,1,16223
1,1,2015,Greggs,Eating Out,7,16216
2,1,2015,Tescos,Groceries,40,16176
2,1,2015,Starbucks Coffee,Eating Out,2,16174
2,1,2015,Subway,Eating Out,5,16169
2,1,2015,The Grand Pub,Eating Out,9,16160
2,1,2015,Pizza Express,Eating Out,25,16135
2,1,2015,ATM Cash Withdrawal,General,10,16125
3,1,2015,Scott's Restaurant,Eating Out,38,16087
3,1,2015,ATM Cash Withdrawal,General,20,16067
4,1,2015,Pizza Express,Eating Out,40,16027
4,1,2015,ATM Cash Withdrawal,General,10,16017
5,1,2015,South West Trains,Transport,25,15992
5,1,2015,Greggs,Eating Out,5,15987
6,1,2015,Costa Coffee,Eating Out,2,15985
6,1,2015,McDonalds,Eating Out,6,15979
7,1,2015,Cubit and West rent,Rent,400,15579
8,1,2015,Starbucks Coffee,Eating Out,2,15577
8,1,2015,The West Cornwall Pasty Company,Eating Out,6,15571
8,1,2015,ATM Cash Withdrawal,General,20,15551
9,1,2015,ASDA,Groceries,73,15478
9,1,2015,Wild Bean Cafe,Eating Out,2,15476
9,1,2015,Greggs,Eating Out,4,15472
9,1,2015,Ministry of Sound ClubXOYO Club,Eating Out,12,15460
9,1,2015,Ministry of Sound ClubXOYO Club,Eating Out,11,15449
9,1,2015,Restaurant Gordon RamsayPortland Restaurant,Eating Out,34,15415
9,1,2015,ATM Cash Withdrawal,General,20,15395
9,1,2015,Tool Shop,,7,15388
10,1,2015,ATM Cash Withdrawal,General,10,15378
10,1,2015,Paying back Julie,,9,15369
11,1,2015,Pizza Express,Eating Out,29,15340
12,1,2015,South West Trains,Transport,21,15319
12,1,2015,Costa Coffee,Eating Out,2,15317
13,1,2015,ATM Cash Withdrawal,General,20,15297
14,1,2015,Costa Coffee,Eating Out,1,15296
14,1,2015,ATM Cash Withdrawal,General,20,15276
15,1,2015,BRGAS-Electricity,Bills,40,15236
15,1,2015,BRGAS-Gas,Bills,26,15210
15,1,2015,Wild Bean Cafe,Eating Out,1,15209
15,1,2015,Pret A Manger,Eating Out,4,15205
16,1,2015,LBS Council Tax,Bills,20,15185
16,1,2015,Morrisons,Groceries,72,15113
16,1,2015,Subway,Eating Out,8,15105
16,1,2015,Fabric Club,Eating Out,5,15100
19,1,2015,South West Trains,Transport,17,15083
19,1,2015,Starbucks Coffee,Eating Out,2,15081
19,1,2015,Subway,Eating Out,7,15074
20,1,2015,VIRGIN MEDIA PYMTS,Bills,22,15052
20,1,2015,Costa Coffee,Eating Out,1,15051
20,1,2015,Greggs,Eating Out,4,15047
21,1,2015,Wild Bean Cafe,Eating Out,2,15045
21,1,2015,Greggs,Eating Out,8,15037
22,1,2015,McDonalds,Eating Out,8,15029
23,1,2015,Sainsburys,Groceries,68,14961
23,1,2015,Caffe Nero,Eating Out,2,14959
23,1,2015,McDonalds,Eating Out,8,14951
24,1,2015,O2,Bills,21,14930
24,1,2015,Paying back James,,9,14921
25,1,2015,Scott's Restaurant,Eating Out,37,14884
26,1,2015,South West Trains,Transport,23,14861
26,1,2015,Caffe Nero,Eating Out,1,14860
26,1,2015,The West Cornwall Pasty Company,Eating Out,5,14855
27,1,2015,Starbucks Coffee,Eating Out,2,14853
27,1,2015,Chicken Cottage,Eating Out,8,14845
28,1,2015,McDonalds,Eating Out,7,14838
30,1,2015,ASDA,Groceries,37,14801
30,1,2015,Caffe Nero,Eating Out,2,14799
30,1,2015,Subway,Eating Out,8,14791
31,1,2015,Tool Tec,,9,14782
1,2,2015,Rhino Sports salary,General,1600,16382
2,2,2015,South West Trains,Transport,19,16363
2,2,2015,Caffe Nero,Eating Out,2,16361
2,2,2015,Pret A Manger,Eating Out,5,16356
3,2,2015,Wild Bean Cafe,Eating Out,2,16354
3,2,2015,The West Cornwall Pasty Company,Eating Out,8,16346
4,2,2015,Wild Bean Cafe,Eating Out,1,16345
4,2,2015,Pret A Manger,Eating Out,7,16338
4,2,2015,ATM Cash Withdrawal,General,20,16318
5,2,2015,Caffe Nero,Eating Out,2,16316
5,2,2015,McDonalds,Eating Out,6,16310
6,2,2015,Morrisons,Groceries,48,16262
6,2,2015,Starbucks Coffee,Eating Out,2,16260
6,2,2015,Pret A Manger,Eating Out,4,16256
6,2,2015,Heaven Club,Eating Out,8,16248
6,2,2015,Heaven Club,Eating Out,8,16240
6,2,2015,Heaven Club,Eating Out,14,16226
6,2,2015,Heaven Club,Eating Out,9,16217
6,2,2015,Heaven Club,Eating Out,7,16210
6,2,2015,Heaven Club,Eating Out,15,16195
6,2,2015,Dominos Pizza,Eating Out,48,16147
6,2,2015,Paying back James,,8,16139
7,2,2015,Cubit and West rent,Rent,400,15739
8,2,2015,Pizza Express,Eating Out,25,15714
9,2,2015,South West Trains,Transport,25,15689
10,2,2015,Caffe Nero,Eating Out,2,15687
10,2,2015,ATM Cash Withdrawal,General,10,15677
10,2,2015,Cheam Service Station,,5,15672
11,2,2015,Wild Bean Cafe,Eating Out,1,15671
11,2,2015,Greggs,Eating Out,8,15663
12,2,2015,Caffe Nero,Eating Out,2,15661
12,2,2015,The West Cornwall Pasty Company,Eating Out,6,15655
13,2,2015,Waitrose,Groceries,39,15616
13,2,2015,Chicken Cottage,Eating Out,6,15610
15,2,2015,BRGAS-Electricity,Bills,18,15592
15,2,2015,BRGAS-Gas,Bills,19,15573
15,2,2015,ATM Cash Withdrawal,General,20,15553
16,2,2015,LBS Council Tax,Bills,20,15533
16,2,2015,South West Trains,Transport,17,15516
16,2,2015,Wild Bean Cafe,Eating Out,2,15514
17,2,2015,ATM Cash Withdrawal,General,20,15494
18,2,2015,Costa Coffee,Eating Out,1,15493
18,2,2015,ATM Cash Withdrawal,General,10,15483
19,2,2015,Wild Bean Cafe,Eating Out,2,15481
19,2,2015,Chicken Cottage,Eating Out,8,15473
20,2,2015,VIRGIN MEDIA PYMTS,Bills,20,15453
20,2,2015,Waitrose,Groceries,49,15404
20,2,2015,Costa Coffee,Eating Out,2,15402
20,2,2015,Pret A Manger,Eating Out,7,15395
20,2,2015,ATM Cash Withdrawal,General,10,15385
20,2,2015,Cheam Service Station,,8,15377
21,2,2015,Fabric Club,Eating Out,6,15371
21,2,2015,Fabric Club,Eating Out,13,15358
21,2,2015,Fabric Club,Eating Out,8,15350
21,2,2015,Fabric Club,Eating Out,5,15345
22,2,2015,Anglo restaurant,Eating Out,55,15290
23,2,2015,South West Trains,Transport,20,15270
24,2,2015,O2,Bills,22,15248
24,2,2015,Wild Bean Cafe,Eating Out,2,15246
24,2,2015,Paying back James,,1,15245
25,2,2015,Pret A Manger,Eating Out,8,15237
25,2,2015,ATM Cash Withdrawal,General,10,15227
26,2,2015,Caffe Nero,Eating Out,2,15225
26,2,2015,Pret A Manger,Eating Out,4,15221
27,2,2015,Waitrose,Groceries,58,15163
27,2,2015,Wild Bean Cafe,Eating Out,2,15161
27,2,2015,Subway,Eating Out,5,15156
28,2,2015,Dominos Pizza,Eating Out,28,15128
1,3,2015,Rhino Sports salary,General,1600,16728
1,3,2015,ATM Cash Withdrawal,General,10,16718
2,3,2015,South West Trains,Transport,23,16695
2,3,2015,Caffe Nero,Eating Out,1,16694
3,3,2015,Caffe Nero,Eating Out,1,16693
3,3,2015,Chicken Cottage,Eating Out,6,16687
3,3,2015,Red Shop,,4,16683
4,3,2015,Starbucks Coffee,Eating Out,1,16682
5,3,2015,Starbucks Coffee,Eating Out,2,16680
5,3,2015,Cheam Service Station,,1,16679
6,3,2015,Waitrose,Groceries,43,16636
6,3,2015,Costa Coffee,Eating Out,2,16634
7,3,2015,Cubit and West rent,Rent,400,16234
7,3,2015,Restaurant Gordon RamsayPortland Restaurant,Eating Out,46,16188
9,3,2015,South West Trains,Transport,18,16170
9,3,2015,Costa Coffee,Eating Out,2,16168
10,3,2015,Costa Coffee,Eating Out,1,16167
11,3,2015,Starbucks Coffee,Eating Out,2,16165
12,3,2015,Starbucks Coffee,Eating Out,2,16163
12,3,2015,Chicken Cottage,Eating Out,8,16155
13,3,2015,Waitrose,Groceries,68,16087
13,3,2015,Wild Bean Cafe,Eating Out,2,16085
13,3,2015,Greggs,Eating Out,4,16081
13,3,2015,Pizza Express,Eating Out,35,16046
13,3,2015,Paying back Julie,,5,16041
14,3,2015,Dominos Pizza,Eating Out,52,15989
14,3,2015,ATM Cash Withdrawal,General,20,15969
15,3,2015,BRGAS-Electricity,Bills,28,15941
15,3,2015,BRGAS-Gas,Bills,15,15926
16,3,2015,LBS Council Tax,Bills,20,15906
16,3,2015,South West Trains,Transport,23,15883
16,3,2015,Pret A Manger,Eating Out,5,15878
17,3,2015,Caffe Nero,Eating Out,1,15877
17,3,2015,Greggs,Eating Out,6,15871
17,3,2015,ATM Cash Withdrawal,General,10,15861
18,3,2015,Starbucks Coffee,Eating Out,1,15860
19,3,2015,Costa Coffee,Eating Out,2,15858
20,3,2015,VIRGIN MEDIA PYMTS,Bills,21,15837
20,3,2015,ASDA,Groceries,35,15802
20,3,2015,Starbucks Coffee,Eating Out,1,15801
20,3,2015,Subway,Eating Out,4,15797
20,3,2015,Cheam Service Station,,4,15793
21,3,2015,Dominos Pizza,Eating Out,48,15745
21,3,2015,ATM Cash Withdrawal,General,10,15735
22,3,2015,ATM Cash Withdrawal,General,10,15725
23,3,2015,South West Trains,Transport,16,15709
23,3,2015,Caffe Nero,Eating Out,1,15708
24,3,2015,O2,Bills,24,15684
24,3,2015,Caffe Nero,Eating Out,2,15682
24,3,2015,Chicken Cottage,Eating Out,8,15674
25,3,2015,Caffe Nero,Eating Out,2,15672
26,3,2015,Caffe Nero,Eating Out,2,15670
26,3,2015,Tool Tec,,8,15662
27,3,2015,Waitrose,Groceries,52,15610
27,3,2015,Starbucks Coffee,Eating Out,1,15609
27,3,2015,Ministry of Sound ClubXOYO Club,Eating Out,16,15593
27,3,2015,Ministry of Sound ClubXOYO Club,Eating Out,12,15581
27,3,2015,Ministry of Sound ClubXOYO Club,Eating Out,5,15576
27,3,2015,Ministry of Sound ClubXOYO Club,Eating Out,13,15563
27,3,2015,Ministry of Sound ClubXOYO Club,Eating Out,15,15548
27,3,2015,Dominos Pizza,Eating Out,41,15507
28,3,2015,Pizza Express,Eating Out,50,15457
28,3,2015,ATM Cash Withdrawal,General,20,15437
29,3,2015,Cheam Service Station,,1,15436
30,3,2015,South West Trains,Transport,22,15414
30,3,2015,Chicken Cottage,Eating Out,5,15409
30,3,2015,ATM Cash Withdrawal,General,10,15399
31,3,2015,McDonalds,Eating Out,6,15393
1,4,2015,Rhino Sports salary,General,1600,16993
1,4,2015,Chicken Cottage,Eating Out,4,16989
1,4,2015,Civic Shop,,5,16984
2,4,2015,Caffe Nero,Eating Out,2,16982
2,4,2015,McDonalds,Eating Out,7,16975
3,4,2015,Waitrose,Groceries,72,16903
3,4,2015,Wild Bean Cafe,Eating Out,2,16901
3,4,2015,Chicken Cottage,Eating Out,5,16896
5,4,2015,Restaurant Gordon RamsayPortland Restaurant,Eating Out,28,16868
6,4,2015,South West Trains,Transport,21,16847
6,4,2015,McDonalds,Eating Out,8,16839
6,4,2015,Red Shop,,4,16835
7,4,2015,Cubit and West rent,Rent,400,16435
7,4,2015,Costa Coffee,Eating Out,2,16433
7,4,2015,The West Cornwall Pasty Company,Eating Out,5,16428
7,4,2015,ATM Cash Withdrawal,General,20,16408
9,4,2015,Starbucks Coffee,Eating Out,2,16406
9,4,2015,Chicken Cottage,Eating Out,5,16401
9,4,2015,ATM Cash Withdrawal,General,20,16381
10,4,2015,Sainsburys,Groceries,74,16307
10,4,2015,Costa Coffee,Eating Out,2,16305
11,4,2015,Restaurant Gordon RamsayPortland Restaurant,Eating Out,47,16258
13,4,2015,South West Trains,Transport,24,16234
13,4,2015,Caffe Nero,Eating Out,1,16233
13,4,2015,Subway,Eating Out,5,16228
14,4,2015,Starbucks Coffee,Eating Out,2,16226
14,4,2015,ATM Cash Withdrawal,General,10,16216
15,4,2015,BRGAS-Electricity,Bills,17,16199
15,4,2015,BRGAS-Gas,Bills,24,16175
15,4,2015,Wild Bean Cafe,Eating Out,2,16173
16,4,2015,LBS Council Tax,Bills,20,16153
16,4,2015,Caffe Nero,Eating Out,2,16151
16,4,2015,The West Cornwall Pasty Company,Eating Out,8,16143
17,4,2015,Sainsburys,Groceries,43,16100
17,4,2015,Wild Bean Cafe,Eating Out,1,16099
17,4,2015,McDonalds,Eating Out,7,16092
17,4,2015,Anglo restaurant,Eating Out,41,16051
18,4,2015,Anglo restaurant,Eating Out,51,16000
20,4,2015,VIRGIN MEDIA PYMTS,Bills,15,15985
20,4,2015,South West Trains,Transport,25,15960
20,4,2015,Wild Bean Cafe,Eating Out,2,15958
20,4,2015,Subway,Eating Out,4,15954
21,4,2015,Costa Coffee,Eating Out,2,15952
21,4,2015,Pret A Manger,Eating Out,5,15947
22,4,2015,Wild Bean Cafe,Eating Out,1,15946
23,4,2015,Wild Bean Cafe,Eating Out,1,15945
23,4,2015,The West Cornwall Pasty Company,Eating Out,8,15937
24,4,2015,O2,Bills,20,15917
24,4,2015,Morrisons,Groceries,47,15870
24,4,2015,Restaurant Gordon RamsayPortland Restaurant,Eating Out,55,15815
25,4,2015,Anglo restaurant,Eating Out,44,15771
26,4,2015,ATM Cash Withdrawal,General,10,15761
26,4,2015,Red Shop,,9,15752
27,4,2015,South West Trains,Transport,22,15730
27,4,2015,Starbucks Coffee,Eating Out,2,15728
28,4,2015,Caffe Nero,Eating Out,2,15726
28,4,2015,Pret A Manger,Eating Out,6,15720
29,4,2015,Wild Bean Cafe,Eating Out,1,15719
29,4,2015,The West Cornwall Pasty Company,Eating Out,6,15713
30,4,2015,Wild Bean Cafe,Eating Out,2,15711
30,4,2015,ATM Cash Withdrawal,General,10,15701
1,5,2015,Rhino Sports salary,General,1600,17301
1,5,2015,Waitrose,Groceries,71,17230
1,5,2015,Starbucks Coffee,Eating Out,2,17228
1,5,2015,McDonalds,Eating Out,4,17224
1,5,2015,Restaurant Gordon RamsayPortland Restaurant,Eating Out,25,17199
2,5,2015,Civic Shop,,3,17196
3,5,2015,ATM Cash Withdrawal,General,20,17176
4,5,2015,South West Trains,Transport,24,17152
4,5,2015,Costa Coffee,Eating Out,2,17150
4,5,2015,Greggs,Eating Out,4,17146
5,5,2015,Caffe Nero,Eating Out,2,17144
5,5,2015,Chicken Cottage,Eating Out,7,17137
6,5,2015,Wild Bean Cafe,Eating Out,1,17136
6,5,2015,The West Cornwall Pasty Company,Eating Out,7,17129
7,5,2015,Cubit and West rent,Rent,400,16729
8,5,2015,Sainsburys,Groceries,64,16665
8,5,2015,Starbucks Coffee,Eating Out,1,16664
8,5,2015,Pret A Manger,Eating Out,6,16658
8,5,2015,ATM Cash Withdrawal,General,20,16638
9,5,2015,ATM Cash Withdrawal,General,20,16618
11,5,2015,South West Trains,Transport,22,16596
11,5,2015,Costa Coffee,Eating Out,2,16594
12,5,2015,Costa Coffee,Eating Out,1,16593
13,5,2015,Starbucks Coffee,Eating Out,1,16592
15,5,2015,BRGAS-Electricity,Bills,29,16563
15,5,2015,BRGAS-Gas,Bills,25,16538
15,5,2015,Morrisons,Groceries,43,16495
15,5,2015,Wild Bean Cafe,Eating Out,2,16493
16,5,2015,LBS Council Tax,Bills,20,16473
17,5,2015,Pizza Express,Eating Out,54,16419
18,5,2015,South West Trains,Transport,16,16403
18,5,2015,Subway,Eating Out,7,16396
19,5,2015,Caffe Nero,Eating Out,2,16394
19,5,2015,Greggs,Eating Out,7,16387
20,5,2015,VIRGIN MEDIA PYMTS,Bills,16,16371
20,5,2015,Costa Coffee,Eating Out,2,16369
20,5,2015,ATM Cash Withdrawal,General,10,16359
21,5,2015,Starbucks Coffee,Eating Out,2,16357
21,5,2015,Subway,Eating Out,5,16352
21,5,2015,ATM Cash Withdrawal,General,20,16332
22,5,2015,Waitrose,Groceries,55,16277
22,5,2015,Caffe Nero,Eating Out,2,16275
22,5,2015,The West Cornwall Pasty Company,Eating Out,7,16268
22,5,2015,ATM Cash Withdrawal,General,20,16248
23,5,2015,Fabric Club,Eating Out,8,16240
23,5,2015,Fabric Club,Eating Out,12,16228
23,5,2015,Red Shop,,7,16221
24,5,2015,O2,Bills,25,16196
25,5,2015,South West Trains,Transport,21,16175
25,5,2015,Starbucks Coffee,Eating Out,2,16173
25,5,2015,McDonalds,Eating Out,5,16168
26,5,2015,Caffe Nero,Eating Out,2,16166
26,5,2015,Greggs,Eating Out,6,16160
27,5,2015,Starbucks Coffee,Eating Out,2,16158
27,5,2015,ATM Cash Withdrawal,General,10,16148
28,5,2015,Wild Bean Cafe,Eating Out,2,16146
28,5,2015,Greggs,Eating Out,8,16138
29,5,2015,Tescos,Groceries,56,16082
29,5,2015,Starbucks Coffee,Eating Out,1,16081
29,5,2015,Chicken Cottage,Eating Out,8,16073
29,5,2015,The Grand Pub,Eating Out,5,16068
29,5,2015,The Grand Pub,Eating Out,13,16055
29,5,2015,The Grand Pub,Eating Out,7,16048
29,5,2015,The Grand Pub,Eating Out,12,16036
29,5,2015,The Grand Pub,Eating Out,12,16024
30,5,2015,The Grand Pub,Eating Out,7,16017
30,5,2015,The Grand Pub,Eating Out,12,16005
30,5,2015,The Grand Pub,Eating Out,11,15994
30,5,2015,The Grand Pub,Eating Out,7,15987
30,5,2015,The Grand Pub,Eating Out,7,15980
30,5,2015,The Grand Pub,Eating Out,6,15974
30,5,2015,ATM Cash Withdrawal,General,20,15954
31,5,2015,Pizza Express,Eating Out,41,15913
31,5,2015,Cheam Service Station,,6,15907
1,6,2015,Rhino Sports salary,General,1600,17507
1,6,2015,South West Trains,Transport,23,17484
2,6,2015,Costa Coffee,Eating Out,2,17482
2,6,2015,Cheam Service Station,,6,17476
3,6,2015,Chicken Cottage,Eating Out,4,17472
3,6,2015,ATM Cash Withdrawal,General,10,17462
4,6,2015,Costa Coffee,Eating Out,2,17460
5,6,2015,Morrisons,Groceries,47,17413
5,6,2015,Costa Coffee,Eating Out,2,17411
5,6,2015,McDonalds,Eating Out,5,17406
5,6,2015,ATM Cash Withdrawal,General,20,17386
6,6,2015,Restaurant Gordon RamsayPortland Restaurant,Eating Out,52,17334
7,6,2015,Cubit and West rent,Rent,400,16934
8,6,2015,South West Trains,Transport,17,16917
8,6,2015,Starbucks Coffee,Eating Out,2,16915
8,6,2015,The West Cornwall Pasty Company,Eating Out,8,16907
9,6,2015,Chicken Cottage,Eating Out,5,16902
11,6,2015,Wild Bean Cafe,Eating Out,1,16901
12,6,2015,Tescos,Groceries,54,16847
12,6,2015,Costa Coffee,Eating Out,2,16845
12,6,2015,Pret A Manger,Eating Out,5,16840
12,6,2015,Pizza Express,Eating Out,46,16794
14,6,2015,Scott's Restaurant,Eating Out,34,16760
14,6,2015,ATM Cash Withdrawal,General,10,16750
15,6,2015,BRGAS-Electricity,Bills,24,16726
15,6,2015,BRGAS-Gas,Bills,23,16703
15,6,2015,South West Trains,Transport,23,16680
15,6,2015,Wild Bean Cafe,Eating Out,1,16679
15,6,2015,The West Cornwall Pasty Company,Eating Out,8,16671
16,6,2015,LBS Council Tax,Bills,20,16651
16,6,2015,Costa Coffee,Eating Out,1,16650
17,6,2015,Costa Coffee,Eating Out,2,16648
17,6,2015,Chicken Cottage,Eating Out,5,16643
17,6,2015,ATM Cash Withdrawal,General,10,16633
18,6,2015,Caffe Nero,Eating Out,2,16631
18,6,2015,McDonalds,Eating Out,4,16627
19,6,2015,Tescos,Groceries,57,16570
19,6,2015,Pret A Manger,Eating Out,6,16564
19,6,2015,Restaurant Gordon RamsayPortland Restaurant,Eating Out,31,16533
20,6,2015,VIRGIN MEDIA PYMTS,Bills,23,16510
20,6,2015,Anglo restaurant,Eating Out,34,16476
21,6,2015,ATM Cash Withdrawal,General,20,16456
22,6,2015,South West Trains,Transport,20,16436
22,6,2015,Costa Coffee,Eating Out,1,16435
23,6,2015,Costa Coffee,Eating Out,1,16434
24,6,2015,O2,Bills,25,16409
26,6,2015,Waitrose,Groceries,50,16359
26,6,2015,Caffe Nero,Eating Out,1,16358
26,6,2015,The West Cornwall Pasty Company,Eating Out,8,16350
26,6,2015,Heaven Club,Eating Out,11,16339
26,6,2015,Heaven Club,Eating Out,11,16328
26,6,2015,Heaven Club,Eating Out,5,16323
26,6,2015,Heaven Club,Eating Out,15,16308
26,6,2015,Heaven Club,Eating Out,6,16302
26,6,2015,ATM Cash Withdrawal,General,20,16282
26,6,2015,Tool Shop,,3,16279
28,6,2015,Anglo restaurant,Eating Out,34,16245
29,6,2015,South West Trains,Transport,20,16225
29,6,2015,Caffe Nero,Eating Out,2,16223
29,6,2015,Greggs,Eating Out,5,16218
29,6,2015,ATM Cash Withdrawal,General,10,16208
1,7,2015,Rhino Sports salary,General,1600,17808
1,7,2015,Wild Bean Cafe,Eating Out,1,17807
2,7,2015,McDonalds,Eating Out,8,17799
3,7,2015,Morrisons,Groceries,39,17760
3,7,2015,Greggs,Eating Out,4,17756
5,7,2015,Pizza Express,Eating Out,52,17704
5,7,2015,ATM Cash Withdrawal,General,10,17694
5,7,2015,Tool Tec,,4,17690
6,7,2015,South West Trains,Transport,17,17673
6,7,2015,The West Cornwall Pasty Company,Eating Out,7,17666
7,7,2015,Cubit and West rent,Rent,400,17266
7,7,2015,Starbucks Coffee,Eating Out,1,17265
8,7,2015,Subway,Eating Out,4,17261
9,7,2015,Wild Bean Cafe,Eating Out,1,17260
9,7,2015,The West Cornwall Pasty Company,Eating Out,7,17253
10,7,2015,Tescos,Groceries,51,17202
10,7,2015,Wild Bean Cafe,Eating Out,2,17200
10,7,2015,Greggs,Eating Out,8,17192
10,7,2015,ATM Cash Withdrawal,General,10,17182
11,7,2015,The Grand Pub,Eating Out,7,17175
11,7,2015,The Grand Pub,Eating Out,8,17167
11,7,2015,ATM Cash Withdrawal,General,10,17157
11,7,2015,Tool Shop,,2,17155
12,7,2015,ATM Cash Withdrawal,General,10,17145
13,7,2015,South West Trains,Transport,22,17123
13,7,2015,Costa Coffee,Eating Out,2,17121
13,7,2015,Greggs,Eating Out,5,17116
14,7,2015,Starbucks Coffee,Eating Out,2,17114
14,7,2015,The West Cornwall Pasty Company,Eating Out,7,17107
15,7,2015,BRGAS-Electricity,Bills,15,17092
15,7,2015,BRGAS-Gas,Bills,23,17069
15,7,2015,Starbucks Coffee,Eating Out,1,17068
15,7,2015,Subway,Eating Out,6,17062
16,7,2015,LBS Council Tax,Bills,20,17042
16,7,2015,Caffe Nero,Eating Out,2,17040
16,7,2015,Pret A Manger,Eating Out,7,17033
17,7,2015,Tescos,Groceries,59,16974
17,7,2015,Wild Bean Cafe,Eating Out,2,16972
17,7,2015,McDonalds,Eating Out,7,16965
18,7,2015,Pizza Express,Eating Out,39,16926
19,7,2015,Anglo restaurant,Eating Out,49,16877
19,7,2015,ATM Cash Withdrawal,General,20,16857
20,7,2015,VIRGIN MEDIA PYMTS,Bills,26,16831
20,7,2015,South West Trains,Transport,21,16810
20,7,2015,Pret A Manger,Eating Out,6,16804
21,7,2015,Costa Coffee,Eating Out,2,16802
21,7,2015,ATM Cash Withdrawal,General,10,16792
22,7,2015,Starbucks Coffee,Eating Out,2,16790
22,7,2015,Greggs,Eating Out,4,16786
23,7,2015,Pret A Manger,Eating Out,8,16778
24,7,2015,O2,Bills,23,16755
24,7,2015,Tescos,Groceries,39,16716
24,7,2015,Costa Coffee,Eating Out,1,16715
24,7,2015,The West Cornwall Pasty Company,Eating Out,7,16708
24,7,2015,Anglo restaurant,Eating Out,31,16677
26,7,2015,Restaurant Gordon RamsayPortland Restaurant,Eating Out,46,16631
27,7,2015,South West Trains,Transport,25,16606
27,7,2015,Caffe Nero,Eating Out,2,16604
28,7,2015,Caffe Nero,Eating Out,1,16603
28,7,2015,McDonalds,Eating Out,6,16597
29,7,2015,Caffe Nero,Eating Out,2,16595
29,7,2015,Chicken Cottage,Eating Out,8,16587
31,7,2015,Waitrose,Groceries,54,16533
31,7,2015,Greggs,Eating Out,5,16528
1,8,2015,Rhino Sports salary,General,1600,18128
1,8,2015,Heaven Club,Eating Out,12,18116
1,8,2015,Heaven Club,Eating Out,7,18109
2,8,2015,ATM Cash Withdrawal,General,10,18099
3,8,2015,South West Trains,Transport,18,18081
3,8,2015,Caffe Nero,Eating Out,1,18080
4,8,2015,Starbucks Coffee,Eating Out,2,18078
5,8,2015,Costa Coffee,Eating Out,2,18076
5,8,2015,Chicken Cottage,Eating Out,5,18071
6,8,2015,Starbucks Coffee,Eating Out,2,18069
6,8,2015,McDonalds,Eating Out,8,18061
7,8,2015,Cubit and West rent,Rent,400,17661
7,8,2015,Sainsburys,Groceries,72,17589
7,8,2015,Caffe Nero,Eating Out,1,17588
7,8,2015,Subway,Eating Out,6,17582
7,8,2015,Heaven Club,Eating Out,8,17574
7,8,2015,Heaven Club,Eating Out,14,17560
7,8,2015,Heaven Club,Eating Out,7,17553
7,8,2015,Heaven Club,Eating Out,5,17548
7,8,2015,ATM Cash Withdrawal,General,20,17528
10,8,2015,South West Trains,Transport,19,17509
10,8,2015,Caffe Nero,Eating Out,2,17507
10,8,2015,Chicken Cottage,Eating Out,4,17503
11,8,2015,Wild Bean Cafe,Eating Out,2,17501
11,8,2015,Pret A Manger,Eating Out,5,17496
12,8,2015,Starbucks Coffee,Eating Out,1,17495
12,8,2015,The West Cornwall Pasty Company,Eating Out,6,17489
13,8,2015,Starbucks Coffee,Eating Out,1,17488
13,8,2015,Cheam Service Station,,5,17483
14,8,2015,ASDA,Groceries,44,17439
14,8,2015,Wild Bean Cafe,Eating Out,1,17438
14,8,2015,The West Cornwall Pasty Company,Eating Out,7,17431
14,8,2015,ATM Cash Withdrawal,General,20,17411
15,8,2015,BRGAS-Electricity,Bills,27,17384
15,8,2015,BRGAS-Gas,Bills,18,17366
15,8,2015,Ministry of Sound ClubXOYO Club,Eating Out,7,17359
15,8,2015,Ministry of Sound ClubXOYO Club,Eating Out,13,17346
15,8,2015,Dominos Pizza,Eating Out,39,17307
15,8,2015,ATM Cash Withdrawal,General,20,17287
16,8,2015,LBS Council Tax,Bills,20,17267
17,8,2015,South West Trains,Transport,25,17242
17,8,2015,Caffe Nero,Eating Out,1,17241
18,8,2015,Caffe Nero,Eating Out,1,17240
18,8,2015,ATM Cash Withdrawal,General,10,17230
19,8,2015,Wild Bean Cafe,Eating Out,2,17228
20,8,2015,VIRGIN MEDIA PYMTS,Bills,28,17200
20,8,2015,Caffe Nero,Eating Out,2,17198
21,8,2015,Morrisons,Groceries,50,17148
21,8,2015,Costa Coffee,Eating Out,2,17146
21,8,2015,Greggs,Eating Out,6,17140
21,8,2015,Dominos Pizza,Eating Out,36,17104
22,8,2015,Dominos Pizza,Eating Out,52,17052
24,8,2015,O2,Bills,21,17031
24,8,2015,South West Trains,Transport,21,17010
24,8,2015,Caffe Nero,Eating Out,1,17009
24,8,2015,Subway,Eating Out,8,17001
25,8,2015,Costa Coffee,Eating Out,2,16999
25,8,2015,ATM Cash Withdrawal,General,20,16979
26,8,2015,Starbucks Coffee,Eating Out,1,16978
26,8,2015,Pret A Manger,Eating Out,7,16971
27,8,2015,Wild Bean Cafe,Eating Out,2,16969
27,8,2015,McDonalds,Eating Out,8,16961
28,8,2015,Morrisons,Groceries,36,16925
28,8,2015,Caffe Nero,Eating Out,1,16924
28,8,2015,Subway,Eating Out,5,16919
28,8,2015,Scott's Restaurant,Eating Out,38,16881
29,8,2015,Anglo restaurant,Eating Out,24,16857
29,8,2015,ATM Cash Withdrawal,General,10,16847
31,8,2015,South West Trains,Transport,25,16822
31,8,2015,Wild Bean Cafe,Eating Out,2,16820
1,9,2015,Rhino Sports salary,General,1600,18420
1,9,2015,McDonalds,Eating Out,5,18415
1,9,2015,Paying back James,,9,18406
2,9,2015,Wild Bean Cafe,Eating Out,2,18404
2,9,2015,McDonalds,Eating Out,8,18396
3,9,2015,Costa Coffee,Eating Out,2,18394
3,9,2015,The West Cornwall Pasty Company,Eating Out,5,18389
4,9,2015,Sainsburys,Groceries,53,18336
4,9,2015,Caffe Nero,Eating Out,2,18334
4,9,2015,McDonalds,Eating Out,5,18329
4,9,2015,Restaurant Gordon RamsayPortland Restaurant,Eating Out,54,18275
5,9,2015,ATM Cash Withdrawal,General,10,18265
7,9,2015,Cubit and West rent,Rent,400,17865
7,9,2015,South West Trains,Transport,23,17842
7,9,2015,Wild Bean Cafe,Eating Out,1,17841
7,9,2015,Chicken Cottage,Eating Out,6,17835
8,9,2015,Costa Coffee,Eating Out,2,17833
9,9,2015,Wild Bean Cafe,Eating Out,2,17831
9,9,2015,Pret A Manger,Eating Out,4,17827
10,9,2015,Costa Coffee,Eating Out,1,17826
11,9,2015,ASDA,Groceries,39,17787
11,9,2015,Costa Coffee,Eating Out,2,17785
11,9,2015,Subway,Eating Out,7,17778
11,9,2015,Dominos Pizza,Eating Out,32,17746
12,9,2015,Anglo restaurant,Eating Out,31,17715
13,9,2015,Dominos Pizza,Eating Out,28,17687
13,9,2015,ATM Cash Withdrawal,General,10,17677
13,9,2015,Cheam Service Station,,6,17671
14,9,2015,South West Trains,Transport,22,17649
14,9,2015,Costa Coffee,Eating Out,2,17647
14,9,2015,Greggs,Eating Out,7,17640
14,9,2015,ATM Cash Withdrawal,General,20,17620
15,9,2015,BRGAS-Electricity,Bills,28,17592
15,9,2015,BRGAS-Gas,Bills,19,17573
15,9,2015,Pret A Manger,Eating Out,7,17566
15,9,2015,ATM Cash Withdrawal,General,10,17556
16,9,2015,LBS Council Tax,Bills,20,17536
16,9,2015,Caffe Nero,Eating Out,2,17534
16,9,2015,Chicken Cottage,Eating Out,7,17527
16,9,2015,Paying back James,,2,17525
17,9,2015,Costa Coffee,Eating Out,1,17524
18,9,2015,Tescos,Groceries,36,17488
18,9,2015,Pret A Manger,Eating Out,5,17483
18,9,2015,ATM Cash Withdrawal,General,20,17463
19,9,2015,ATM Cash Withdrawal,General,10,17453
20,9,2015,VIRGIN MEDIA PYMTS,Bills,25,17428
21,9,2015,South West Trains,Transport,17,17411
21,9,2015,Costa Coffee,Eating Out,2,17409
21,9,2015,Greggs,Eating Out,6,17403
22,9,2015,Starbucks Coffee,Eating Out,2,17401
23,9,2015,Costa Coffee,Eating Out,2,17399
24,9,2015,O2,Bills,20,17379
24,9,2015,Starbucks Coffee,Eating Out,1,17378
25,9,2015,Sainsburys,Groceries,68,17310
25,9,2015,Costa Coffee,Eating Out,1,17309
26,9,2015,ATM Cash Withdrawal,General,20,17289
27,9,2015,Scott's Restaurant,Eating Out,41,17248
28,9,2015,South West Trains,Transport,16,17232
28,9,2015,ATM Cash Withdrawal,General,20,17212
29,9,2015,Starbucks Coffee,Eating Out,2,17210
29,9,2015,Chicken Cottage,Eating Out,6,17204
30,9,2015,Starbucks Coffee,Eating Out,2,17202
30,9,2015,McDonalds,Eating Out,4,17198
1,10,2015,Rhino Sports salary,General,1600,18798
1,10,2015,Greggs,Eating Out,6,18792
1,10,2015,ATM Cash Withdrawal,General,20,18772
2,10,2015,Waitrose,Groceries,36,18736
2,10,2015,Caffe Nero,Eating Out,2,18734
2,10,2015,Greggs,Eating Out,4,18730
2,10,2015,Heaven Club,Eating Out,14,18716
2,10,2015,Heaven Club,Eating Out,8,18708
2,10,2015,Heaven Club,Eating Out,12,18696
2,10,2015,ATM Cash Withdrawal,General,20,18676
4,10,2015,ATM Cash Withdrawal,General,20,18656
5,10,2015,South West Trains,Transport,16,18640
5,10,2015,Wild Bean Cafe,Eating Out,2,18638
5,10,2015,Subway,Eating Out,7,18631
6,10,2015,Caffe Nero,Eating Out,2,18629
6,10,2015,Greggs,Eating Out,5,18624
6,10,2015,ATM Cash Withdrawal,General,10,18614
7,10,2015,Cubit and West rent,Rent,400,18214
7,10,2015,Costa Coffee,Eating Out,2,18212
7,10,2015,Chicken Cottage,Eating Out,7,18205
8,10,2015,Caffe Nero,Eating Out,2,18203
9,10,2015,Sainsburys,Groceries,53,18150
9,10,2015,Wild Bean Cafe,Eating Out,1,18149
9,10,2015,Greggs,Eating Out,8,18141
9,10,2015,Red Shop,,5,18136
10,10,2015,The Grand Pub,Eating Out,9,18127
10,10,2015,The Grand Pub,Eating Out,10,18117
10,10,2015,The Grand Pub,Eating Out,11,18106
10,10,2015,The Grand Pub,Eating Out,10,18096
10,10,2015,The Grand Pub,Eating Out,16,18080
10,10,2015,The Grand Pub,Eating Out,5,18075
11,10,2015,ATM Cash Withdrawal,General,10,18065
12,10,2015,South West Trains,Transport,22,18043
12,10,2015,The West Cornwall Pasty Company,Eating Out,5,18038
12,10,2015,ATM Cash Withdrawal,General,10,18028
13,10,2015,Costa Coffee,Eating Out,2,18026
13,10,2015,Greggs,Eating Out,6,18020
14,10,2015,Starbucks Coffee,Eating Out,2,18018
15,10,2015,BRGAS-Electricity,Bills,18,18000
15,10,2015,BRGAS-Gas,Bills,18,17982
15,10,2015,Costa Coffee,Eating Out,2,17980
15,10,2015,McDonalds,Eating Out,8,17972
16,10,2015,LBS Council Tax,Bills,20,17952
16,10,2015,Tescos,Groceries,49,17903
16,10,2015,Starbucks Coffee,Eating Out,1,17902
16,10,2015,Subway,Eating Out,7,17895
16,10,2015,Anglo restaurant,Eating Out,48,17847
17,10,2015,Pizza Express,Eating Out,59,17788
17,10,2015,ATM Cash Withdrawal,General,20,17768
17,10,2015,Cheam Service Station,,3,17765
19,10,2015,South West Trains,Transport,22,17743
19,10,2015,Costa Coffee,Eating Out,2,17741
19,10,2015,Greggs,Eating Out,8,17733
20,10,2015,VIRGIN MEDIA PYMTS,Bills,18,17715
20,10,2015,Costa Coffee,Eating Out,1,17714
20,10,2015,Chicken Cottage,Eating Out,7,17707
21,10,2015,Wild Bean Cafe,Eating Out,1,17706
21,10,2015,Pret A Manger,Eating Out,5,17701
22,10,2015,Wild Bean Cafe,Eating Out,2,17699
22,10,2015,Greggs,Eating Out,8,17691
22,10,2015,ATM Cash Withdrawal,General,10,17681
23,10,2015,Morrisons,Groceries,54,17627
23,10,2015,Caffe Nero,Eating Out,1,17626
23,10,2015,Greggs,Eating Out,7,17619
24,10,2015,O2,Bills,20,17599
24,10,2015,Dominos Pizza,Eating Out,27,17572
25,10,2015,Scott's Restaurant,Eating Out,28,17544
25,10,2015,Tool Shop,,2,17542
26,10,2015,South West Trains,Transport,19,17523
27,10,2015,Starbucks Coffee,Eating Out,1,17522
28,10,2015,Costa Coffee,Eating Out,2,17520
28,10,2015,Subway,Eating Out,5,17515
29,10,2015,Caffe Nero,Eating Out,1,17514
29,10,2015,Greggs,Eating Out,7,17507
29,10,2015,Cheam Service Station,,6,17501
30,10,2015,Sainsburys,Groceries,68,17433
30,10,2015,Caffe Nero,Eating Out,1,17432
30,10,2015,Heaven Club,Eating Out,7,17425
30,10,2015,Restaurant Gordon RamsayPortland Restaurant,Eating Out,36,17389
31,10,2015,Scott's Restaurant,Eating Out,40,17349
1,11,2015,Rhino Sports salary,General,1600,18949
1,11,2015,Scott's Restaurant,Eating Out,59,18890
1,11,2015,ATM Cash Withdrawal,General,10,18880
2,11,2015,South West Trains,Transport,19,18861
2,11,2015,Caffe Nero,Eating Out,1,18860
2,11,2015,Chicken Cottage,Eating Out,7,18853
3,11,2015,Subway,Eating Out,7,18846
4,11,2015,Costa Coffee,Eating Out,2,18844
4,11,2015,The West Cornwall Pasty Company,Eating Out,7,18837
4,11,2015,Red Shop,,5,18832
5,11,2015,Caffe Nero,Eating Out,1,18831
5,11,2015,Greggs,Eating Out,8,18823
5,11,2015,ATM Cash Withdrawal,General,20,18803
6,11,2015,ASDA,Groceries,73,18730
6,11,2015,Costa Coffee,Eating Out,2,18728
7,11,2015,Cubit and West rent,Rent,400,18328
7,11,2015,The Grand Pub,Eating Out,13,18315
7,11,2015,The Grand Pub,Eating Out,5,18310
7,11,2015,The Grand Pub,Eating Out,15,18295
7,11,2015,The Grand Pub,Eating Out,13,18282
7,11,2015,ATM Cash Withdrawal,General,20,18262
7,11,2015,Civic Shop,,3,18259
9,11,2015,South West Trains,Transport,21,18238
9,11,2015,Caffe Nero,Eating Out,2,18236
9,11,2015,Chicken Cottage,Eating Out,7,18229
10,11,2015,Wild Bean Cafe,Eating Out,2,18227
10,11,2015,Chicken Cottage,Eating Out,5,18222
11,11,2015,Caffe Nero,Eating Out,2,18220
11,11,2015,McDonalds,Eating Out,6,18214
12,11,2015,Caffe Nero,Eating Out,2,18212
12,11,2015,The West Cornwall Pasty Company,Eating Out,6,18206
13,11,2015,Tescos,Groceries,73,18133
13,11,2015,Costa Coffee,Eating Out,2,18131
13,11,2015,The West Cornwall Pasty Company,Eating Out,8,18123
13,11,2015,Dominos Pizza,Eating Out,34,18089
13,11,2015,ATM Cash Withdrawal,General,20,18069
15,11,2015,BRGAS-Electricity,Bills,42,18027
15,11,2015,BRGAS-Gas,Bills,38,17989
16,11,2015,LBS Council Tax,Bills,20,17969
16,11,2015,South West Trains,Transport,17,17952
16,11,2015,Wild Bean Cafe,Eating Out,1,17951
18,11,2015,Caffe Nero,Eating Out,1,17950
18,11,2015,McDonalds,Eating Out,7,17943
19,11,2015,Subway,Eating Out,6,17937
19,11,2015,Red Shop,,6,17931
20,11,2015,VIRGIN MEDIA PYMTS,Bills,24,17907
20,11,2015,Tescos,Groceries,37,17870
20,11,2015,Wild Bean Cafe,Eating Out,2,17868
20,11,2015,Scott's Restaurant,Eating Out,38,17830
21,11,2015,Fabric Club,Eating Out,12,17818
21,11,2015,Fabric Club,Eating Out,14,17804
21,11,2015,Fabric Club,Eating Out,6,17798
21,11,2015,Fabric Club,Eating Out,6,17792
21,11,2015,Fabric Club,Eating Out,7,17785
23,11,2015,South West Trains,Transport,18,17767
23,11,2015,Costa Coffee,Eating Out,1,17766
23,11,2015,ATM Cash Withdrawal,General,20,17746
24,11,2015,O2,Bills,24,17722
24,11,2015,Costa Coffee,Eating Out,1,17721
24,11,2015,Greggs,Eating Out,4,17717
25,11,2015,ATM Cash Withdrawal,General,10,17707
26,11,2015,Costa Coffee,Eating Out,2,17705
26,11,2015,Subway,Eating Out,8,17697
27,11,2015,ASDA,Groceries,54,17643
27,11,2015,Starbucks Coffee,Eating Out,1,17642
27,11,2015,The West Cornwall Pasty Company,Eating Out,8,17634
30,11,2015,South West Trains,Transport,16,17618
30,11,2015,Chicken Cottage,Eating Out,7,17611
30,11,2015,ATM Cash Withdrawal,General,20,17591
1,12,2015,Rhino Sports salary,General,1600,19191
1,12,2015,The West Cornwall Pasty Company,Eating Out,6,19185
1,12,2015,ATM Cash Withdrawal,General,10,19175
2,12,2015,Costa Coffee,Eating Out,1,19174
2,12,2015,Subway,Eating Out,8,19166
3,12,2015,Wild Bean Cafe,Eating Out,1,19165
3,12,2015,Chicken Cottage,Eating Out,4,19161
4,12,2015,Sainsburys,Groceries,52,19109
4,12,2015,Costa Coffee,Eating Out,2,19107
4,12,2015,McDonalds,Eating Out,4,19103
5,12,2015,Pizza Express,Eating Out,32,19071
5,12,2015,ATM Cash Withdrawal,General,20,19051
7,12,2015,Cubit and West rent,Rent,400,18651
7,12,2015,South West Trains,Transport,17,18634
7,12,2015,ATM Cash Withdrawal,General,20,18614
8,12,2015,Red Shop,,8,18606
9,12,2015,The West Cornwall Pasty Company,Eating Out,5,18601
10,12,2015,Wild Bean Cafe,Eating Out,2,18599
10,12,2015,The West Cornwall Pasty Company,Eating Out,8,18591
11,12,2015,Sainsburys,Groceries,38,18553
11,12,2015,Wild Bean Cafe,Eating Out,1,18552
11,12,2015,Chicken Cottage,Eating Out,8,18544
11,12,2015,Red Shop,,9,18535
12,12,2015,ATM Cash Withdrawal,General,10,18525
13,12,2015,Restaurant Gordon RamsayPortland Restaurant,Eating Out,43,18482
14,12,2015,South West Trains,Transport,18,18464
15,12,2015,BRGAS-Electricity,Bills,15,18449
15,12,2015,BRGAS-Gas,Bills,29,18420
15,12,2015,Costa Coffee,Eating Out,2,18418
16,12,2015,LBS Council Tax,Bills,20,18398
16,12,2015,McDonalds,Eating Out,7,18391
17,12,2015,Caffe Nero,Eating Out,2,18389
18,12,2015,Sainsburys,Groceries,46,18343
18,12,2015,Starbucks Coffee,Eating Out,1,18342
18,12,2015,Subway,Eating Out,8,18334
19,12,2015,Dominos Pizza,Eating Out,34,18300
20,12,2015,VIRGIN MEDIA PYMTS,Bills,26,18274
20,12,2015,Dominos Pizza,Eating Out,45,18229
21,12,2015,South West Trains,Transport,17,18212
21,12,2015,Caffe Nero,Eating Out,2,18210
21,12,2015,Greggs,Eating Out,5,18205
21,12,2015,Red Shop,,6,18199
22,12,2015,Caffe Nero,Eating Out,2,18197
22,12,2015,ATM Cash Withdrawal,General,20,18177
23,12,2015,Costa Coffee,Eating Out,1,18176
24,12,2015,O2,Bills,25,18151
24,12,2015,Starbucks Coffee,Eating Out,1,18150
24,12,2015,Pret A Manger,Eating Out,5,18145
25,12,2015,Waitrose,Groceries,55,18090
25,12,2015,Starbucks Coffee,Eating Out,1,18089
25,12,2015,McDonalds,Eating Out,8,18081
25,12,2015,Fabric Club,Eating Out,13,18068
25,12,2015,Red Shop,,3,18065
28,12,2015,South West Trains,Transport,23,18042
28,12,2015,Wild Bean Cafe,Eating Out,2,18040
28,12,2015,ATM Cash Withdrawal,General,20,18020
29,12,2015,Costa Coffee,Eating Out,2,18018
29,12,2015,ATM Cash Withdrawal,General,10,18008
30,12,2015,Caffe Nero,Eating Out,2,18006
30,12,2015,Greggs,Eating Out,4,18002
31,12,2015,ATM Cash Withdrawal,General,20,17982
1,1,2016,Rhino Sports salary,General,1600,19582
1,1,2016,ASDA,Groceries,38,19544
1,1,2016,Pizza Express,Eating Out,30,19514
1,1,2016,Paying back Julie,,4,19510
2,1,2016,Anglo restaurant,Eating Out,27,19483
3,1,2016,Pizza Express,Eating Out,57,19426
3,1,2016,ATM Cash Withdrawal,General,20,19406
4,1,2016,South West Trains,Transport,24,19382
4,1,2016,Costa Coffee,Eating Out,2,19380
4,1,2016,McDonalds,Eating Out,8,19372
4,1,2016,ATM Cash Withdrawal,General,10,19362
5,1,2016,Starbucks Coffee,Eating Out,2,19360
5,1,2016,Greggs,Eating Out,8,19352
6,1,2016,Caffe Nero,Eating Out,2,19350
6,1,2016,The West Cornwall Pasty Company,Eating Out,8,19342
6,1,2016,ATM Cash Withdrawal,General,10,19332
6,1,2016,Cheam Service Station,,9,19323
7,1,2016,Cubit and West rent,Rent,400,18923
7,1,2016,McDonalds,Eating Out,7,18916
8,1,2016,Sainsburys,Groceries,62,18854
8,1,2016,Costa Coffee,Eating Out,1,18853
8,1,2016,McDonalds,Eating Out,5,18848
8,1,2016,Heaven Club,Eating Out,7,18841
9,1,2016,Restaurant Gordon RamsayPortland Restaurant,Eating Out,57,18784
10,1,2016,Restaurant Gordon RamsayPortland Restaurant,Eating Out,59,18725
11,1,2016,South West Trains,Transport,23,18702
11,1,2016,Wild Bean Cafe,Eating Out,2,18700
11,1,2016,Greggs,Eating Out,7,18693
12,1,2016,Starbucks Coffee,Eating Out,2,18691
13,1,2016,Starbucks Coffee,Eating Out,2,18689
13,1,2016,Subway,Eating Out,4,18685
14,1,2016,Wild Bean Cafe,Eating Out,1,18684
14,1,2016,Pret A Manger,Eating Out,6,18678
15,1,2016,BRGAS-Electricity,Bills,38,18640
15,1,2016,BRGAS-Gas,Bills,52,18588
15,1,2016,Tescos,Groceries,69,18519
15,1,2016,Starbucks Coffee,Eating Out,2,18517
15,1,2016,The West Cornwall Pasty Company,Eating Out,7,18510
15,1,2016,Paying back Julie,,1,18509
16,1,2016,LBS Council Tax,Bills,20,18489
16,1,2016,Scott's Restaurant,Eating Out,55,18434
17,1,2016,Restaurant Gordon RamsayPortland Restaurant,Eating Out,46,18388
17,1,2016,ATM Cash Withdrawal,General,20,18368
18,1,2016,South West Trains,Transport,25,18343
18,1,2016,Costa Coffee,Eating Out,2,18341
18,1,2016,Greggs,Eating Out,8,18333
18,1,2016,ATM Cash Withdrawal,General,10,18323
19,1,2016,Caffe Nero,Eating Out,2,18321
19,1,2016,Greggs,Eating Out,6,18315
19,1,2016,Tool Shop,,7,18308
20,1,2016,VIRGIN MEDIA PYMTS,Bills,15,18293
20,1,2016,Costa Coffee,Eating Out,2,18291
20,1,2016,Subway,Eating Out,7,18284
20,1,2016,ATM Cash Withdrawal,General,10,18274
21,1,2016,Caffe Nero,Eating Out,2,18272
21,1,2016,Pret A Manger,Eating Out,6,18266
22,1,2016,Waitrose,Groceries,65,18201
22,1,2016,Starbucks Coffee,Eating Out,2,18199
22,1,2016,Chicken Cottage,Eating Out,4,18195
22,1,2016,Fabric Club,Eating Out,14,18181
22,1,2016,Fabric Club,Eating Out,7,18174
22,1,2016,Fabric Club,Eating Out,12,18162
22,1,2016,Fabric Club,Eating Out,11,18151
22,1,2016,Fabric Club,Eating Out,5,18146
22,1,2016,Pizza Express,Eating Out,54,18092
23,1,2016,Heaven Club,Eating Out,11,18081
23,1,2016,Heaven Club,Eating Out,8,18073
23,1,2016,ATM Cash Withdrawal,General,10,18063
24,1,2016,O2,Bills,21,18042
25,1,2016,South West Trains,Transport,22,18020
25,1,2016,Caffe Nero,Eating Out,1,18019
25,1,2016,Subway,Eating Out,8,18011
26,1,2016,Greggs,Eating Out,7,18004
26,1,2016,ATM Cash Withdrawal,General,10,17994
26,1,2016,Red Shop,,8,17986
27,1,2016,Costa Coffee,Eating Out,1,17985
27,1,2016,Greggs,Eating Out,8,17977
28,1,2016,Wild Bean Cafe,Eating Out,2,17975
29,1,2016,ASDA,Groceries,71,17904
29,1,2016,McDonalds,Eating Out,8,17896
29,1,2016,Heaven Club,Eating Out,11,17885
29,1,2016,Heaven Club,Eating Out,6,17879
29,1,2016,ATM Cash Withdrawal,General,20,17859
29,1,2016,Paying back Julie,,6,17853
30,1,2016,Anglo restaurant,Eating Out,56,17797
30,1,2016,ATM Cash Withdrawal,General,10,17787
31,1,2016,ATM Cash Withdrawal,General,20,17767
1,2,2016,Rhino Sports salary,General,1600,19367
1,2,2016,South West Trains,Transport,16,19351
1,2,2016,Caffe Nero,Eating Out,2,19349
1,2,2016,Paying back Julie,,5,19344
2,2,2016,Greggs,Eating Out,6,19338
3,2,2016,Costa Coffee,Eating Out,1,19337
3,2,2016,McDonalds,Eating Out,6,19331
3,2,2016,ATM Cash Withdrawal,General,10,19321
4,2,2016,Costa Coffee,Eating Out,2,19319
4,2,2016,Greggs,Eating Out,8,19311
5,2,2016,Waitrose,Groceries,67,19244
5,2,2016,Wild Bean Cafe,Eating Out,2,19242
5,2,2016,Subway,Eating Out,7,19235
5,2,2016,Heaven Club,Eating Out,6,19229
5,2,2016,Heaven Club,Eating Out,13,19216
5,2,2016,Heaven Club,Eating Out,8,19208
5,2,2016,Heaven Club,Eating Out,14,19194
5,2,2016,ATM Cash Withdrawal,General,20,19174
6,2,2016,The Grand Pub,Eating Out,8,19166
6,2,2016,The Grand Pub,Eating Out,10,19156
6,2,2016,The Grand Pub,Eating Out,5,19151
6,2,2016,The Grand Pub,Eating Out,15,19136
6,2,2016,The Grand Pub,Eating Out,12,19124
7,2,2016,Cubit and West rent,Rent,400,18724
8,2,2016,South West Trains,Transport,23,18701
8,2,2016,McDonalds,Eating Out,6,18695
8,2,2016,ATM Cash Withdrawal,General,20,18675
8,2,2016,Civic Shop,,1,18674
9,2,2016,Starbucks Coffee,Eating Out,2,18672
10,2,2016,Starbucks Coffee,Eating Out,2,18670
10,2,2016,Pret A Manger,Eating Out,6,18664
10,2,2016,ATM Cash Withdrawal,General,20,18644
11,2,2016,Pret A Manger,Eating Out,5,18639
11,2,2016,Red Shop,,3,18636
12,2,2016,Morrisons,Groceries,39,18597
12,2,2016,Caffe Nero,Eating Out,1,18596
12,2,2016,Anglo restaurant,Eating Out,55,18541
12,2,2016,ATM Cash Withdrawal,General,20,18521
14,2,2016,Scott's Restaurant,Eating Out,53,18468
14,2,2016,ATM Cash Withdrawal,General,20,18448
15,2,2016,BRGAS-Electricity,Bills,22,18426
15,2,2016,BRGAS-Gas,Bills,26,18400
15,2,2016,South West Trains,Transport,21,18379
15,2,2016,Caffe Nero,Eating Out,2,18377
16,2,2016,LBS Council Tax,Bills,20,18357
16,2,2016,Wild Bean Cafe,Eating Out,2,18355
17,2,2016,Wild Bean Cafe,Eating Out,2,18353
17,2,2016,Subway,Eating Out,6,18347
19,2,2016,Tescos,Groceries,71,18276
19,2,2016,Starbucks Coffee,Eating Out,1,18275
19,2,2016,Pret A Manger,Eating Out,8,18267
19,2,2016,Pizza Express,Eating Out,52,18215
20,2,2016,VIRGIN MEDIA PYMTS,Bills,28,18187
20,2,2016,Pizza Express,Eating Out,28,18159
21,2,2016,ATM Cash Withdrawal,General,10,18149
22,2,2016,South West Trains,Transport,17,18132
22,2,2016,Caffe Nero,Eating Out,2,18130
22,2,2016,Greggs,Eating Out,8,18122
22,2,2016,ATM Cash Withdrawal,General,10,18112
23,2,2016,Wild Bean Cafe,Eating Out,1,18111
24,2,2016,O2,Bills,20,18091
24,2,2016,Caffe Nero,Eating Out,1,18090
24,2,2016,Pret A Manger,Eating Out,8,18082
24,2,2016,ATM Cash Withdrawal,General,20,18062
24,2,2016,Tool Tec,,6,18056
25,2,2016,Costa Coffee,Eating Out,2,18054
25,2,2016,ATM Cash Withdrawal,General,10,18044
26,2,2016,Tescos,Groceries,61,17983
26,2,2016,Caffe Nero,Eating Out,2,17981
26,2,2016,Dominos Pizza,Eating Out,53,17928
29,2,2016,South West Trains,Transport,18,17910
29,2,2016,Caffe Nero,Eating Out,2,17908
1,3,2016,Rhino Sports salary,General,1600,19508
1,3,2016,Costa Coffee,Eating Out,2,19506
1,3,2016,Subway,Eating Out,6,19500
2,3,2016,Pret A Manger,Eating Out,5,19495
3,3,2016,Starbucks Coffee,Eating Out,2,19493
3,3,2016,Chicken Cottage,Eating Out,4,19489
4,3,2016,Waitrose,Groceries,38,19451
4,3,2016,Starbucks Coffee,Eating Out,2,19449
5,3,2016,Heaven Club,Eating Out,14,19435
5,3,2016,ATM Cash Withdrawal,General,20,19415
7,3,2016,Cubit and West rent,Rent,400,19015
7,3,2016,South West Trains,Transport,24,18991
7,3,2016,ATM Cash Withdrawal,General,20,18971
7,3,2016,Tool Shop,,4,18967
8,3,2016,Starbucks Coffee,Eating Out,2,18965
8,3,2016,Pret A Manger,Eating Out,8,18957
9,3,2016,Costa Coffee,Eating Out,1,18956
10,3,2016,Pret A Manger,Eating Out,5,18951
11,3,2016,Waitrose,Groceries,62,18889
11,3,2016,Caffe Nero,Eating Out,2,18887
11,3,2016,Scott's Restaurant,Eating Out,31,18856
12,3,2016,Pizza Express,Eating Out,56,18800
12,3,2016,ATM Cash Withdrawal,General,20,18780
13,3,2016,Restaurant Gordon RamsayPortland Restaurant,Eating Out,26,18754
14,3,2016,South West Trains,Transport,19,18735
14,3,2016,Costa Coffee,Eating Out,1,18734
15,3,2016,BRGAS-Electricity,Bills,21,18713
15,3,2016,BRGAS-Gas,Bills,22,18691
16,3,2016,LBS Council Tax,Bills,20,18671
16,3,2016,Caffe Nero,Eating Out,2,18669
16,3,2016,McDonalds,Eating Out,5,18664
16,3,2016,ATM Cash Withdrawal,General,20,18644
17,3,2016,The West Cornwall Pasty Company,Eating Out,6,18638
18,3,2016,Morrisons,Groceries,46,18592
18,3,2016,Starbucks Coffee,Eating Out,2,18590
18,3,2016,Subway,Eating Out,8,18582
19,3,2016,Fabric Club,Eating Out,13,18569
19,3,2016,Anglo restaurant,Eating Out,54,18515
19,3,2016,ATM Cash Withdrawal,General,20,18495
20,3,2016,VIRGIN MEDIA PYMTS,Bills,26,18469
20,3,2016,Dominos Pizza,Eating Out,29,18440
20,3,2016,ATM Cash Withdrawal,General,10,18430
21,3,2016,South West Trains,Transport,25,18405
21,3,2016,Costa Coffee,Eating Out,1,18404
21,3,2016,The West Cornwall Pasty Company,Eating Out,8,18396
22,3,2016,Caffe Nero,Eating Out,2,18394
22,3,2016,The West Cornwall Pasty Company,Eating Out,4,18390
23,3,2016,Wild Bean Cafe,Eating Out,2,18388
24,3,2016,O2,Bills,23,18365
24,3,2016,Caffe Nero,Eating Out,2,18363
24,3,2016,Subway,Eating Out,5,18358
25,3,2016,Morrisons,Groceries,43,18315
25,3,2016,Heaven Club,Eating Out,14,18301
25,3,2016,Heaven Club,Eating Out,9,18292
25,3,2016,Heaven Club,Eating Out,8,18284
25,3,2016,ATM Cash Withdrawal,General,10,18274
26,3,2016,ATM Cash Withdrawal,General,20,18254
27,3,2016,Anglo restaurant,Eating Out,29,18225
27,3,2016,ATM Cash Withdrawal,General,20,18205
28,3,2016,South West Trains,Transport,17,18188
28,3,2016,Caffe Nero,Eating Out,2,18186
28,3,2016,McDonalds,Eating Out,7,18179
28,3,2016,ATM Cash Withdrawal,General,20,18159
29,3,2016,Costa Coffee,Eating Out,2,18157
29,3,2016,The West Cornwall Pasty Company,Eating Out,6,18151
30,3,2016,Starbucks Coffee,Eating Out,2,18149
30,3,2016,Greggs,Eating Out,6,18143
31,3,2016,Pret A Manger,Eating Out,5,18138
1,4,2016,Rhino Sports salary,General,1600,19738
1,4,2016,Sainsburys,Groceries,36,19702
1,4,2016,Starbucks Coffee,Eating Out,2,19700
1,4,2016,Subway,Eating Out,8,19692
1,4,2016,Restaurant Gordon RamsayPortland Restaurant,Eating Out,40,19652
2,4,2016,ATM Cash Withdrawal,General,20,19632
3,4,2016,ATM Cash Withdrawal,General,20,19612
4,4,2016,South West Trains,Transport,21,19591
4,4,2016,Starbucks Coffee,Eating Out,1,19590
4,4,2016,The West Cornwall Pasty Company,Eating Out,4,19586
5,4,2016,Costa Coffee,Eating Out,2,19584
6,4,2016,Starbucks Coffee,Eating Out,2,19582
7,4,2016,Cubit and West rent,Rent,400,19182
7,4,2016,Caffe Nero,Eating Out,2,19180
7,4,2016,McDonalds,Eating Out,8,19172
8,4,2016,Sainsburys,Groceries,74,19098
8,4,2016,Wild Bean Cafe,Eating Out,1,19097
8,4,2016,Paying back James,,4,19093
9,4,2016,Anglo restaurant,Eating Out,58,19035
9,4,2016,ATM Cash Withdrawal,General,10,19025
10,4,2016,Pizza Express,Eating Out,26,18999
10,4,2016,Red Shop,,2,18997
11,4,2016,South West Trains,Transport,19,18978
11,4,2016,Caffe Nero,Eating Out,2,18976
11,4,2016,Subway,Eating Out,8,18968
12,4,2016,Caffe Nero,Eating Out,1,18967
12,4,2016,The West Cornwall Pasty Company,Eating Out,5,18962
13,4,2016,Wild Bean Cafe,Eating Out,1,18961
13,4,2016,Greggs,Eating Out,6,18955
14,4,2016,Starbucks Coffee,Eating Out,2,18953
14,4,2016,Paying back James,,8,18945
15,4,2016,BRGAS-Electricity,Bills,14,18931
15,4,2016,BRGAS-Gas,Bills,15,18916
15,4,2016,ASDA,Groceries,68,18848
15,4,2016,Wild Bean Cafe,Eating Out,1,18847
15,4,2016,The West Cornwall Pasty Company,Eating Out,7,18840
16,4,2016,LBS Council Tax,Bills,20,18820
16,4,2016,Red Shop,,4,18816
17,4,2016,Restaurant Gordon RamsayPortland Restaurant,Eating Out,24,18792
17,4,2016,ATM Cash Withdrawal,General,20,18772
18,4,2016,South West Trains,Transport,21,18751
18,4,2016,Wild Bean Cafe,Eating Out,2,18749
18,4,2016,Chicken Cottage,Eating Out,5,18744
18,4,2016,Civic Shop,,7,18737
19,4,2016,Costa Coffee,Eating Out,1,18736
20,4,2016,VIRGIN MEDIA PYMTS,Bills,17,18719
21,4,2016,Costa Coffee,Eating Out,2,18717
21,4,2016,McDonalds,Eating Out,4,18713
22,4,2016,Morrisons,Groceries,42,18671
22,4,2016,ATM Cash Withdrawal,General,10,18661
23,4,2016,The Grand Pub,Eating Out,12,18649
23,4,2016,The Grand Pub,Eating Out,6,18643
23,4,2016,The Grand Pub,Eating Out,5,18638
23,4,2016,The Grand Pub,Eating Out,16,18622
23,4,2016,Scott's Restaurant,Eating Out,31,18591
24,4,2016,O2,Bills,21,18570
24,4,2016,Dominos Pizza,Eating Out,27,18543
24,4,2016,Tool Tec,,7,18536
25,4,2016,South West Trains,Transport,24,18512
25,4,2016,McDonalds,Eating Out,7,18505
26,4,2016,Cheam Service Station,,2,18503
28,4,2016,Costa Coffee,Eating Out,2,18501
28,4,2016,McDonalds,Eating Out,4,18497
29,4,2016,Waitrose,Groceries,49,18448
29,4,2016,Wild Bean Cafe,Eating Out,2,18446
29,4,2016,The West Cornwall Pasty Company,Eating Out,4,18442
30,4,2016,Fabric Club,Eating Out,15,18427
30,4,2016,Fabric Club,Eating Out,8,18419
30,4,2016,Fabric Club,Eating Out,12,18407
30,4,2016,Fabric Club,Eating Out,6,18401
30,4,2016,Fabric Club,Eating Out,9,18392
30,4,2016,ATM Cash Withdrawal,General,10,18382
1,5,2016,Rhino Sports salary,General,1600,19982
1,5,2016,Scott's Restaurant,Eating Out,59,19923
1,5,2016,ATM Cash Withdrawal,General,10,19913
2,5,2016,South West Trains,Transport,19,19894
2,5,2016,Starbucks Coffee,Eating Out,2,19892
2,5,2016,ATM Cash Withdrawal,General,20,19872
3,5,2016,Starbucks Coffee,Eating Out,2,19870
3,5,2016,Pret A Manger,Eating Out,7,19863
4,5,2016,Costa Coffee,Eating Out,2,19861
4,5,2016,The West Cornwall Pasty Company,Eating Out,4,19857
4,5,2016,Civic Shop,,4,19853
5,5,2016,Starbucks Coffee,Eating Out,2,19851
5,5,2016,Greggs,Eating Out,6,19845
5,5,2016,Paying back Julie,,3,19842
6,5,2016,Tescos,Groceries,71,19771
6,5,2016,Caffe Nero,Eating Out,2,19769
7,5,2016,Cubit and West rent,Rent,400,19369
7,5,2016,ATM Cash Withdrawal,General,20,19349
9,5,2016,South West Trains,Transport,22,19327
12,5,2016,McDonalds,Eating Out,7,19320
13,5,2016,Sainsburys,Groceries,64,19256
13,5,2016,Pret A Manger,Eating Out,6,19250
14,5,2016,Anglo restaurant,Eating Out,57,19193
14,5,2016,ATM Cash Withdrawal,General,20,19173
15,5,2016,BRGAS-Electricity,Bills,16,19157
15,5,2016,BRGAS-Gas,Bills,24,19133
16,5,2016,LBS Council Tax,Bills,20,19113
16,5,2016,South West Trains,Transport,22,19091
16,5,2016,Caffe Nero,Eating Out,1,19090
16,5,2016,McDonalds,Eating Out,7,19083
17,5,2016,Wild Bean Cafe,Eating Out,2,19081
17,5,2016,McDonalds,Eating Out,7,19074
17,5,2016,Paying back Julie,,4,19070
18,5,2016,The West Cornwall Pasty Company,Eating Out,7,19063
18,5,2016,ATM Cash Withdrawal,General,20,19043
19,5,2016,Costa Coffee,Eating Out,1,19042
19,5,2016,Chicken Cottage,Eating Out,4,19038
19,5,2016,ATM Cash Withdrawal,General,20,19018
20,5,2016,VIRGIN MEDIA PYMTS,Bills,26,18992
20,5,2016,ASDA,Groceries,56,18936
20,5,2016,Costa Coffee,Eating Out,2,18934
20,5,2016,Greggs,Eating Out,4,18930
20,5,2016,Dominos Pizza,Eating Out,25,18905
20,5,2016,ATM Cash Withdrawal,General,10,18895
21,5,2016,Pizza Express,Eating Out,48,18847
22,5,2016,Dominos Pizza,Eating Out,44,18803
23,5,2016,South West Trains,Transport,21,18782
23,5,2016,Wild Bean Cafe,Eating Out,2,18780
23,5,2016,Greggs,Eating Out,7,18773
23,5,2016,ATM Cash Withdrawal,General,10,18763
23,5,2016,Cheam Service Station,,8,18755
24,5,2016,O2,Bills,23,18732
24,5,2016,Wild Bean Cafe,Eating Out,2,18730
24,5,2016,ATM Cash Withdrawal,General,20,18710
25,5,2016,Wild Bean Cafe,Eating Out,2,18708
25,5,2016,Greggs,Eating Out,8,18700
26,5,2016,Wild Bean Cafe,Eating Out,1,18699
26,5,2016,McDonalds,Eating Out,5,18694
27,5,2016,Morrisons,Groceries,68,18626
27,5,2016,Caffe Nero,Eating Out,2,18624
27,5,2016,Pret A Manger,Eating Out,8,18616
27,5,2016,Scott's Restaurant,Eating Out,42,18574
28,5,2016,ATM Cash Withdrawal,General,20,18554
29,5,2016,Pizza Express,Eating Out,38,18516
30,5,2016,South West Trains,Transport,21,18495
30,5,2016,Costa Coffee,Eating Out,1,18494
31,5,2016,Wild Bean Cafe,Eating Out,2,18492
31,5,2016,Greggs,Eating Out,5,18487
1,6,2016,Rhino Sports salary,General,1600,20087
1,6,2016,Chicken Cottage,Eating Out,5,20082
1,6,2016,ATM Cash Withdrawal,General,10,20072
2,6,2016,Starbucks Coffee,Eating Out,1,20071
2,6,2016,Subway,Eating Out,5,20066
3,6,2016,Waitrose,Groceries,53,20013
3,6,2016,Costa Coffee,Eating Out,2,20011
3,6,2016,Greggs,Eating Out,8,20003
6,6,2016,South West Trains,Transport,20,19983
6,6,2016,Costa Coffee,Eating Out,2,19981
6,6,2016,Greggs,Eating Out,5,19976
7,6,2016,Cubit and West rent,Rent,400,19576
7,6,2016,Costa Coffee,Eating Out,1,19575
7,6,2016,Chicken Cottage,Eating Out,6,19569
8,6,2016,Starbucks Coffee,Eating Out,2,19567
8,6,2016,McDonalds,Eating Out,8,19559
9,6,2016,Caffe Nero,Eating Out,1,19558
9,6,2016,The West Cornwall Pasty Company,Eating Out,8,19550
10,6,2016,ASDA,Groceries,64,19486
10,6,2016,Starbucks Coffee,Eating Out,1,19485
10,6,2016,The West Cornwall Pasty Company,Eating Out,6,19479
11,6,2016,Fabric Club,Eating Out,12,19467
12,6,2016,ATM Cash Withdrawal,General,10,19457
13,6,2016,South West Trains,Transport,25,19432
13,6,2016,Costa Coffee,Eating Out,2,19430
13,6,2016,Pret A Manger,Eating Out,8,19422
14,6,2016,Starbucks Coffee,Eating Out,2,19420
14,6,2016,ATM Cash Withdrawal,General,20,19400
15,6,2016,BRGAS-Electricity,Bills,21,19379
15,6,2016,BRGAS-Gas,Bills,19,19360
15,6,2016,Subway,Eating Out,4,19356
15,6,2016,ATM Cash Withdrawal,General,20,19336
16,6,2016,LBS Council Tax,Bills,20,19316
16,6,2016,Pret A Manger,Eating Out,8,19308
16,6,2016,Paying back Julie,,9,19299
17,6,2016,Tescos,Groceries,53,19246
17,6,2016,Starbucks Coffee,Eating Out,2,19244
18,6,2016,ATM Cash Withdrawal,General,10,19234
18,6,2016,Cheam Service Station,,4,19230
20,6,2016,VIRGIN MEDIA PYMTS,Bills,22,19208
20,6,2016,South West Trains,Transport,21,19187
20,6,2016,The West Cornwall Pasty Company,Eating Out,7,19180
21,6,2016,Wild Bean Cafe,Eating Out,2,19178
21,6,2016,ATM Cash Withdrawal,General,20,19158
22,6,2016,Wild Bean Cafe,Eating Out,1,19157
22,6,2016,Subway,Eating Out,4,19153
23,6,2016,Caffe Nero,Eating Out,1,19152
23,6,2016,McDonalds,Eating Out,7,19145
24,6,2016,O2,Bills,20,19125
24,6,2016,Tescos,Groceries,41,19084
24,6,2016,Costa Coffee,Eating Out,1,19083
24,6,2016,McDonalds,Eating Out,8,19075
24,6,2016,Scott's Restaurant,Eating Out,46,19029
25,6,2016,Red Shop,,1,19028
27,6,2016,South West Trains,Transport,25,19003
28,6,2016,Caffe Nero,Eating Out,2,19001
29,6,2016,Wild Bean Cafe,Eating Out,1,19000
30,6,2016,Caffe Nero,Eating Out,2,18998
1,7,2016,Rhino Sports salary,General,1600,20598
1,7,2016,Tescos,Groceries,52,20546
1,7,2016,Wild Bean Cafe,Eating Out,1,20545
1,7,2016,Pret A Manger,Eating Out,8,20537
3,7,2016,Pizza Express,Eating Out,45,20492
4,7,2016,South West Trains,Transport,21,20471
4,7,2016,Costa Coffee,Eating Out,1,20470
4,7,2016,The West Cornwall Pasty Company,Eating Out,6,20464
4,7,2016,Cheam Service Station,,2,20462
5,7,2016,Pret A Manger,Eating Out,5,20457
6,7,2016,Costa Coffee,Eating Out,1,20456
6,7,2016,Pret A Manger,Eating Out,6,20450
7,7,2016,Cubit and West rent,Rent,400,20050
7,7,2016,Wild Bean Cafe,Eating Out,1,20049
7,7,2016,The West Cornwall Pasty Company,Eating Out,4,20045
7,7,2016,Red Shop,,3,20042
8,7,2016,Sainsburys,Groceries,41,20001
8,7,2016,Caffe Nero,Eating Out,2,19999
8,7,2016,Anglo restaurant,Eating Out,35,19964
10,7,2016,ATM Cash Withdrawal,General,10,19954
11,7,2016,South West Trains,Transport,17,19937
11,7,2016,Chicken Cottage,Eating Out,8,19929
12,7,2016,Chicken Cottage,Eating Out,7,19922
12,7,2016,ATM Cash Withdrawal,General,10,19912
14,7,2016,Wild Bean Cafe,Eating Out,2,19910
14,7,2016,Pret A Manger,Eating Out,4,19906
14,7,2016,ATM Cash Withdrawal,General,10,19896
15,7,2016,BRGAS-Electricity,Bills,19,19877
15,7,2016,BRGAS-Gas,Bills,28,19849
15,7,2016,Waitrose,Groceries,60,19789
15,7,2016,Caffe Nero,Eating Out,2,19787
15,7,2016,Pizza Express,Eating Out,59,19728
16,7,2016,LBS Council Tax,Bills,20,19708
16,7,2016,ATM Cash Withdrawal,General,10,19698
17,7,2016,Scott's Restaurant,Eating Out,42,19656
18,7,2016,South West Trains,Transport,19,19637
18,7,2016,Costa Coffee,Eating Out,2,19635
19,7,2016,Pret A Manger,Eating Out,5,19630
19,7,2016,ATM Cash Withdrawal,General,10,19620
20,7,2016,VIRGIN MEDIA PYMTS,Bills,29,19591
20,7,2016,Wild Bean Cafe,Eating Out,2,19589
20,7,2016,Pret A Manger,Eating Out,4,19585
21,7,2016,Costa Coffee,Eating Out,2,19583
21,7,2016,Greggs,Eating Out,5,19578
22,7,2016,Waitrose,Groceries,62,19516
22,7,2016,Starbucks Coffee,Eating Out,1,19515
22,7,2016,McDonalds,Eating Out,5,19510
22,7,2016,Ministry of Sound ClubXOYO Club,Eating Out,11,19499
22,7,2016,Ministry of Sound ClubXOYO Club,Eating Out,12,19487
22,7,2016,Ministry of Sound ClubXOYO Club,Eating Out,9,19478
22,7,2016,Ministry of Sound ClubXOYO Club,Eating Out,11,19467
22,7,2016,Ministry of Sound ClubXOYO Club,Eating Out,14,19453
22,7,2016,Ministry of Sound ClubXOYO Club,Eating Out,11,19442
22,7,2016,Restaurant Gordon RamsayPortland Restaurant,Eating Out,37,19405
22,7,2016,ATM Cash Withdrawal,General,20,19385
23,7,2016,Tool Tec,,3,19382
24,7,2016,O2,Bills,24,19358
24,7,2016,Restaurant Gordon RamsayPortland Restaurant,Eating Out,25,19333
24,7,2016,ATM Cash Withdrawal,General,20,19313
25,7,2016,South West Trains,Transport,24,19289
25,7,2016,Starbucks Coffee,Eating Out,2,19287
25,7,2016,Greggs,Eating Out,5,19282
25,7,2016,ATM Cash Withdrawal,General,10,19272
26,7,2016,Caffe Nero,Eating Out,1,19271
26,7,2016,Subway,Eating Out,8,19263
27,7,2016,Caffe Nero,Eating Out,2,19261
27,7,2016,Greggs,Eating Out,6,19255
27,7,2016,ATM Cash Withdrawal,General,20,19235
28,7,2016,Wild Bean Cafe,Eating Out,2,19233
29,7,2016,Waitrose,Groceries,38,19195
29,7,2016,Costa Coffee,Eating Out,2,19193
29,7,2016,Cheam Service Station,,3,19190
30,7,2016,Dominos Pizza,Eating Out,29,19161
30,7,2016,Cheam Service Station,,9,19152
1,8,2016,Rhino Sports salary,General,1600,20752
1,8,2016,South West Trains,Transport,19,20733
1,8,2016,Starbucks Coffee,Eating Out,1,20732
1,8,2016,McDonalds,Eating Out,6,20726
2,8,2016,ATM Cash Withdrawal,General,10,20716
2,8,2016,Red Shop,,9,20707
3,8,2016,Wild Bean Cafe,Eating Out,1,20706
3,8,2016,Pret A Manger,Eating Out,7,20699
3,8,2016,Paying back Julie,,9,20690
4,8,2016,Wild Bean Cafe,Eating Out,1,20689
4,8,2016,McDonalds,Eating Out,8,20681
5,8,2016,Waitrose,Groceries,48,20633
5,8,2016,Wild Bean Cafe,Eating Out,2,20631
5,8,2016,Restaurant Gordon RamsayPortland Restaurant,Eating Out,34,20597
5,8,2016,ATM Cash Withdrawal,General,10,20587
6,8,2016,Dominos Pizza,Eating Out,55,20532
7,8,2016,Cubit and West rent,Rent,400,20132
7,8,2016,Anglo restaurant,Eating Out,45,20087
8,8,2016,South West Trains,Transport,21,20066
8,8,2016,McDonalds,Eating Out,5,20061
8,8,2016,ATM Cash Withdrawal,General,10,20051
9,8,2016,Caffe Nero,Eating Out,1,20050
9,8,2016,Greggs,Eating Out,7,20043
10,8,2016,Starbucks Coffee,Eating Out,1,20042
10,8,2016,Chicken Cottage,Eating Out,4,20038
10,8,2016,ATM Cash Withdrawal,General,10,20028
11,8,2016,Costa Coffee,Eating Out,1,20027
12,8,2016,Tescos,Groceries,73,19954
12,8,2016,Wild Bean Cafe,Eating Out,2,19952
12,8,2016,McDonalds,Eating Out,7,19945
13,8,2016,Fabric Club,Eating Out,5,19940
13,8,2016,Fabric Club,Eating Out,11,19929
13,8,2016,Fabric Club,Eating Out,14,19915
14,8,2016,Dominos Pizza,Eating Out,49,19866
14,8,2016,ATM Cash Withdrawal,General,10,19856
15,8,2016,BRGAS-Electricity,Bills,21,19835
15,8,2016,BRGAS-Gas,Bills,25,19810
15,8,2016,South West Trains,Transport,23,19787
15,8,2016,Costa Coffee,Eating Out,2,19785
16,8,2016,LBS Council Tax,Bills,20,19765
16,8,2016,Starbucks Coffee,Eating Out,1,19764
16,8,2016,Chicken Cottage,Eating Out,5,19759
17,8,2016,The West Cornwall Pasty Company,Eating Out,8,19751
18,8,2016,Starbucks Coffee,Eating Out,2,19749
18,8,2016,McDonalds,Eating Out,5,19744
19,8,2016,Morrisons,Groceries,36,19708
19,8,2016,Wild Bean Cafe,Eating Out,1,19707
19,8,2016,Pret A Manger,Eating Out,7,19700
19,8,2016,Dominos Pizza,Eating Out,38,19662
20,8,2016,VIRGIN MEDIA PYMTS,Bills,24,19638
20,8,2016,Anglo restaurant,Eating Out,33,19605
22,8,2016,South West Trains,Transport,20,19585
22,8,2016,Greggs,Eating Out,8,19577
23,8,2016,The West Cornwall Pasty Company,Eating Out,8,19569
23,8,2016,Tool Tec,,7,19562
24,8,2016,O2,Bills,22,19540
24,8,2016,McDonalds,Eating Out,8,19532
24,8,2016,ATM Cash Withdrawal,General,10,19522
25,8,2016,Costa Coffee,Eating Out,2,19520
25,8,2016,Chicken Cottage,Eating Out,6,19514
26,8,2016,Waitrose,Groceries,62,19452
26,8,2016,Restaurant Gordon RamsayPortland Restaurant,Eating Out,43,19409
27,8,2016,ATM Cash Withdrawal,General,10,19399
28,8,2016,ATM Cash Withdrawal,General,20,19379
29,8,2016,South West Trains,Transport,20,19359
29,8,2016,Subway,Eating Out,4,19355
30,8,2016,Starbucks Coffee,Eating Out,2,19353
31,8,2016,Costa Coffee,Eating Out,1,19352
31,8,2016,Greggs,Eating Out,8,19344
1,9,2016,Rhino Sports salary,General,1600,20944
1,9,2016,Costa Coffee,Eating Out,1,20943
1,9,2016,McDonalds,Eating Out,4,20939
2,9,2016,Waitrose,Groceries,70,20869
2,9,2016,Wild Bean Cafe,Eating Out,2,20867
2,9,2016,The West Cornwall Pasty Company,Eating Out,4,20863
2,9,2016,Dominos Pizza,Eating Out,54,20809
3,9,2016,ATM Cash Withdrawal,General,20,20789
5,9,2016,South West Trains,Transport,18,20771
5,9,2016,Starbucks Coffee,Eating Out,1,20770
5,9,2016,McDonalds,Eating Out,7,20763
7,9,2016,Cubit and West rent,Rent,400,20363
7,9,2016,Caffe Nero,Eating Out,2,20361
7,9,2016,Subway,Eating Out,7,20354
7,9,2016,ATM Cash Withdrawal,General,10,20344
8,9,2016,Wild Bean Cafe,Eating Out,2,20342
9,9,2016,Morrisons,Groceries,71,20271
9,9,2016,Wild Bean Cafe,Eating Out,2,20269
9,9,2016,Pret A Manger,Eating Out,8,20261
9,9,2016,Dominos Pizza,Eating Out,30,20231
11,9,2016,Tool Shop,,7,20224
12,9,2016,South West Trains,Transport,20,20204
12,9,2016,Starbucks Coffee,Eating Out,1,20203
12,9,2016,Chicken Cottage,Eating Out,4,20199
13,9,2016,Costa Coffee,Eating Out,1,20198
13,9,2016,Subway,Eating Out,8,20190
14,9,2016,Caffe Nero,Eating Out,1,20189
15,9,2016,BRGAS-Electricity,Bills,25,20164
15,9,2016,BRGAS-Gas,Bills,22,20142
15,9,2016,Caffe Nero,Eating Out,1,20141
15,9,2016,McDonalds,Eating Out,8,20133
16,9,2016,LBS Council Tax,Bills,20,20113
16,9,2016,ASDA,Groceries,55,20058
16,9,2016,Wild Bean Cafe,Eating Out,1,20057
16,9,2016,Pizza Express,Eating Out,50,20007
16,9,2016,ATM Cash Withdrawal,General,10,19997
16,9,2016,Red Shop,,2,19995
18,9,2016,Pizza Express,Eating Out,29,19966
19,9,2016,South West Trains,Transport,23,19943
19,9,2016,Caffe Nero,Eating Out,2,19941
19,9,2016,ATM Cash Withdrawal,General,10,19931
20,9,2016,VIRGIN MEDIA PYMTS,Bills,21,19910
20,9,2016,Costa Coffee,Eating Out,2,19908
20,9,2016,Greggs,Eating Out,4,19904
20,9,2016,ATM Cash Withdrawal,General,10,19894
21,9,2016,Costa Coffee,Eating Out,2,19892
21,9,2016,Chicken Cottage,Eating Out,5,19887
21,9,2016,ATM Cash Withdrawal,General,20,19867
22,9,2016,Starbucks Coffee,Eating Out,2,19865
22,9,2016,Chicken Cottage,Eating Out,7,19858
23,9,2016,Sainsburys,Groceries,64,19794
23,9,2016,Starbucks Coffee,Eating Out,1,19793
23,9,2016,Subway,Eating Out,6,19787
23,9,2016,Pizza Express,Eating Out,44,19743
23,9,2016,ATM Cash Withdrawal,General,20,19723
24,9,2016,O2,Bills,21,19702
25,9,2016,ATM Cash Withdrawal,General,20,19682
26,9,2016,South West Trains,Transport,19,19663
26,9,2016,Starbucks Coffee,Eating Out,2,19661
26,9,2016,McDonalds,Eating Out,7,19654
27,9,2016,Starbucks Coffee,Eating Out,2,19652
27,9,2016,Greggs,Eating Out,5,19647
27,9,2016,ATM Cash Withdrawal,General,20,19627
28,9,2016,Greggs,Eating Out,5,19622
28,9,2016,ATM Cash Withdrawal,General,10,19612
29,9,2016,Wild Bean Cafe,Eating Out,2,19610
29,9,2016,The West Cornwall Pasty Company,Eating Out,6,19604
29,9,2016,ATM Cash Withdrawal,General,10,19594
30,9,2016,Tescos,Groceries,70,19524
30,9,2016,Wild Bean Cafe,Eating Out,1,19523
30,9,2016,McDonalds,Eating Out,8,19515
1,10,2016,Rhino Sports salary,General,1600,21115
2,10,2016,Anglo restaurant,Eating Out,36,21079
2,10,2016,ATM Cash Withdrawal,General,10,21069
3,10,2016,South West Trains,Transport,18,21051
3,10,2016,Starbucks Coffee,Eating Out,1,21050
4,10,2016,Wild Bean Cafe,Eating Out,2,21048
4,10,2016,Subway,Eating Out,8,21040
5,10,2016,Pret A Manger,Eating Out,6,21034
5,10,2016,ATM Cash Withdrawal,General,20,21014
5,10,2016,Tool Shop,,5,21009
6,10,2016,Caffe Nero,Eating Out,1,21008
6,10,2016,Chicken Cottage,Eating Out,8,21000
6,10,2016,Civic Shop,,4,20996
7,10,2016,Cubit and West rent,Rent,400,20596
7,10,2016,Sainsburys,Groceries,57,20539
7,10,2016,Costa Coffee,Eating Out,1,20538
7,10,2016,Pret A Manger,Eating Out,7,20531
8,10,2016,Fabric Club,Eating Out,16,20515
8,10,2016,Fabric Club,Eating Out,6,20509
8,10,2016,Fabric Club,Eating Out,6,20503
8,10,2016,ATM Cash Withdrawal,General,10,20493
9,10,2016,ATM Cash Withdrawal,General,10,20483
10,10,2016,South West Trains,Transport,18,20465
10,10,2016,Subway,Eating Out,6,20459
11,10,2016,Starbucks Coffee,Eating Out,2,20457
11,10,2016,Subway,Eating Out,4,20453
12,10,2016,Wild Bean Cafe,Eating Out,2,20451
12,10,2016,The West Cornwall Pasty Company,Eating Out,8,20443
13,10,2016,Subway,Eating Out,5,20438
14,10,2016,Waitrose,Groceries,50,20388
14,10,2016,Wild Bean Cafe,Eating Out,2,20386
14,10,2016,Dominos Pizza,Eating Out,38,20348
15,10,2016,BRGAS-Electricity,Bills,14,20334
15,10,2016,BRGAS-Gas,Bills,22,20312
15,10,2016,ATM Cash Withdrawal,General,20,20292
16,10,2016,LBS Council Tax,Bills,20,20272
16,10,2016,Restaurant Gordon RamsayPortland Restaurant,Eating Out,52,20220
16,10,2016,Civic Shop,,7,20213
17,10,2016,South West Trains,Transport,18,20195
17,10,2016,Caffe Nero,Eating Out,2,20193
17,10,2016,Subway,Eating Out,7,20186
18,10,2016,Costa Coffee,Eating Out,1,20185
18,10,2016,ATM Cash Withdrawal,General,10,20175
19,10,2016,Subway,Eating Out,5,20170
20,10,2016,VIRGIN MEDIA PYMTS,Bills,18,20152
20,10,2016,Caffe Nero,Eating Out,2,20150
20,10,2016,McDonalds,Eating Out,6,20144
21,10,2016,Morrisons,Groceries,66,20078
21,10,2016,Wild Bean Cafe,Eating Out,1,20077
21,10,2016,Greggs,Eating Out,6,20071
21,10,2016,The Grand Pub,Eating Out,9,20062
21,10,2016,The Grand Pub,Eating Out,9,20053
21,10,2016,The Grand Pub,Eating Out,7,20046
21,10,2016,Restaurant Gordon RamsayPortland Restaurant,Eating Out,59,19987
21,10,2016,ATM Cash Withdrawal,General,10,19977
22,10,2016,ATM Cash Withdrawal,General,20,19957
23,10,2016,Restaurant Gordon RamsayPortland Restaurant,Eating Out,56,19901
23,10,2016,ATM Cash Withdrawal,General,10,19891
23,10,2016,Cheam Service Station,,3,19888
24,10,2016,O2,Bills,23,19865
24,10,2016,South West Trains,Transport,23,19842
24,10,2016,Wild Bean Cafe,Eating Out,1,19841
24,10,2016,Chicken Cottage,Eating Out,8,19833
25,10,2016,ATM Cash Withdrawal,General,20,19813
26,10,2016,Pret A Manger,Eating Out,7,19806
28,10,2016,Tescos,Groceries,61,19745
28,10,2016,Wild Bean Cafe,Eating Out,1,19744
28,10,2016,The West Cornwall Pasty Company,Eating Out,6,19738
28,10,2016,ATM Cash Withdrawal,General,20,19718
30,10,2016,Scott's Restaurant,Eating Out,55,19663
31,10,2016,South West Trains,Transport,16,19647
31,10,2016,Wild Bean Cafe,Eating Out,2,19645
31,10,2016,ATM Cash Withdrawal,General,10,19635
1,11,2016,Rhino Sports salary,General,1600,21235
1,11,2016,Wild Bean Cafe,Eating Out,1,21234
1,11,2016,Greggs,Eating Out,5,21229
2,11,2016,Starbucks Coffee,Eating Out,2,21227
2,11,2016,McDonalds,Eating Out,8,21219
2,11,2016,ATM Cash Withdrawal,General,10,21209
3,11,2016,Caffe Nero,Eating Out,1,21208
3,11,2016,Subway,Eating Out,7,21201
3,11,2016,Cheam Service Station,,8,21193
4,11,2016,Tescos,Groceries,45,21148
4,11,2016,Starbucks Coffee,Eating Out,1,21147
4,11,2016,Pret A Manger,Eating Out,4,21143
4,11,2016,ATM Cash Withdrawal,General,20,21123
6,11,2016,Dominos Pizza,Eating Out,27,21096
7,11,2016,Cubit and West rent,Rent,400,20696
7,11,2016,South West Trains,Transport,22,20674
7,11,2016,Wild Bean Cafe,Eating Out,1,20673
8,11,2016,McDonalds,Eating Out,8,20665
9,11,2016,Costa Coffee,Eating Out,1,20664
9,11,2016,Cheam Service Station,,7,20657
10,11,2016,Wild Bean Cafe,Eating Out,2,20655
10,11,2016,Pret A Manger,Eating Out,5,20650
10,11,2016,ATM Cash Withdrawal,General,10,20640
10,11,2016,Cheam Service Station,,3,20637
11,11,2016,Morrisons,Groceries,54,20583
11,11,2016,The West Cornwall Pasty Company,Eating Out,7,20576
11,11,2016,Anglo restaurant,Eating Out,43,20533
11,11,2016,ATM Cash Withdrawal,General,20,20513
12,11,2016,Anglo restaurant,Eating Out,32,20481
12,11,2016,ATM Cash Withdrawal,General,20,20461
13,11,2016,Anglo restaurant,Eating Out,43,20418
14,11,2016,South West Trains,Transport,18,20400
14,11,2016,Wild Bean Cafe,Eating Out,2,20398
14,11,2016,Greggs,Eating Out,7,20391
15,11,2016,BRGAS-Electricity,Bills,58,20333
15,11,2016,BRGAS-Gas,Bills,58,20275
15,11,2016,Caffe Nero,Eating Out,1,20274
15,11,2016,McDonalds,Eating Out,8,20266
16,11,2016,LBS Council Tax,Bills,20,20246
16,11,2016,Caffe Nero,Eating Out,2,20244
17,11,2016,Costa Coffee,Eating Out,1,20243
17,11,2016,Pret A Manger,Eating Out,7,20236
18,11,2016,Morrisons,Groceries,41,20195
18,11,2016,Wild Bean Cafe,Eating Out,2,20193
18,11,2016,The West Cornwall Pasty Company,Eating Out,7,20186
20,11,2016,VIRGIN MEDIA PYMTS,Bills,23,20163
21,11,2016,South West Trains,Transport,20,20143
21,11,2016,Costa Coffee,Eating Out,2,20141
21,11,2016,Pret A Manger,Eating Out,5,20136
22,11,2016,Chicken Cottage,Eating Out,7,20129
23,11,2016,Costa Coffee,Eating Out,2,20127
23,11,2016,Chicken Cottage,Eating Out,4,20123
24,11,2016,O2,Bills,21,20102
24,11,2016,Wild Bean Cafe,Eating Out,2,20100
24,11,2016,McDonalds,Eating Out,6,20094
25,11,2016,ASDA,Groceries,55,20039
25,11,2016,Wild Bean Cafe,Eating Out,1,20038
25,11,2016,Ministry of Sound ClubXOYO Club,Eating Out,15,20023
25,11,2016,ATM Cash Withdrawal,General,20,20003
27,11,2016,ATM Cash Withdrawal,General,20,19983
28,11,2016,South West Trains,Transport,24,19959
28,11,2016,Starbucks Coffee,Eating Out,1,19958
28,11,2016,McDonalds,Eating Out,5,19953
28,11,2016,ATM Cash Withdrawal,General,20,19933
29,11,2016,Wild Bean Cafe,Eating Out,2,19931
29,11,2016,Tool Tec,,4,19927
30,11,2016,Starbucks Coffee,Eating Out,1,19926
1,12,2016,Rhino Sports salary,General,1600,21526
1,12,2016,Starbucks Coffee,Eating Out,2,21524
1,12,2016,Chicken Cottage,Eating Out,6,21518
2,12,2016,ASDA,Groceries,68,21450
2,12,2016,Costa Coffee,Eating Out,2,21448
2,12,2016,Pret A Manger,Eating Out,7,21441
5,12,2016,South West Trains,Transport,16,21425
5,12,2016,Caffe Nero,Eating Out,2,21423
5,12,2016,Subway,Eating Out,5,21418
5,12,2016,ATM Cash Withdrawal,General,20,21398
6,12,2016,Pret A Manger,Eating Out,8,21390
7,12,2016,Cubit and West rent,Rent,400,20990
7,12,2016,Caffe Nero,Eating Out,2,20988
7,12,2016,Pret A Manger,Eating Out,8,20980
8,12,2016,Chicken Cottage,Eating Out,5,20975
8,12,2016,Paying back Julie,,5,20970
9,12,2016,Sainsburys,Groceries,59,20911
9,12,2016,McDonalds,Eating Out,6,20905
9,12,2016,ATM Cash Withdrawal,General,10,20895
10,12,2016,Scott's Restaurant,Eating Out,48,20847
10,12,2016,ATM Cash Withdrawal,General,10,20837
12,12,2016,South West Trains,Transport,23,20814
12,12,2016,Costa Coffee,Eating Out,2,20812
12,12,2016,Paying back James,,7,20805
13,12,2016,Pret A Manger,Eating Out,4,20801
14,12,2016,Wild Bean Cafe,Eating Out,2,20799
14,12,2016,The West Cornwall Pasty Company,Eating Out,7,20792
15,12,2016,BRGAS-Electricity,Bills,23,20769
15,12,2016,BRGAS-Gas,Bills,29,20740
15,12,2016,Cheam Service Station,,7,20733
16,12,2016,LBS Council Tax,Bills,20,20713
16,12,2016,Waitrose,Groceries,40,20673
16,12,2016,Starbucks Coffee,Eating Out,1,20672
16,12,2016,Pret A Manger,Eating Out,7,20665
16,12,2016,Anglo restaurant,Eating Out,24,20641
16,12,2016,ATM Cash Withdrawal,General,20,20621
16,12,2016,Civic Shop,,2,20619
17,12,2016,ATM Cash Withdrawal,General,20,20599
18,12,2016,Dominos Pizza,Eating Out,55,20544
19,12,2016,South West Trains,Transport,16,20528
19,12,2016,Wild Bean Cafe,Eating Out,2,20526
19,12,2016,ATM Cash Withdrawal,General,20,20506
20,12,2016,VIRGIN MEDIA PYMTS,Bills,21,20485
20,12,2016,Starbucks Coffee,Eating Out,1,20484
21,12,2016,Caffe Nero,Eating Out,1,20483
21,12,2016,Chicken Cottage,Eating Out,5,20478
22,12,2016,Costa Coffee,Eating Out,1,20477
22,12,2016,Greggs,Eating Out,5,20472
22,12,2016,ATM Cash Withdrawal,General,20,20452
23,12,2016,Waitrose,Groceries,47,20405
23,12,2016,Costa Coffee,Eating Out,1,20404
23,12,2016,Restaurant Gordon RamsayPortland Restaurant,Eating Out,51,20353
24,12,2016,O2,Bills,23,20330
24,12,2016,ATM Cash Withdrawal,General,20,20310
24,12,2016,Paying back Julie,,7,20303
26,12,2016,South West Trains,Transport,23,20280
26,12,2016,Wild Bean Cafe,Eating Out,2,20278
27,12,2016,Costa Coffee,Eating Out,2,20276
27,12,2016,McDonalds,Eating Out,8,20268
27,12,2016,ATM Cash Withdrawal,General,10,20258
28,12,2016,Starbucks Coffee,Eating Out,2,20256
28,12,2016,Chicken Cottage,Eating Out,4,20252
28,12,2016,Civic Shop,,4,20248
29,12,2016,Starbucks Coffee,Eating Out,2,20246
30,12,2016,Sainsburys,Groceries,42,20204
30,12,2016,Wild Bean Cafe,Eating Out,2,20202
30,12,2016,Anglo restaurant,Eating Out,41,20161
31,12,2016,Anglo restaurant,Eating Out,48,20113
1,1,2017,Rhino Sports salary,General,1600,21713
1,1,2017,ATM Cash Withdrawal,General,20,21693
2,1,2017,South West Trains,Transport,25,21668
2,1,2017,Costa Coffee,Eating Out,2,21666
2,1,2017,Chicken Cottage,Eating Out,5,21661
2,1,2017,Paying back James,,8,21653
3,1,2017,Costa Coffee,Eating Out,2,21651
3,1,2017,Tool Shop,,6,21645
4,1,2017,ATM Cash Withdrawal,General,10,21635
5,1,2017,Starbucks Coffee,Eating Out,2,21633
5,1,2017,Greggs,Eating Out,4,21629
6,1,2017,ASDA,Groceries,48,21581
6,1,2017,Anglo restaurant,Eating Out,28,21553
6,1,2017,ATM Cash Withdrawal,General,20,21533
7,1,2017,Cubit and West rent,Rent,400,21133
8,1,2017,Pizza Express,Eating Out,39,21094
9,1,2017,South West Trains,Transport,17,21077
9,1,2017,Subway,Eating Out,6,21071
10,1,2017,Starbucks Coffee,Eating Out,1,21070
11,1,2017,Wild Bean Cafe,Eating Out,2,21068
11,1,2017,Pret A Manger,Eating Out,8,21060
12,1,2017,Costa Coffee,Eating Out,2,21058
13,1,2017,ASDA,Groceries,65,20993
13,1,2017,Starbucks Coffee,Eating Out,2,20991
13,1,2017,The West Cornwall Pasty Company,Eating Out,7,20984
13,1,2017,ATM Cash Withdrawal,General,20,20964
13,1,2017,Tool Shop,,9,20955
14,1,2017,ATM Cash Withdrawal,General,20,20935
15,1,2017,BRGAS-Electricity,Bills,31,20904
15,1,2017,BRGAS-Gas,Bills,17,20887
16,1,2017,LBS Council Tax,Bills,20,20867
16,1,2017,South West Trains,Transport,24,20843
16,1,2017,Starbucks Coffee,Eating Out,2,20841
16,1,2017,Chicken Cottage,Eating Out,7,20834
16,1,2017,ATM Cash Withdrawal,General,10,20824
17,1,2017,Caffe Nero,Eating Out,1,20823
17,1,2017,ATM Cash Withdrawal,General,10,20813
20,1,2017,VIRGIN MEDIA PYMTS,Bills,22,20791
20,1,2017,Morrisons,Groceries,67,20724
20,1,2017,Wild Bean Cafe,Eating Out,2,20722
20,1,2017,Subway,Eating Out,4,20718
20,1,2017,Restaurant Gordon RamsayPortland Restaurant,Eating Out,41,20677
21,1,2017,Pizza Express,Eating Out,55,20622
22,1,2017,Pizza Express,Eating Out,42,20580
23,1,2017,South West Trains,Transport,19,20561
23,1,2017,Caffe Nero,Eating Out,1,20560
24,1,2017,O2,Bills,21,20539
24,1,2017,Subway,Eating Out,8,20531
24,1,2017,ATM Cash Withdrawal,General,10,20521
25,1,2017,Caffe Nero,Eating Out,2,20519
25,1,2017,McDonalds,Eating Out,8,20511
26,1,2017,Caffe Nero,Eating Out,1,20510
27,1,2017,Tescos,Groceries,50,20460
27,1,2017,Starbucks Coffee,Eating Out,1,20459
27,1,2017,Restaurant Gordon RamsayPortland Restaurant,Eating Out,33,20426
27,1,2017,Red Shop,,9,20417
28,1,2017,Red Shop,,3,20414
29,1,2017,ATM Cash Withdrawal,General,20,20394
30,1,2017,South West Trains,Transport,18,20376
30,1,2017,Starbucks Coffee,Eating Out,1,20375
30,1,2017,McDonalds,Eating Out,4,20371
31,1,2017,Costa Coffee,Eating Out,2,20369
1,2,2017,Rhino Sports salary,General,1600,21969
2,2,2017,Caffe Nero,Eating Out,1,21968
2,2,2017,Subway,Eating Out,4,21964
3,2,2017,Morrisons,Groceries,43,21921
3,2,2017,Costa Coffee,Eating Out,1,21920
4,2,2017,Pizza Express,Eating Out,53,21867
6,2,2017,South West Trains,Transport,20,21847
6,2,2017,Caffe Nero,Eating Out,1,21846
6,2,2017,Pret A Manger,Eating Out,5,21841
7,2,2017,Cubit and West rent,Rent,400,21441
7,2,2017,Starbucks Coffee,Eating Out,1,21440
7,2,2017,Greggs,Eating Out,6,21434
7,2,2017,ATM Cash Withdrawal,General,20,21414
7,2,2017,Red Shop,,8,21406
8,2,2017,Costa Coffee,Eating Out,2,21404
8,2,2017,Subway,Eating Out,6,21398
8,2,2017,Paying back Julie,,7,21391
9,2,2017,Starbucks Coffee,Eating Out,2,21389
9,2,2017,ATM Cash Withdrawal,General,10,21379
10,2,2017,Morrisons,Groceries,70,21309
10,2,2017,Caffe Nero,Eating Out,2,21307
10,2,2017,Chicken Cottage,Eating Out,8,21299
10,2,2017,Scott's Restaurant,Eating Out,24,21275
10,2,2017,Cheam Service Station,,5,21270
11,2,2017,ATM Cash Withdrawal,General,10,21260
11,2,2017,Paying back James,,6,21254
12,2,2017,Scott's Restaurant,Eating Out,48,21206
13,2,2017,South West Trains,Transport,24,21182
13,2,2017,Starbucks Coffee,Eating Out,2,21180
13,2,2017,ATM Cash Withdrawal,General,10,21170
13,2,2017,Red Shop,,5,21165
14,2,2017,Caffe Nero,Eating Out,2,21163
14,2,2017,Chicken Cottage,Eating Out,6,21157
15,2,2017,BRGAS-Electricity,Bills,25,21132
15,2,2017,BRGAS-Gas,Bills,24,21108
15,2,2017,Caffe Nero,Eating Out,1,21107
15,2,2017,Pret A Manger,Eating Out,6,21101
16,2,2017,LBS Council Tax,Bills,20,21081
16,2,2017,The West Cornwall Pasty Company,Eating Out,5,21076
17,2,2017,Sainsburys,Groceries,63,21013
17,2,2017,Costa Coffee,Eating Out,1,21012
17,2,2017,Dominos Pizza,Eating Out,47,20965
17,2,2017,ATM Cash Withdrawal,General,10,20955
17,2,2017,Cheam Service Station,,5,20950
19,2,2017,ATM Cash Withdrawal,General,20,20930
20,2,2017,VIRGIN MEDIA PYMTS,Bills,25,20905
20,2,2017,South West Trains,Transport,20,20885
20,2,2017,Costa Coffee,Eating Out,2,20883
20,2,2017,Cheam Service Station,,4,20879
21,2,2017,Caffe Nero,Eating Out,2,20877
21,2,2017,Greggs,Eating Out,6,20871
22,2,2017,Costa Coffee,Eating Out,2,20869
23,2,2017,Caffe Nero,Eating Out,2,20867
23,2,2017,Chicken Cottage,Eating Out,8,20859
23,2,2017,Paying back James,,4,20855
24,2,2017,O2,Bills,20,20835
24,2,2017,Sainsburys,Groceries,61,20774
24,2,2017,Wild Bean Cafe,Eating Out,1,20773
24,2,2017,Subway,Eating Out,4,20769
24,2,2017,Scott's Restaurant,Eating Out,52,20717
26,2,2017,Anglo restaurant,Eating Out,32,20685
27,2,2017,South West Trains,Transport,25,20660
27,2,2017,Wild Bean Cafe,Eating Out,2,20658
27,2,2017,Greggs,Eating Out,7,20651
27,2,2017,Paying back James,,5,20646
28,2,2017,Costa Coffee,Eating Out,1,20645
28,2,2017,Pret A Manger,Eating Out,5,20640
1,3,2017,Rhino Sports salary,General,1600,22240
1,3,2017,Greggs,Eating Out,6,22234
2,3,2017,Caffe Nero,Eating Out,1,22233
2,3,2017,Subway,Eating Out,6,22227
3,3,2017,Waitrose,Groceries,45,22182
3,3,2017,Costa Coffee,Eating Out,2,22180
3,3,2017,Subway,Eating Out,6,22174
3,3,2017,The Grand Pub,Eating Out,10,22164
3,3,2017,The Grand Pub,Eating Out,5,22159
3,3,2017,The Grand Pub,Eating Out,5,22154
3,3,2017,The Grand Pub,Eating Out,7,22147
4,3,2017,ATM Cash Withdrawal,General,10,22137
5,3,2017,Restaurant Gordon RamsayPortland Restaurant,Eating Out,27,22110
6,3,2017,South West Trains,Transport,25,22085
6,3,2017,Costa Coffee,Eating Out,2,22083
6,3,2017,The West Cornwall Pasty Company,Eating Out,4,22079
7,3,2017,Cubit and West rent,Rent,400,21679
8,3,2017,Caffe Nero,Eating Out,2,21677
8,3,2017,Greggs,Eating Out,5,21672
9,3,2017,McDonalds,Eating Out,8,21664
10,3,2017,Tescos,Groceries,45,21619
10,3,2017,Wild Bean Cafe,Eating Out,2,21617
10,3,2017,ATM Cash Withdrawal,General,20,21597
12,3,2017,Dominos Pizza,Eating Out,49,21548
12,3,2017,ATM Cash Withdrawal,General,10,21538
13,3,2017,South West Trains,Transport,21,21517
13,3,2017,Starbucks Coffee,Eating Out,2,21515
13,3,2017,Pret A Manger,Eating Out,7,21508
14,3,2017,Costa Coffee,Eating Out,1,21507
14,3,2017,The West Cornwall Pasty Company,Eating Out,4,21503
14,3,2017,ATM Cash Withdrawal,General,10,21493
15,3,2017,BRGAS-Electricity,Bills,24,21469
15,3,2017,BRGAS-Gas,Bills,19,21450
15,3,2017,McDonalds,Eating Out,4,21446
15,3,2017,Civic Shop,,9,21437
16,3,2017,LBS Council Tax,Bills,20,21417
17,3,2017,Waitrose,Groceries,52,21365
17,3,2017,The West Cornwall Pasty Company,Eating Out,6,21359
18,3,2017,Restaurant Gordon RamsayPortland Restaurant,Eating Out,53,21306
18,3,2017,ATM Cash Withdrawal,General,10,21296
20,3,2017,VIRGIN MEDIA PYMTS,Bills,26,21270
20,3,2017,South West Trains,Transport,18,21252
20,3,2017,The West Cornwall Pasty Company,Eating Out,4,21248
20,3,2017,ATM Cash Withdrawal,General,20,21228
21,3,2017,Wild Bean Cafe,Eating Out,1,21227
22,3,2017,Wild Bean Cafe,Eating Out,2,21225
22,3,2017,Pret A Manger,Eating Out,5,21220
23,3,2017,Caffe Nero,Eating Out,2,21218
23,3,2017,Greggs,Eating Out,6,21212
24,3,2017,O2,Bills,24,21188
24,3,2017,Sainsburys,Groceries,40,21148
25,3,2017,Civic Shop,,7,21141
27,3,2017,South West Trains,Transport,22,21119
27,3,2017,Wild Bean Cafe,Eating Out,2,21117
27,3,2017,ATM Cash Withdrawal,General,10,21107
28,3,2017,Starbucks Coffee,Eating Out,1,21106
28,3,2017,Chicken Cottage,Eating Out,4,21102
29,3,2017,Wild Bean Cafe,Eating Out,2,21100
29,3,2017,Pret A Manger,Eating Out,4,21096
30,3,2017,Wild Bean Cafe,Eating Out,1,21095
30,3,2017,The West Cornwall Pasty Company,Eating Out,4,21091
31,3,2017,ASDA,Groceries,38,21053
31,3,2017,Subway,Eating Out,5,21048
1,4,2017,Rhino Sports salary,General,1600,22648
1,4,2017,ATM Cash Withdrawal,General,20,22628
1,4,2017,Cheam Service Station,,8,22620
3,4,2017,South West Trains,Transport,23,22597
3,4,2017,Starbucks Coffee,Eating Out,2,22595
3,4,2017,McDonalds,Eating Out,4,22591
4,4,2017,The West Cornwall Pasty Company,Eating Out,6,22585
4,4,2017,Paying back Julie,,1,22584
5,4,2017,Costa Coffee,Eating Out,2,22582
5,4,2017,Chicken Cottage,Eating Out,8,22574
6,4,2017,Costa Coffee,Eating Out,2,22572
6,4,2017,Subway,Eating Out,6,22566
7,4,2017,Cubit and West rent,Rent,400,22166
7,4,2017,ASDA,Groceries,45,22121
7,4,2017,Wild Bean Cafe,Eating Out,1,22120
7,4,2017,Greggs,Eating Out,6,22114
7,4,2017,Dominos Pizza,Eating Out,38,22076
8,4,2017,ATM Cash Withdrawal,General,20,22056
9,4,2017,Cheam Service Station,,3,22053
10,4,2017,South West Trains,Transport,21,22032
10,4,2017,Costa Coffee,Eating Out,1,22031
11,4,2017,Chicken Cottage,Eating Out,6,22025
12,4,2017,Wild Bean Cafe,Eating Out,2,22023
13,4,2017,Wild Bean Cafe,Eating Out,1,22022
13,4,2017,Chicken Cottage,Eating Out,6,22016
13,4,2017,ATM Cash Withdrawal,General,10,22006
13,4,2017,Civic Shop,,7,21999
14,4,2017,Tescos,Groceries,69,21930
14,4,2017,Wild Bean Cafe,Eating Out,2,21928
14,4,2017,Greggs,Eating Out,6,21922
14,4,2017,Scott's Restaurant,Eating Out,28,21894
14,4,2017,ATM Cash Withdrawal,General,20,21874
15,4,2017,BRGAS-Electricity,Bills,16,21858
15,4,2017,BRGAS-Gas,Bills,14,21844
15,4,2017,ATM Cash Withdrawal,General,10,21834
16,4,2017,LBS Council Tax,Bills,20,21814
16,4,2017,Pizza Express,Eating Out,44,21770
17,4,2017,South West Trains,Transport,22,21748
17,4,2017,Starbucks Coffee,Eating Out,2,21746
18,4,2017,Greggs,Eating Out,7,21739
18,4,2017,Paying back Julie,,7,21732
19,4,2017,Caffe Nero,Eating Out,2,21730
19,4,2017,Pret A Manger,Eating Out,8,21722
20,4,2017,VIRGIN MEDIA PYMTS,Bills,27,21695
20,4,2017,Greggs,Eating Out,4,21691
21,4,2017,Tescos,Groceries,57,21634
21,4,2017,Caffe Nero,Eating Out,2,21632
21,4,2017,Pizza Express,Eating Out,46,21586
23,4,2017,Restaurant Gordon RamsayPortland Restaurant,Eating Out,47,21539
23,4,2017,ATM Cash Withdrawal,General,10,21529
24,4,2017,O2,Bills,25,21504
24,4,2017,South West Trains,Transport,17,21487
24,4,2017,Caffe Nero,Eating Out,1,21486
24,4,2017,The West Cornwall Pasty Company,Eating Out,8,21478
24,4,2017,Paying back James,,9,21469
25,4,2017,Wild Bean Cafe,Eating Out,2,21467
25,4,2017,Greggs,Eating Out,6,21461
26,4,2017,Wild Bean Cafe,Eating Out,2,21459
26,4,2017,McDonalds,Eating Out,4,21455
27,4,2017,Wild Bean Cafe,Eating Out,1,21454
28,4,2017,Morrisons,Groceries,39,21415
28,4,2017,Starbucks Coffee,Eating Out,2,21413
28,4,2017,The West Cornwall Pasty Company,Eating Out,5,21408
28,4,2017,ATM Cash Withdrawal,General,10,21398
29,4,2017,Fabric Club,Eating Out,13,21385
30,4,2017,Dominos Pizza,Eating Out,40,21345
30,4,2017,Paying back James,,6,21339
1,5,2017,Rhino Sports salary,General,1600,22939
1,5,2017,South West Trains,Transport,24,22915
1,5,2017,Caffe Nero,Eating Out,1,22914
1,5,2017,ATM Cash Withdrawal,General,10,22904
2,5,2017,Costa Coffee,Eating Out,2,22902
2,5,2017,The West Cornwall Pasty Company,Eating Out,7,22895
3,5,2017,Caffe Nero,Eating Out,1,22894
3,5,2017,McDonalds,Eating Out,5,22889
3,5,2017,ATM Cash Withdrawal,General,20,22869
3,5,2017,Red Shop,,4,22865
4,5,2017,McDonalds,Eating Out,7,22858
5,5,2017,Tescos,Groceries,74,22784
5,5,2017,Wild Bean Cafe,Eating Out,2,22782
5,5,2017,Chicken Cottage,Eating Out,5,22777
5,5,2017,Anglo restaurant,Eating Out,29,22748
5,5,2017,ATM Cash Withdrawal,General,10,22738
6,5,2017,ATM Cash Withdrawal,General,10,22728
7,5,2017,Cubit and West rent,Rent,400,22328
8,5,2017,South West Trains,Transport,24,22304
8,5,2017,Costa Coffee,Eating Out,2,22302
8,5,2017,The West Cornwall Pasty Company,Eating Out,4,22298
9,5,2017,Caffe Nero,Eating Out,1,22297
9,5,2017,Subway,Eating Out,7,22290
9,5,2017,ATM Cash Withdrawal,General,20,22270
10,5,2017,Costa Coffee,Eating Out,2,22268
10,5,2017,McDonalds,Eating Out,6,22262
11,5,2017,Starbucks Coffee,Eating Out,1,22261
11,5,2017,ATM Cash Withdrawal,General,10,22251
12,5,2017,Tescos,Groceries,73,22178
12,5,2017,Costa Coffee,Eating Out,2,22176
12,5,2017,ATM Cash Withdrawal,General,20,22156
15,5,2017,BRGAS-Electricity,Bills,26,22130
15,5,2017,BRGAS-Gas,Bills,21,22109
15,5,2017,South West Trains,Transport,20,22089
15,5,2017,Starbucks Coffee,Eating Out,2,22087
15,5,2017,McDonalds,Eating Out,7,22080
16,5,2017,LBS Council Tax,Bills,20,22060
16,5,2017,Caffe Nero,Eating Out,2,22058
16,5,2017,Chicken Cottage,Eating Out,6,22052
18,5,2017,McDonalds,Eating Out,4,22048
19,5,2017,Tescos,Groceries,61,21987
19,5,2017,Starbucks Coffee,Eating Out,2,21985
19,5,2017,Anglo restaurant,Eating Out,43,21942
20,5,2017,VIRGIN MEDIA PYMTS,Bills,28,21914
20,5,2017,Heaven Club,Eating Out,9,21905
20,5,2017,ATM Cash Withdrawal,General,10,21895
21,5,2017,Pizza Express,Eating Out,52,21843
22,5,2017,South West Trains,Transport,24,21819
22,5,2017,Costa Coffee,Eating Out,2,21817
22,5,2017,ATM Cash Withdrawal,General,10,21807
23,5,2017,Starbucks Coffee,Eating Out,2,21805
23,5,2017,Greggs,Eating Out,7,21798
24,5,2017,O2,Bills,20,21778
24,5,2017,Starbucks Coffee,Eating Out,2,21776
24,5,2017,ATM Cash Withdrawal,General,20,21756
25,5,2017,Costa Coffee,Eating Out,1,21755
25,5,2017,Chicken Cottage,Eating Out,6,21749
25,5,2017,ATM Cash Withdrawal,General,10,21739
26,5,2017,Tescos,Groceries,70,21669
26,5,2017,Wild Bean Cafe,Eating Out,1,21668
26,5,2017,McDonalds,Eating Out,4,21664
26,5,2017,Fabric Club,Eating Out,9,21655
26,5,2017,Fabric Club,Eating Out,7,21648
26,5,2017,Fabric Club,Eating Out,7,21641
26,5,2017,Pizza Express,Eating Out,30,21611
29,5,2017,South West Trains,Transport,17,21594
29,5,2017,Starbucks Coffee,Eating Out,1,21593
29,5,2017,Paying back James,,1,21592
30,5,2017,Wild Bean Cafe,Eating Out,2,21590
30,5,2017,The West Cornwall Pasty Company,Eating Out,5,21585
31,5,2017,Wild Bean Cafe,Eating Out,2,21583
31,5,2017,McDonalds,Eating Out,6,21577
31,5,2017,ATM Cash Withdrawal,General,20,21557
31,5,2017,Cheam Service Station,,8,21549
1,6,2017,Rhino Sports salary,General,1600,23149
1,6,2017,Caffe Nero,Eating Out,1,23148
2,6,2017,Morrisons,Groceries,37,23111
2,6,2017,Starbucks Coffee,Eating Out,2,23109
2,6,2017,McDonalds,Eating Out,5,23104
2,6,2017,ATM Cash Withdrawal,General,10,23094
5,6,2017,South West Trains,Transport,20,23074
5,6,2017,Starbucks Coffee,Eating Out,1,23073
5,6,2017,Chicken Cottage,Eating Out,5,23068
6,6,2017,Caffe Nero,Eating Out,2,23066
6,6,2017,Red Shop,,3,23063
7,6,2017,Cubit and West rent,Rent,400,22663
7,6,2017,Costa Coffee,Eating Out,2,22661
8,6,2017,Costa Coffee,Eating Out,1,22660
8,6,2017,ATM Cash Withdrawal,General,20,22640
9,6,2017,Morrisons,Groceries,40,22600
9,6,2017,Starbucks Coffee,Eating Out,2,22598
10,6,2017,Scott's Restaurant,Eating Out,28,22570
10,6,2017,ATM Cash Withdrawal,General,10,22560
11,6,2017,ATM Cash Withdrawal,General,10,22550
12,6,2017,South West Trains,Transport,20,22530
12,6,2017,McDonalds,Eating Out,5,22525
13,6,2017,Costa Coffee,Eating Out,1,22524
15,6,2017,BRGAS-Electricity,Bills,19,22505
15,6,2017,BRGAS-Gas,Bills,22,22483
15,6,2017,Starbucks Coffee,Eating Out,2,22481
15,6,2017,McDonalds,Eating Out,6,22475
16,6,2017,LBS Council Tax,Bills,20,22455
16,6,2017,Waitrose,Groceries,71,22384
16,6,2017,Costa Coffee,Eating Out,2,22382
16,6,2017,McDonalds,Eating Out,8,22374
16,6,2017,Restaurant Gordon RamsayPortland Restaurant,Eating Out,33,22341
19,6,2017,South West Trains,Transport,17,22324
19,6,2017,Costa Coffee,Eating Out,1,22323
19,6,2017,McDonalds,Eating Out,4,22319
19,6,2017,Paying back James,,1,22318
20,6,2017,VIRGIN MEDIA PYMTS,Bills,15,22303
20,6,2017,McDonalds,Eating Out,8,22295
21,6,2017,Greggs,Eating Out,6,22289
21,6,2017,ATM Cash Withdrawal,General,20,22269
22,6,2017,Starbucks Coffee,Eating Out,2,22267
22,6,2017,Pret A Manger,Eating Out,8,22259
22,6,2017,Tool Shop,,5,22254
23,6,2017,Sainsburys,Groceries,43,22211
23,6,2017,Starbucks Coffee,Eating Out,1,22210
23,6,2017,The West Cornwall Pasty Company,Eating Out,6,22204
23,6,2017,Scott's Restaurant,Eating Out,51,22153
23,6,2017,Paying back James,,5,22148
24,6,2017,O2,Bills,23,22125
24,6,2017,Restaurant Gordon RamsayPortland Restaurant,Eating Out,59,22066
26,6,2017,South West Trains,Transport,24,22042
26,6,2017,Starbucks Coffee,Eating Out,1,22041
26,6,2017,Subway,Eating Out,5,22036
26,6,2017,ATM Cash Withdrawal,General,10,22026
26,6,2017,Paying back Julie,,4,22022
27,6,2017,Starbucks Coffee,Eating Out,1,22021
27,6,2017,Chicken Cottage,Eating Out,4,22017
28,6,2017,Costa Coffee,Eating Out,1,22016
29,6,2017,Costa Coffee,Eating Out,2,22014
29,6,2017,Greggs,Eating Out,7,22007
30,6,2017,Morrisons,Groceries,44,21963
30,6,2017,Starbucks Coffee,Eating Out,1,21962
1,7,2017,Rhino Sports salary,General,1600,23562
1,7,2017,Restaurant Gordon RamsayPortland Restaurant,Eating Out,55,23507
2,7,2017,ATM Cash Withdrawal,General,20,23487
3,7,2017,South West Trains,Transport,23,23464
3,7,2017,Costa Coffee,Eating Out,1,23463
4,7,2017,Starbucks Coffee,Eating Out,2,23461
5,7,2017,Wild Bean Cafe,Eating Out,2,23459
6,7,2017,Costa Coffee,Eating Out,1,23458
7,7,2017,Cubit and West rent,Rent,400,23058
7,7,2017,ASDA,Groceries,61,22997
7,7,2017,Starbucks Coffee,Eating Out,2,22995
7,7,2017,Anglo restaurant,Eating Out,34,22961
7,7,2017,ATM Cash Withdrawal,General,20,22941
9,7,2017,Dominos Pizza,Eating Out,34,22907
9,7,2017,ATM Cash Withdrawal,General,10,22897
10,7,2017,South West Trains,Transport,22,22875
10,7,2017,Starbucks Coffee,Eating Out,1,22874
10,7,2017,Pret A Manger,Eating Out,4,22870
11,7,2017,Starbucks Coffee,Eating Out,1,22869
11,7,2017,ATM Cash Withdrawal,General,20,22849
12,7,2017,Caffe Nero,Eating Out,1,22848
12,7,2017,Chicken Cottage,Eating Out,8,22840
13,7,2017,Wild Bean Cafe,Eating Out,2,22838
13,7,2017,ATM Cash Withdrawal,General,20,22818
14,7,2017,ASDA,Groceries,40,22778
14,7,2017,Wild Bean Cafe,Eating Out,1,22777
14,7,2017,ATM Cash Withdrawal,General,20,22757
15,7,2017,BRGAS-Electricity,Bills,19,22738
15,7,2017,BRGAS-Gas,Bills,25,22713
15,7,2017,Dominos Pizza,Eating Out,51,22662
15,7,2017,ATM Cash Withdrawal,General,20,22642
16,7,2017,LBS Council Tax,Bills,20,22622
16,7,2017,Anglo restaurant,Eating Out,52,22570
16,7,2017,Paying back Julie,,1,22569
17,7,2017,South West Trains,Transport,23,22546
17,7,2017,Caffe Nero,Eating Out,2,22544
17,7,2017,ATM Cash Withdrawal,General,20,22524
18,7,2017,Costa Coffee,Eating Out,1,22523
18,7,2017,The West Cornwall Pasty Company,Eating Out,5,22518
18,7,2017,Red Shop,,9,22509
19,7,2017,Wild Bean Cafe,Eating Out,2,22507
19,7,2017,The West Cornwall Pasty Company,Eating Out,8,22499
19,7,2017,ATM Cash Withdrawal,General,20,22479
20,7,2017,VIRGIN MEDIA PYMTS,Bills,27,22452
20,7,2017,Costa Coffee,Eating Out,1,22451
20,7,2017,McDonalds,Eating Out,8,22443
21,7,2017,ASDA,Groceries,44,22399
21,7,2017,McDonalds,Eating Out,4,22395
22,7,2017,ATM Cash Withdrawal,General,10,22385
24,7,2017,O2,Bills,24,22361
24,7,2017,South West Trains,Transport,21,22340
24,7,2017,Greggs,Eating Out,5,22335
25,7,2017,Starbucks Coffee,Eating Out,2,22333
25,7,2017,Chicken Cottage,Eating Out,6,22327
26,7,2017,Costa Coffee,Eating Out,1,22326
26,7,2017,Subway,Eating Out,5,22321
27,7,2017,Starbucks Coffee,Eating Out,2,22319
27,7,2017,The West Cornwall Pasty Company,Eating Out,7,22312
28,7,2017,Tescos,Groceries,54,22258
28,7,2017,Costa Coffee,Eating Out,1,22257
28,7,2017,McDonalds,Eating Out,6,22251
29,7,2017,Anglo restaurant,Eating Out,45,22206
30,7,2017,Scott's Restaurant,Eating Out,58,22148
31,7,2017,South West Trains,Transport,16,22132
31,7,2017,Subway,Eating Out,5,22127
1,8,2017,Rhino Sports salary,General,1600,23727
1,8,2017,Caffe Nero,Eating Out,1,23726
1,8,2017,Chicken Cottage,Eating Out,7,23719
2,8,2017,Wild Bean Cafe,Eating Out,2,23717
2,8,2017,Greggs,Eating Out,6,23711
3,8,2017,Caffe Nero,Eating Out,2,23709
3,8,2017,Subway,Eating Out,7,23702
4,8,2017,Sainsburys,Groceries,44,23658
4,8,2017,Caffe Nero,Eating Out,2,23656
4,8,2017,McDonalds,Eating Out,4,23652
4,8,2017,ATM Cash Withdrawal,General,20,23632
5,8,2017,Pizza Express,Eating Out,55,23577
5,8,2017,ATM Cash Withdrawal,General,10,23567
6,8,2017,Anglo restaurant,Eating Out,33,23534
7,8,2017,Cubit and West rent,Rent,400,23134
7,8,2017,South West Trains,Transport,16,23118
7,8,2017,Caffe Nero,Eating Out,2,23116
7,8,2017,McDonalds,Eating Out,7,23109
9,8,2017,Chicken Cottage,Eating Out,8,23101
9,8,2017,Cheam Service Station,,5,23096
10,8,2017,Starbucks Coffee,Eating Out,2,23094
11,8,2017,Tescos,Groceries,70,23024
11,8,2017,Costa Coffee,Eating Out,2,23022
11,8,2017,Anglo restaurant,Eating Out,58,22964
11,8,2017,ATM Cash Withdrawal,General,10,22954
13,8,2017,Pizza Express,Eating Out,46,22908
13,8,2017,ATM Cash Withdrawal,General,10,22898
14,8,2017,South West Trains,Transport,18,22880
14,8,2017,Starbucks Coffee,Eating Out,1,22879
15,8,2017,BRGAS-Electricity,Bills,16,22863
15,8,2017,BRGAS-Gas,Bills,18,22845
15,8,2017,The West Cornwall Pasty Company,Eating Out,7,22838
15,8,2017,Red Shop,,3,22835
16,8,2017,LBS Council Tax,Bills,20,22815
16,8,2017,The West Cornwall Pasty Company,Eating Out,8,22807
17,8,2017,Costa Coffee,Eating Out,1,22806
17,8,2017,Paying back James,,1,22805
18,8,2017,Waitrose,Groceries,74,22731
18,8,2017,Starbucks Coffee,Eating Out,2,22729
18,8,2017,Chicken Cottage,Eating Out,6,22723
18,8,2017,ATM Cash Withdrawal,General,10,22713
19,8,2017,ATM Cash Withdrawal,General,20,22693
20,8,2017,VIRGIN MEDIA PYMTS,Bills,16,22677
20,8,2017,ATM Cash Withdrawal,General,10,22667
21,8,2017,South West Trains,Transport,21,22646
21,8,2017,ATM Cash Withdrawal,General,20,22626
22,8,2017,The West Cornwall Pasty Company,Eating Out,4,22622
22,8,2017,ATM Cash Withdrawal,General,10,22612
23,8,2017,Starbucks Coffee,Eating Out,1,22611
23,8,2017,McDonalds,Eating Out,5,22606
23,8,2017,ATM Cash Withdrawal,General,20,22586
24,8,2017,O2,Bills,20,22566
24,8,2017,Wild Bean Cafe,Eating Out,2,22564
24,8,2017,The West Cornwall Pasty Company,Eating Out,6,22558
24,8,2017,ATM Cash Withdrawal,General,10,22548
25,8,2017,Tescos,Groceries,40,22508
25,8,2017,Costa Coffee,Eating Out,2,22506
25,8,2017,Greggs,Eating Out,5,22501
25,8,2017,Fabric Club,Eating Out,14,22487
25,8,2017,Fabric Club,Eating Out,12,22475
25,8,2017,Fabric Club,Eating Out,7,22468
25,8,2017,ATM Cash Withdrawal,General,20,22448
26,8,2017,ATM Cash Withdrawal,General,10,22438
26,8,2017,Civic Shop,,4,22434
27,8,2017,Dominos Pizza,Eating Out,33,22401
28,8,2017,South West Trains,Transport,23,22378
28,8,2017,Costa Coffee,Eating Out,2,22376
29,8,2017,Wild Bean Cafe,Eating Out,1,22375
30,8,2017,Starbucks Coffee,Eating Out,2,22373
30,8,2017,Tool Shop,,9,22364
31,8,2017,Starbucks Coffee,Eating Out,2,22362
31,8,2017,Red Shop,,4,22358
1,9,2017,Rhino Sports salary,General,1600,23958
1,9,2017,Tescos,Groceries,57,23901
1,9,2017,Starbucks Coffee,Eating Out,2,23899
1,9,2017,Pret A Manger,Eating Out,5,23894
1,9,2017,Scott's Restaurant,Eating Out,55,23839
2,9,2017,The Grand Pub,Eating Out,13,23826
2,9,2017,The Grand Pub,Eating Out,14,23812
2,9,2017,The Grand Pub,Eating Out,8,23804
2,9,2017,ATM Cash Withdrawal,General,10,23794
3,9,2017,Anglo restaurant,Eating Out,58,23736
3,9,2017,ATM Cash Withdrawal,General,20,23716
4,9,2017,South West Trains,Transport,16,23700
4,9,2017,Wild Bean Cafe,Eating Out,1,23699
4,9,2017,Pret A Manger,Eating Out,4,23695
5,9,2017,The West Cornwall Pasty Company,Eating Out,8,23687
6,9,2017,Costa Coffee,Eating Out,2,23685
6,9,2017,Civic Shop,,6,23679
7,9,2017,Cubit and West rent,Rent,400,23279
7,9,2017,Caffe Nero,Eating Out,2,23277
7,9,2017,Red Shop,,6,23271
8,9,2017,Waitrose,Groceries,41,23230
8,9,2017,Wild Bean Cafe,Eating Out,2,23228
8,9,2017,McDonalds,Eating Out,5,23223
9,9,2017,ATM Cash Withdrawal,General,10,23213
11,9,2017,South West Trains,Transport,21,23192
11,9,2017,Costa Coffee,Eating Out,2,23190
11,9,2017,McDonalds,Eating Out,5,23185
13,9,2017,Wild Bean Cafe,Eating Out,2,23183
13,9,2017,McDonalds,Eating Out,8,23175
14,9,2017,Starbucks Coffee,Eating Out,2,23173
15,9,2017,BRGAS-Electricity,Bills,25,23148
15,9,2017,BRGAS-Gas,Bills,24,23124
15,9,2017,Tescos,Groceries,39,23085
15,9,2017,Greggs,Eating Out,8,23077
16,9,2017,LBS Council Tax,Bills,20,23057
16,9,2017,Ministry of Sound ClubXOYO Club,Eating Out,7,23050
16,9,2017,Anglo restaurant,Eating Out,49,23001
17,9,2017,ATM Cash Withdrawal,General,20,22981
18,9,2017,South West Trains,Transport,16,22965
18,9,2017,Caffe Nero,Eating Out,2,22963
18,9,2017,Pret A Manger,Eating Out,6,22957
19,9,2017,Starbucks Coffee,Eating Out,2,22955
20,9,2017,VIRGIN MEDIA PYMTS,Bills,14,22941
20,9,2017,Caffe Nero,Eating Out,1,22940
21,9,2017,Starbucks Coffee,Eating Out,2,22938
21,9,2017,ATM Cash Withdrawal,General,10,22928
22,9,2017,Tescos,Groceries,49,22879
22,9,2017,Wild Bean Cafe,Eating Out,2,22877
22,9,2017,The Grand Pub,Eating Out,9,22868
22,9,2017,The Grand Pub,Eating Out,13,22855
22,9,2017,Anglo restaurant,Eating Out,43,22812
23,9,2017,Scott's Restaurant,Eating Out,31,22781
23,9,2017,Paying back James,,9,22772
24,9,2017,O2,Bills,24,22748
24,9,2017,Restaurant Gordon RamsayPortland Restaurant,Eating Out,44,22704
25,9,2017,South West Trains,Transport,24,22680
25,9,2017,Wild Bean Cafe,Eating Out,2,22678
25,9,2017,Greggs,Eating Out,5,22673
26,9,2017,Wild Bean Cafe,Eating Out,2,22671
26,9,2017,Greggs,Eating Out,8,22663
28,9,2017,Starbucks Coffee,Eating Out,2,22661
28,9,2017,ATM Cash Withdrawal,General,20,22641
29,9,2017,Tescos,Groceries,40,22601
29,9,2017,Starbucks Coffee,Eating Out,2,22599
29,9,2017,Subway,Eating Out,6,22593
29,9,2017,Anglo restaurant,Eating Out,30,22563
29,9,2017,ATM Cash Withdrawal,General,20,22543
29,9,2017,Paying back James,,9,22534
30,9,2017,Fabric Club,Eating Out,6,22528
30,9,2017,Fabric Club,Eating Out,15,22513
30,9,2017,Fabric Club,Eating Out,16,22497
1,10,2017,Rhino Sports salary,General,1600,24097
1,10,2017,Restaurant Gordon RamsayPortland Restaurant,Eating Out,53,24044
1,10,2017,ATM Cash Withdrawal,General,10,24034
2,10,2017,South West Trains,Transport,17,24017
2,10,2017,Costa Coffee,Eating Out,2,24015
2,10,2017,Pret A Manger,Eating Out,6,24009
3,10,2017,Wild Bean Cafe,Eating Out,2,24007
4,10,2017,Chicken Cottage,Eating Out,6,24001
4,10,2017,ATM Cash Withdrawal,General,10,23991
5,10,2017,Wild Bean Cafe,Eating Out,1,23990
5,10,2017,Greggs,Eating Out,7,23983
6,10,2017,Tescos,Groceries,42,23941
6,10,2017,Wild Bean Cafe,Eating Out,1,23940
6,10,2017,The West Cornwall Pasty Company,Eating Out,8,23932
6,10,2017,Heaven Club,Eating Out,8,23924
6,10,2017,Heaven Club,Eating Out,14,23910
6,10,2017,Heaven Club,Eating Out,12,23898
6,10,2017,Heaven Club,Eating Out,10,23888
6,10,2017,Heaven Club,Eating Out,16,23872
6,10,2017,Heaven Club,Eating Out,11,23861
6,10,2017,Dominos Pizza,Eating Out,53,23808
7,10,2017,Cubit and West rent,Rent,400,23408
7,10,2017,Dominos Pizza,Eating Out,42,23366
9,10,2017,South West Trains,Transport,17,23349
9,10,2017,Costa Coffee,Eating Out,2,23347
9,10,2017,Greggs,Eating Out,4,23343
10,10,2017,Starbucks Coffee,Eating Out,2,23341
10,10,2017,Subway,Eating Out,8,23333
11,10,2017,McDonalds,Eating Out,6,23327
11,10,2017,ATM Cash Withdrawal,General,20,23307
11,10,2017,Paying back Julie,,6,23301
12,10,2017,Costa Coffee,Eating Out,1,23300
13,10,2017,Tescos,Groceries,72,23228
13,10,2017,Greggs,Eating Out,7,23221
13,10,2017,Dominos Pizza,Eating Out,59,23162
14,10,2017,Ministry of Sound ClubXOYO Club,Eating Out,14,23148
14,10,2017,Ministry of Sound ClubXOYO Club,Eating Out,12,23136
14,10,2017,ATM Cash Withdrawal,General,10,23126
15,10,2017,BRGAS-Electricity,Bills,19,23107
15,10,2017,BRGAS-Gas,Bills,29,23078
16,10,2017,LBS Council Tax,Bills,20,23058
16,10,2017,South West Trains,Transport,16,23042
16,10,2017,ATM Cash Withdrawal,General,20,23022
17,10,2017,Costa Coffee,Eating Out,2,23020
17,10,2017,The West Cornwall Pasty Company,Eating Out,7,23013
18,10,2017,Starbucks Coffee,Eating Out,2,23011
18,10,2017,McDonalds,Eating Out,5,23006
18,10,2017,ATM Cash Withdrawal,General,20,22986
19,10,2017,Caffe Nero,Eating Out,2,22984
19,10,2017,Greggs,Eating Out,7,22977
20,10,2017,VIRGIN MEDIA PYMTS,Bills,16,22961
20,10,2017,Morrisons,Groceries,46,22915
20,10,2017,Wild Bean Cafe,Eating Out,2,22913
20,10,2017,The Grand Pub,Eating Out,13,22900
20,10,2017,The Grand Pub,Eating Out,14,22886
20,10,2017,The Grand Pub,Eating Out,8,22878
20,10,2017,The Grand Pub,Eating Out,13,22865
23,10,2017,South West Trains,Transport,25,22840
23,10,2017,Costa Coffee,Eating Out,2,22838
23,10,2017,The West Cornwall Pasty Company,Eating Out,7,22831
24,10,2017,O2,Bills,24,22807
24,10,2017,Caffe Nero,Eating Out,2,22805
24,10,2017,McDonalds,Eating Out,6,22799
25,10,2017,Red Shop,,4,22795
26,10,2017,Costa Coffee,Eating Out,2,22793
26,10,2017,The West Cornwall Pasty Company,Eating Out,5,22788
26,10,2017,ATM Cash Withdrawal,General,10,22778
26,10,2017,Paying back James,,4,22774
27,10,2017,Morrisons,Groceries,66,22708
27,10,2017,Caffe Nero,Eating Out,2,22706
27,10,2017,Dominos Pizza,Eating Out,30,22676
27,10,2017,ATM Cash Withdrawal,General,10,22666
30,10,2017,South West Trains,Transport,22,22644
30,10,2017,Wild Bean Cafe,Eating Out,1,22643
30,10,2017,Subway,Eating Out,6,22637
31,10,2017,Caffe Nero,Eating Out,1,22636
31,10,2017,Pret A Manger,Eating Out,8,22628
31,10,2017,ATM Cash Withdrawal,General,10,22618
1,11,2017,Rhino Sports salary,General,1600,24218
1,11,2017,Wild Bean Cafe,Eating Out,1,24217
1,11,2017,The West Cornwall Pasty Company,Eating Out,8,24209
2,11,2017,Starbucks Coffee,Eating Out,1,24208
2,11,2017,Chicken Cottage,Eating Out,8,24200
2,11,2017,ATM Cash Withdrawal,General,20,24180
3,11,2017,ASDA,Groceries,45,24135
3,11,2017,Starbucks Coffee,Eating Out,2,24133
3,11,2017,Subway,Eating Out,5,24128
3,11,2017,Dominos Pizza,Eating Out,59,24069
5,11,2017,Pizza Express,Eating Out,57,24012
5,11,2017,ATM Cash Withdrawal,General,10,24002
6,11,2017,South West Trains,Transport,22,23980
6,11,2017,Caffe Nero,Eating Out,1,23979
6,11,2017,Pret A Manger,Eating Out,5,23974
6,11,2017,ATM Cash Withdrawal,General,20,23954
7,11,2017,Cubit and West rent,Rent,400,23554
7,11,2017,Starbucks Coffee,Eating Out,1,23553
7,11,2017,McDonalds,Eating Out,7,23546
7,11,2017,ATM Cash Withdrawal,General,10,23536
8,11,2017,Wild Bean Cafe,Eating Out,1,23535
9,11,2017,Costa Coffee,Eating Out,2,23533
9,11,2017,The West Cornwall Pasty Company,Eating Out,7,23526
10,11,2017,Sainsburys,Groceries,63,23463
10,11,2017,Costa Coffee,Eating Out,1,23462
11,11,2017,ATM Cash Withdrawal,General,10,23452
13,11,2017,South West Trains,Transport,21,23431
13,11,2017,Caffe Nero,Eating Out,2,23429
14,11,2017,Starbucks Coffee,Eating Out,2,23427
14,11,2017,Greggs,Eating Out,6,23421
15,11,2017,BRGAS-Electricity,Bills,36,23385
15,11,2017,BRGAS-Gas,Bills,16,23369
15,11,2017,Starbucks Coffee,Eating Out,1,23368
15,11,2017,Chicken Cottage,Eating Out,7,23361
16,11,2017,LBS Council Tax,Bills,20,23341
17,11,2017,Waitrose,Groceries,67,23274
17,11,2017,ATM Cash Withdrawal,General,10,23264
18,11,2017,Restaurant Gordon RamsayPortland Restaurant,Eating Out,53,23211
19,11,2017,Pizza Express,Eating Out,30,23181
20,11,2017,VIRGIN MEDIA PYMTS,Bills,26,23155
20,11,2017,South West Trains,Transport,20,23135
20,11,2017,Caffe Nero,Eating Out,2,23133
20,11,2017,Greggs,Eating Out,7,23126
22,11,2017,Costa Coffee,Eating Out,2,23124
22,11,2017,Chicken Cottage,Eating Out,8,23116
23,11,2017,Caffe Nero,Eating Out,2,23114
23,11,2017,Greggs,Eating Out,4,23110
24,11,2017,O2,Bills,25,23085
24,11,2017,ASDA,Groceries,63,23022
24,11,2017,Costa Coffee,Eating Out,2,23020
25,11,2017,Scott's Restaurant,Eating Out,41,22979
27,11,2017,South West Trains,Transport,22,22957
27,11,2017,ATM Cash Withdrawal,General,10,22947
28,11,2017,Pret A Manger,Eating Out,6,22941
29,11,2017,Starbucks Coffee,Eating Out,1,22940
29,11,2017,Greggs,Eating Out,5,22935
30,11,2017,Starbucks Coffee,Eating Out,2,22933
30,11,2017,Pret A Manger,Eating Out,4,22929
1,12,2017,Rhino Sports salary,General,1600,24529
1,12,2017,Tescos,Groceries,72,24457
1,12,2017,Wild Bean Cafe,Eating Out,1,24456
1,12,2017,Pret A Manger,Eating Out,5,24451
1,12,2017,The Grand Pub,Eating Out,13,24438
1,12,2017,The Grand Pub,Eating Out,5,24433
1,12,2017,The Grand Pub,Eating Out,11,24422
2,12,2017,The Grand Pub,Eating Out,16,24406
2,12,2017,The Grand Pub,Eating Out,9,24397
2,12,2017,Restaurant Gordon RamsayPortland Restaurant,Eating Out,26,24371
4,12,2017,South West Trains,Transport,17,24354
4,12,2017,Costa Coffee,Eating Out,1,24353
4,12,2017,Chicken Cottage,Eating Out,4,24349
4,12,2017,Paying back Julie,,1,24348
5,12,2017,Caffe Nero,Eating Out,1,24347
5,12,2017,Subway,Eating Out,5,24342
6,12,2017,Costa Coffee,Eating Out,2,24340
6,12,2017,ATM Cash Withdrawal,General,20,24320
7,12,2017,Cubit and West rent,Rent,400,23920
7,12,2017,Starbucks Coffee,Eating Out,2,23918
7,12,2017,ATM Cash Withdrawal,General,20,23898
8,12,2017,Tescos,Groceries,52,23846
8,12,2017,Costa Coffee,Eating Out,1,23845
9,12,2017,ATM Cash Withdrawal,General,10,23835
10,12,2017,ATM Cash Withdrawal,General,20,23815
11,12,2017,South West Trains,Transport,23,23792
11,12,2017,Caffe Nero,Eating Out,2,23790
11,12,2017,McDonalds,Eating Out,6,23784
12,12,2017,Caffe Nero,Eating Out,2,23782
13,12,2017,Caffe Nero,Eating Out,1,23781
14,12,2017,Pret A Manger,Eating Out,6,23775
14,12,2017,ATM Cash Withdrawal,General,20,23755
15,12,2017,BRGAS-Electricity,Bills,19,23736
15,12,2017,BRGAS-Gas,Bills,17,23719
15,12,2017,Sainsburys,Groceries,73,23646
15,12,2017,Wild Bean Cafe,Eating Out,2,23644
15,12,2017,Pizza Express,Eating Out,31,23613
16,12,2017,LBS Council Tax,Bills,20,23593
16,12,2017,Scott's Restaurant,Eating Out,31,23562
16,12,2017,ATM Cash Withdrawal,General,10,23552
18,12,2017,South West Trains,Transport,22,23530
18,12,2017,Subway,Eating Out,4,23526
19,12,2017,Wild Bean Cafe,Eating Out,2,23524
20,12,2017,VIRGIN MEDIA PYMTS,Bills,15,23509
20,12,2017,ATM Cash Withdrawal,General,10,23499
21,12,2017,Starbucks Coffee,Eating Out,2,23497
21,12,2017,Subway,Eating Out,8,23489
21,12,2017,Red Shop,,3,23486
22,12,2017,Morrisons,Groceries,43,23443
22,12,2017,Starbucks Coffee,Eating Out,2,23441
22,12,2017,McDonalds,Eating Out,8,23433
22,12,2017,Scott's Restaurant,Eating Out,31,23402
24,12,2017,O2,Bills,22,23380
25,12,2017,South West Trains,Transport,23,23357
25,12,2017,Wild Bean Cafe,Eating Out,1,23356
25,12,2017,Chicken Cottage,Eating Out,5,23351
26,12,2017,Starbucks Coffee,Eating Out,2,23349
26,12,2017,Chicken Cottage,Eating Out,6,23343
27,12,2017,Wild Bean Cafe,Eating Out,2,23341
27,12,2017,Chicken Cottage,Eating Out,8,23333
27,12,2017,Paying back Julie,,7,23326
28,12,2017,Wild Bean Cafe,Eating Out,2,23324
29,12,2017,ASDA,Groceries,36,23288
29,12,2017,Starbucks Coffee,Eating Out,2,23286
29,12,2017,McDonalds,Eating Out,6,23280
30,12,2017,Restaurant Gordon RamsayPortland Restaurant,Eating Out,44,23236
31,12,2017,ATM Cash Withdrawal,General,20,23216
1,1,2018,Rhino Sports salary,General,1600,24816
1,1,2018,South West Trains,Transport,25,24791
1,1,2018,Caffe Nero,Eating Out,2,24789
1,1,2018,ATM Cash Withdrawal,General,10,24779
1,1,2018,Civic Shop,,4,24775
2,1,2018,Pret A Manger,Eating Out,5,24770
3,1,2018,Caffe Nero,Eating Out,2,24768
4,1,2018,Wild Bean Cafe,Eating Out,2,24766
5,1,2018,Sainsburys,Groceries,39,24727
5,1,2018,Costa Coffee,Eating Out,2,24725
5,1,2018,Chicken Cottage,Eating Out,7,24718
5,1,2018,Heaven Club,Eating Out,12,24706
5,1,2018,Heaven Club,Eating Out,8,24698
5,1,2018,Heaven Club,Eating Out,11,24687
5,1,2018,Heaven Club,Eating Out,6,24681
5,1,2018,Heaven Club,Eating Out,16,24665
5,1,2018,ATM Cash Withdrawal,General,20,24645
6,1,2018,Heaven Club,Eating Out,5,24640
7,1,2018,Cubit and West rent,Rent,400,24240
7,1,2018,Restaurant Gordon RamsayPortland Restaurant,Eating Out,25,24215
8,1,2018,South West Trains,Transport,18,24197
8,1,2018,Wild Bean Cafe,Eating Out,2,24195
9,1,2018,Starbucks Coffee,Eating Out,2,24193
10,1,2018,Costa Coffee,Eating Out,1,24192
10,1,2018,Chicken Cottage,Eating Out,6,24186
10,1,2018,ATM Cash Withdrawal,General,20,24166
11,1,2018,Chicken Cottage,Eating Out,5,24161
11,1,2018,ATM Cash Withdrawal,General,10,24151
12,1,2018,Tescos,Groceries,71,24080
12,1,2018,Starbucks Coffee,Eating Out,2,24078
12,1,2018,Restaurant Gordon RamsayPortland Restaurant,Eating Out,43,24035
14,1,2018,Tool Shop,,6,24029
15,1,2018,BRGAS-Electricity,Bills,43,23986
15,1,2018,BRGAS-Gas,Bills,36,23950
15,1,2018,South West Trains,Transport,25,23925
15,1,2018,Wild Bean Cafe,Eating Out,2,23923
16,1,2018,LBS Council Tax,Bills,20,23903
16,1,2018,Caffe Nero,Eating Out,1,23902
16,1,2018,Subway,Eating Out,5,23897
16,1,2018,Civic Shop,,3,23894
17,1,2018,Wild Bean Cafe,Eating Out,2,23892
17,1,2018,Pret A Manger,Eating Out,6,23886
18,1,2018,Caffe Nero,Eating Out,2,23884
18,1,2018,McDonalds,Eating Out,5,23879
19,1,2018,ASDA,Groceries,61,23818
19,1,2018,Starbucks Coffee,Eating Out,2,23816
20,1,2018,VIRGIN MEDIA PYMTS,Bills,17,23799
20,1,2018,Pizza Express,Eating Out,59,23740
20,1,2018,ATM Cash Withdrawal,General,20,23720
22,1,2018,South West Trains,Transport,25,23695
22,1,2018,Caffe Nero,Eating Out,1,23694
22,1,2018,Pret A Manger,Eating Out,5,23689
23,1,2018,Caffe Nero,Eating Out,1,23688
23,1,2018,Chicken Cottage,Eating Out,6,23682
24,1,2018,O2,Bills,20,23662
24,1,2018,Starbucks Coffee,Eating Out,1,23661
25,1,2018,Costa Coffee,Eating Out,2,23659
25,1,2018,ATM Cash Withdrawal,General,10,23649
25,1,2018,Tool Tec,,3,23646
26,1,2018,Sainsburys,Groceries,69,23577
26,1,2018,Caffe Nero,Eating Out,1,23576
26,1,2018,Chicken Cottage,Eating Out,7,23569
26,1,2018,Tool Shop,,9,23560
28,1,2018,ATM Cash Withdrawal,General,10,23550
28,1,2018,Cheam Service Station,,9,23541
29,1,2018,South West Trains,Transport,19,23522
29,1,2018,Costa Coffee,Eating Out,2,23520
29,1,2018,Subway,Eating Out,7,23513
29,1,2018,Red Shop,,5,23508
30,1,2018,Wild Bean Cafe,Eating Out,2,23506
30,1,2018,Pret A Manger,Eating Out,4,23502
30,1,2018,ATM Cash Withdrawal,General,10,23492
31,1,2018,ATM Cash Withdrawal,General,20,23472
1,2,2018,Rhino Sports salary,General,1600,25072
1,2,2018,Costa Coffee,Eating Out,1,25071
1,2,2018,McDonalds,Eating Out,5,25066
2,2,2018,Waitrose,Groceries,60,25006
2,2,2018,Caffe Nero,Eating Out,1,25005
2,2,2018,ATM Cash Withdrawal,General,10,24995
3,2,2018,Scott's Restaurant,Eating Out,26,24969
5,2,2018,South West Trains,Transport,19,24950
5,2,2018,Wild Bean Cafe,Eating Out,2,24948
5,2,2018,Greggs,Eating Out,6,24942
5,2,2018,ATM Cash Withdrawal,General,10,24932
6,2,2018,Caffe Nero,Eating Out,1,24931
6,2,2018,Subway,Eating Out,8,24923
6,2,2018,ATM Cash Withdrawal,General,20,24903
7,2,2018,Cubit and West rent,Rent,400,24503
7,2,2018,Wild Bean Cafe,Eating Out,2,24501
7,2,2018,Chicken Cottage,Eating Out,7,24494
7,2,2018,ATM Cash Withdrawal,General,10,24484
8,2,2018,Pret A Manger,Eating Out,6,24478
9,2,2018,Waitrose,Groceries,42,24436
9,2,2018,Caffe Nero,Eating Out,1,24435
9,2,2018,Pret A Manger,Eating Out,7,24428
9,2,2018,Fabric Club,Eating Out,15,24413
9,2,2018,Fabric Club,Eating Out,14,24399
9,2,2018,Fabric Club,Eating Out,11,24388
9,2,2018,Fabric Club,Eating Out,7,24381
9,2,2018,Restaurant Gordon RamsayPortland Restaurant,Eating Out,39,24342
10,2,2018,Pizza Express,Eating Out,53,24289
11,2,2018,Paying back Julie,,9,24280
12,2,2018,South West Trains,Transport,21,24259
12,2,2018,Starbucks Coffee,Eating Out,2,24257
12,2,2018,Tool Shop,,1,24256
13,2,2018,ATM Cash Withdrawal,General,10,24246
14,2,2018,Starbucks Coffee,Eating Out,2,24244
14,2,2018,The West Cornwall Pasty Company,Eating Out,8,24236
14,2,2018,Paying back Julie,,6,24230
15,2,2018,BRGAS-Electricity,Bills,26,24204
15,2,2018,BRGAS-Gas,Bills,17,24187
15,2,2018,Caffe Nero,Eating Out,2,24185
15,2,2018,Subway,Eating Out,6,24179
15,2,2018,ATM Cash Withdrawal,General,20,24159
16,2,2018,LBS Council Tax,Bills,20,24139
16,2,2018,Tescos,Groceries,51,24088
16,2,2018,Wild Bean Cafe,Eating Out,2,24086
16,2,2018,Chicken Cottage,Eating Out,8,24078
16,2,2018,Anglo restaurant,Eating Out,47,24031
17,2,2018,Pizza Express,Eating Out,29,24002
18,2,2018,ATM Cash Withdrawal,General,10,23992
19,2,2018,South West Trains,Transport,22,23970
19,2,2018,Wild Bean Cafe,Eating Out,1,23969
19,2,2018,Tool Tec,,7,23962
20,2,2018,VIRGIN MEDIA PYMTS,Bills,27,23935
21,2,2018,Wild Bean Cafe,Eating Out,2,23933
21,2,2018,McDonalds,Eating Out,5,23928
21,2,2018,Paying back James,,9,23919
22,2,2018,Starbucks Coffee,Eating Out,2,23917
22,2,2018,ATM Cash Withdrawal,General,20,23897
23,2,2018,Waitrose,Groceries,37,23860
23,2,2018,Greggs,Eating Out,5,23855
23,2,2018,Fabric Club,Eating Out,16,23839
23,2,2018,Fabric Club,Eating Out,5,23834
23,2,2018,Fabric Club,Eating Out,9,23825
23,2,2018,Fabric Club,Eating Out,11,23814
23,2,2018,Dominos Pizza,Eating Out,40,23774
23,2,2018,ATM Cash Withdrawal,General,20,23754
24,2,2018,O2,Bills,24,23730
24,2,2018,Dominos Pizza,Eating Out,57,23673
24,2,2018,Paying back Julie,,4,23669
26,2,2018,South West Trains,Transport,23,23646
26,2,2018,Caffe Nero,Eating Out,2,23644
26,2,2018,Chicken Cottage,Eating Out,8,23636
28,2,2018,Paying back Julie,,9,23627
1,3,2018,Rhino Sports salary,General,1600,25227
1,3,2018,Costa Coffee,Eating Out,1,25226
1,3,2018,ATM Cash Withdrawal,General,20,25206
2,3,2018,Morrisons,Groceries,45,25161
2,3,2018,Costa Coffee,Eating Out,2,25159
2,3,2018,Restaurant Gordon RamsayPortland Restaurant,Eating Out,46,25113
3,3,2018,ATM Cash Withdrawal,General,20,25093
4,3,2018,Scott's Restaurant,Eating Out,30,25063
5,3,2018,South West Trains,Transport,22,25041
5,3,2018,Wild Bean Cafe,Eating Out,1,25040
5,3,2018,ATM Cash Withdrawal,General,10,25030
7,3,2018,Cubit and West rent,Rent,400,24630
7,3,2018,Wild Bean Cafe,Eating Out,1,24629
7,3,2018,McDonalds,Eating Out,7,24622
8,3,2018,Starbucks Coffee,Eating Out,2,24620
8,3,2018,The West Cornwall Pasty Company,Eating Out,8,24612
9,3,2018,ASDA,Groceries,60,24552
9,3,2018,Wild Bean Cafe,Eating Out,2,24550
9,3,2018,McDonalds,Eating Out,8,24542
10,3,2018,Scott's Restaurant,Eating Out,42,24500
10,3,2018,ATM Cash Withdrawal,General,20,24480
10,3,2018,Tool Tec,,1,24479
11,3,2018,Restaurant Gordon RamsayPortland Restaurant,Eating Out,42,24437
12,3,2018,South West Trains,Transport,18,24419
12,3,2018,Caffe Nero,Eating Out,2,24417
12,3,2018,McDonalds,Eating Out,4,24413
13,3,2018,Pret A Manger,Eating Out,8,24405
13,3,2018,ATM Cash Withdrawal,General,10,24395
14,3,2018,Caffe Nero,Eating Out,2,24393
14,3,2018,Subway,Eating Out,8,24385
15,3,2018,BRGAS-Electricity,Bills,24,24361
15,3,2018,BRGAS-Gas,Bills,29,24332
15,3,2018,Costa Coffee,Eating Out,2,24330
15,3,2018,Chicken Cottage,Eating Out,5,24325
15,3,2018,ATM Cash Withdrawal,General,20,24305
15,3,2018,Tool Tec,,6,24299
16,3,2018,LBS Council Tax,Bills,20,24279
16,3,2018,Sainsburys,Groceries,50,24229
16,3,2018,Wild Bean Cafe,Eating Out,2,24227
16,3,2018,Greggs,Eating Out,7,24220
17,3,2018,Anglo restaurant,Eating Out,49,24171
19,3,2018,South West Trains,Transport,25,24146
19,3,2018,Caffe Nero,Eating Out,2,24144
19,3,2018,Subway,Eating Out,8,24136
20,3,2018,VIRGIN MEDIA PYMTS,Bills,20,24116
20,3,2018,Wild Bean Cafe,Eating Out,2,24114
20,3,2018,The West Cornwall Pasty Company,Eating Out,8,24106
21,3,2018,Starbucks Coffee,Eating Out,2,24104
21,3,2018,Chicken Cottage,Eating Out,4,24100
22,3,2018,Caffe Nero,Eating Out,1,24099
22,3,2018,Chicken Cottage,Eating Out,8,24091
22,3,2018,Tool Tec,,7,24084
23,3,2018,ASDA,Groceries,65,24019
23,3,2018,Costa Coffee,Eating Out,2,24017
23,3,2018,Chicken Cottage,Eating Out,6,24011
23,3,2018,Heaven Club,Eating Out,9,24002
23,3,2018,Heaven Club,Eating Out,5,23997
23,3,2018,Heaven Club,Eating Out,12,23985
24,3,2018,O2,Bills,23,23962
24,3,2018,Anglo restaurant,Eating Out,36,23926
26,3,2018,South West Trains,Transport,22,23904
26,3,2018,Starbucks Coffee,Eating Out,2,23902
26,3,2018,ATM Cash Withdrawal,General,20,23882
27,3,2018,Pret A Manger,Eating Out,7,23875
28,3,2018,Wild Bean Cafe,Eating Out,2,23873
29,3,2018,The West Cornwall Pasty Company,Eating Out,5,23868
30,3,2018,ASDA,Groceries,47,23821
30,3,2018,The West Cornwall Pasty Company,Eating Out,5,23816
30,3,2018,Dominos Pizza,Eating Out,26,23790
31,3,2018,Pizza Express,Eating Out,47,23743
31,3,2018,ATM Cash Withdrawal,General,10,23733
1,4,2018,Rhino Sports salary,General,1600,25333
1,4,2018,Dominos Pizza,Eating Out,29,25304
1,4,2018,ATM Cash Withdrawal,General,20,25284
2,4,2018,South West Trains,Transport,17,25267
2,4,2018,Costa Coffee,Eating Out,2,25265
2,4,2018,Pret A Manger,Eating Out,8,25257
3,4,2018,Costa Coffee,Eating Out,2,25255
3,4,2018,Subway,Eating Out,8,25247
4,4,2018,Costa Coffee,Eating Out,1,25246
4,4,2018,Cheam Service Station,,7,25239
5,4,2018,Starbucks Coffee,Eating Out,2,25237
5,4,2018,The West Cornwall Pasty Company,Eating Out,8,25229
6,4,2018,Waitrose,Groceries,62,25167
6,4,2018,Starbucks Coffee,Eating Out,1,25166
6,4,2018,Heaven Club,Eating Out,14,25152
6,4,2018,Heaven Club,Eating Out,12,25140
6,4,2018,Heaven Club,Eating Out,12,25128
6,4,2018,Heaven Club,Eating Out,14,25114
6,4,2018,Heaven Club,Eating Out,7,25107
6,4,2018,Heaven Club,Eating Out,9,25098
6,4,2018,Pizza Express,Eating Out,36,25062
7,4,2018,Cubit and West rent,Rent,400,24662
7,4,2018,Civic Shop,,4,24658
9,4,2018,South West Trains,Transport,16,24642
9,4,2018,Wild Bean Cafe,Eating Out,1,24641
9,4,2018,ATM Cash Withdrawal,General,10,24631
10,4,2018,Costa Coffee,Eating Out,2,24629
10,4,2018,Chicken Cottage,Eating Out,5,24624
11,4,2018,Wild Bean Cafe,Eating Out,1,24623
11,4,2018,Greggs,Eating Out,8,24615
11,4,2018,Red Shop,,9,24606
12,4,2018,Caffe Nero,Eating Out,1,24605
12,4,2018,Chicken Cottage,Eating Out,4,24601
13,4,2018,Sainsburys,Groceries,70,24531
13,4,2018,Caffe Nero,Eating Out,2,24529
13,4,2018,Paying back James,,7,24522
14,4,2018,Fabric Club,Eating Out,9,24513
14,4,2018,Restaurant Gordon RamsayPortland Restaurant,Eating Out,25,24488
15,4,2018,BRGAS-Electricity,Bills,25,24463
15,4,2018,BRGAS-Gas,Bills,17,24446
15,4,2018,Scott's Restaurant,Eating Out,59,24387
15,4,2018,Tool Tec,,7,24380
16,4,2018,LBS Council Tax,Bills,20,24360
16,4,2018,South West Trains,Transport,19,24341
16,4,2018,Costa Coffee,Eating Out,2,24339
16,4,2018,The West Cornwall Pasty Company,Eating Out,8,24331
17,4,2018,Wild Bean Cafe,Eating Out,2,24329
17,4,2018,Pret A Manger,Eating Out,4,24325
17,4,2018,ATM Cash Withdrawal,General,10,24315
17,4,2018,Tool Tec,,1,24314
18,4,2018,Caffe Nero,Eating Out,1,24313
18,4,2018,Chicken Cottage,Eating Out,8,24305
19,4,2018,Chicken Cottage,Eating Out,7,24298
20,4,2018,VIRGIN MEDIA PYMTS,Bills,14,24284
20,4,2018,ASDA,Groceries,36,24248
20,4,2018,Caffe Nero,Eating Out,1,24247
20,4,2018,Chicken Cottage,Eating Out,5,24242
20,4,2018,Paying back James,,5,24237
21,4,2018,Dominos Pizza,Eating Out,45,24192
