Day,Month,Year,Description,Category,Value,Balance
1,1,2010,Rhino Sports salary,General,1600,1600
1,1,2010,ASDA,Groceries,47,1553
1,1,2010,Wild Bean Cafe,Eating Out,1,1552
1,1,2010,Pret A Manger,Eating Out,5,1547
2,1,2010,ATM Cash Withdrawal,General,20,1527
2,1,2010,Paying back Julie,,4,1523
4,1,2010,South West Trains,Transport,33,1490
4,1,2010,Costa Coffee,Eating Out,2,1488
4,1,2010,The West Cornwall Pasty Company,Eating Out,7,1481
4,1,2010,ATM Cash Withdrawal,General,20,1461
4,1,2010,Paying back Julie,,8,1453
5,1,2010,Caffe Nero,Eating Out,1,1452
5,1,2010,The West Cornwall Pasty Company,Eating Out,5,1447
5,1,2010,ATM Cash Withdrawal,General,10,1437
6,1,2010,Starbucks Coffee,Eating Out,1,1436
6,1,2010,The West Cornwall Pasty Company,Eating Out,8,1428
7,1,2010,Cubit and West rent,Rent,440,988
7,1,2010,Starbucks Coffee,Eating Out,1,987
7,1,2010,Subway,Eating Out,7,980
7,1,2010,Tool Shop,,1,979
8,1,2010,Tescos,Groceries,66,913
8,1,2010,Dominos Pizza,Eating Out,31,882
9,1,2010,Paying back James,,1,881
11,1,2010,South West Trains,Transport,38,843
11,1,2010,Wild Bean Cafe,Eating Out,2,841
11,1,2010,Pret A Manger,Eating Out,8,833
11,1,2010,ATM Cash Withdrawal,General,10,823
12,1,2010,Starbucks Coffee,Eating Out,2,821
12,1,2010,Pret A Manger,Eating Out,5,816
13,1,2010,Wild Bean Cafe,Eating Out,2,814
13,1,2010,McDonalds,Eating Out,5,809
14,1,2010,Starbucks Coffee,Eating Out,1,808
14,1,2010,ATM Cash Withdrawal,General,20,788
15,1,2010,BRGAS-Electricity,Bills,39,749
15,1,2010,BRGAS-Gas,Bills,44,705
15,1,2010,Tescos,Groceries,47,658
15,1,2010,Starbucks Coffee,Eating Out,1,657
15,1,2010,Pret A Manger,Eating Out,6,651
15,1,2010,Cheam Service Station,,2,649
16,1,2010,LBS Council Tax,Bills,35,614
16,1,2010,ATM Cash Withdrawal,General,10,604
17,1,2010,Scott's Restaurant,Eating Out,24,580
17,1,2010,Cheam Service Station,,5,575
18,1,2010,South West Trains,Transport,34,541
18,1,2010,Costa Coffee,Eating Out,2,539
18,1,2010,Subway,Eating Out,8,531
18,1,2010,ATM Cash Withdrawal,General,10,521
19,1,2010,Wild Bean Cafe,Eating Out,1,520
19,1,2010,McDonalds,Eating Out,7,513
20,1,2010,VIRGIN MEDIA PYMTS,Bills,42,471
20,1,2010,Costa Coffee,Eating Out,2,469
20,1,2010,Pret A Manger,Eating Out,4,465
20,1,2010,ATM Cash Withdrawal,General,20,445
21,1,2010,Wild Bean Cafe,Eating Out,2,443
21,1,2010,Greggs,Eating Out,4,439
22,1,2010,Morrisons,Groceries,74,365
22,1,2010,Starbucks Coffee,Eating Out,2,363
23,1,2010,ATM Cash Withdrawal,General,20,343
23,1,2010,Civic Shop,,9,334
24,1,2010,O2,Bills,27,307
24,1,2010,Scott's Restaurant,Eating Out,46,261
25,1,2010,South West Trains,Transport,35,226
25,1,2010,Wild Bean Cafe,Eating Out,2,224
25,1,2010,Pret A Manger,Eating Out,4,220
26,1,2010,Costa Coffee,Eating Out,2,218
26,1,2010,Subway,Eating Out,8,210
27,1,2010,Caffe Nero,Eating Out,1,209
27,1,2010,ATM Cash Withdrawal,General,20,189
27,1,2010,Cheam Service Station,,2,187
28,1,2010,Caffe Nero,Eating Out,2,185
29,1,2010,Waitrose,Groceries,41,144
29,1,2010,Wild Bean Cafe,Eating Out,1,143
29,1,2010,Anglo restaurant,Eating Out,34,109
29,1,2010,Cheam Service Station,,7,102
30,1,2010,Dominos Pizza,Eating Out,53,49
31,1,2010,ATM Cash Withdrawal,General,10,39
1,2,2010,Rhino Sports salary,General,1600,1639
1,2,2010,South West Trains,Transport,30,1609
1,2,2010,Wild Bean Cafe,Eating Out,2,1607
1,2,2010,McDonalds,Eating Out,8,1599
2,2,2010,Greggs,Eating Out,8,1591
3,2,2010,Caffe Nero,Eating Out,2,1589
3,2,2010,The West Cornwall Pasty Company,Eating Out,7,1582
3,2,2010,ATM Cash Withdrawal,General,10,1572
4,2,2010,Greggs,Eating Out,6,1566
4,2,2010,ATM Cash Withdrawal,General,20,1546
5,2,2010,Morrisons,Groceries,58,1488
5,2,2010,Caffe Nero,Eating Out,1,1487
5,2,2010,The West Cornwall Pasty Company,Eating Out,5,1482
5,2,2010,Dominos Pizza,Eating Out,44,1438
6,2,2010,ATM Cash Withdrawal,General,20,1418
7,2,2010,Cubit and West rent,Rent,440,978
7,2,2010,Civic Shop,,7,971
8,2,2010,South West Trains,Transport,37,934
8,2,2010,The West Cornwall Pasty Company,Eating Out,5,929
8,2,2010,ATM Cash Withdrawal,General,20,909
9,2,2010,Starbucks Coffee,Eating Out,2,907
10,2,2010,Caffe Nero,Eating Out,2,905
10,2,2010,ATM Cash Withdrawal,General,20,885
11,2,2010,Costa Coffee,Eating Out,2,883
11,2,2010,ATM Cash Withdrawal,General,10,873
12,2,2010,Sainsburys,Groceries,61,812
12,2,2010,Starbucks Coffee,Eating Out,2,810
13,2,2010,Tool Shop,,2,808
15,2,2010,BRGAS-Electricity,Bills,23,785
15,2,2010,BRGAS-Gas,Bills,36,749
15,2,2010,South West Trains,Transport,32,717
15,2,2010,Caffe Nero,Eating Out,2,715
15,2,2010,Chicken Cottage,Eating Out,8,707
16,2,2010,LBS Council Tax,Bills,35,672
16,2,2010,Costa Coffee,Eating Out,2,670
16,2,2010,ATM Cash Withdrawal,General,10,660
17,2,2010,Caffe Nero,Eating Out,2,658
17,2,2010,ATM Cash Withdrawal,General,10,648
18,2,2010,Starbucks Coffee,Eating Out,2,646
18,2,2010,The West Cornwall Pasty Company,Eating Out,7,639
19,2,2010,Morrisons,Groceries,61,578
19,2,2010,Costa Coffee,Eating Out,2,576
19,2,2010,Restaurant Gordon RamsayPortland Restaurant,Eating Out,52,524
20,2,2010,VIRGIN MEDIA PYMTS,Bills,25,499
20,2,2010,Tool Shop,,6,493
21,2,2010,Tool Tec,,4,489
22,2,2010,South West Trains,Transport,37,452
22,2,2010,Costa Coffee,Eating Out,1,451
23,2,2010,Caffe Nero,Eating Out,2,449
24,2,2010,O2,Bills,25,424
24,2,2010,Caffe Nero,Eating Out,1,423
24,2,2010,Greggs,Eating Out,5,418
24,2,2010,ATM Cash Withdrawal,General,10,408
24,2,2010,Civic Shop,,3,405
25,2,2010,Caffe Nero,Eating Out,2,403
25,2,2010,Pret A Manger,Eating Out,7,396
26,2,2010,Tescos,Groceries,66,330
26,2,2010,Pret A Manger,Eating Out,6,324
26,2,2010,ATM Cash Withdrawal,General,20,304
27,2,2010,Anglo restaurant,Eating Out,57,247
27,2,2010,ATM Cash Withdrawal,General,10,237
28,2,2010,Paying back Julie,,9,228
1,3,2010,Rhino Sports salary,General,1600,1828
1,3,2010,South West Trains,Transport,31,1797
1,3,2010,Costa Coffee,Eating Out,2,1795
1,3,2010,The West Cornwall Pasty Company,Eating Out,5,1790
2,3,2010,Starbucks Coffee,Eating Out,2,1788
2,3,2010,Chicken Cottage,Eating Out,7,1781
2,3,2010,ATM Cash Withdrawal,General,20,1761
3,3,2010,Wild Bean Cafe,Eating Out,1,1760
3,3,2010,McDonalds,Eating Out,5,1755
3,3,2010,ATM Cash Withdrawal,General,10,1745
4,3,2010,Starbucks Coffee,Eating Out,2,1743
5,3,2010,Sainsburys,Groceries,79,1664
5,3,2010,Starbucks Coffee,Eating Out,2,1662
5,3,2010,ATM Cash Withdrawal,General,20,1642
6,3,2010,ATM Cash Withdrawal,General,20,1622
7,3,2010,Cubit and West rent,Rent,440,1182
7,3,2010,Dominos Pizza,Eating Out,49,1133
8,3,2010,South West Trains,Transport,24,1109
8,3,2010,Wild Bean Cafe,Eating Out,1,1108
8,3,2010,Greggs,Eating Out,4,1104
9,3,2010,Chicken Cottage,Eating Out,5,1099
10,3,2010,Starbucks Coffee,Eating Out,1,1098
10,3,2010,Chicken Cottage,Eating Out,4,1094
11,3,2010,Costa Coffee,Eating Out,1,1093
12,3,2010,Morrisons,Groceries,68,1025
12,3,2010,Caffe Nero,Eating Out,2,1023
12,3,2010,Chicken Cottage,Eating Out,4,1019
12,3,2010,Scott's Restaurant,Eating Out,27,992
13,3,2010,ATM Cash Withdrawal,General,10,982
13,3,2010,Cheam Service Station,,2,980
14,3,2010,Scott's Restaurant,Eating Out,44,936
14,3,2010,ATM Cash Withdrawal,General,20,916
14,3,2010,Paying back Julie,,4,912
15,3,2010,BRGAS-Electricity,Bills,26,886
15,3,2010,BRGAS-Gas,Bills,35,851
15,3,2010,South West Trains,Transport,33,818
15,3,2010,Wild Bean Cafe,Eating Out,2,816
15,3,2010,Greggs,Eating Out,6,810
15,3,2010,ATM Cash Withdrawal,General,20,790
16,3,2010,LBS Council Tax,Bills,35,755
17,3,2010,Subway,Eating Out,5,750
18,3,2010,ATM Cash Withdrawal,General,10,740
19,3,2010,Sainsburys,Groceries,62,678
19,3,2010,Starbucks Coffee,Eating Out,2,676
19,3,2010,McDonalds,Eating Out,8,668
19,3,2010,Pizza Express,Eating Out,33,635
19,3,2010,ATM Cash Withdrawal,General,20,615
19,3,2010,Tool Shop,,7,608
20,3,2010,VIRGIN MEDIA PYMTS,Bills,37,571
20,3,2010,Anglo restaurant,Eating Out,28,543
20,3,2010,Paying back Julie,,2,541
21,3,2010,ATM Cash Withdrawal,General,10,531
22,3,2010,South West Trains,Transport,32,499
22,3,2010,Caffe Nero,Eating Out,2,497
23,3,2010,Caffe Nero,Eating Out,2,495
23,3,2010,Greggs,Eating Out,8,487
24,3,2010,O2,Bills,29,458
24,3,2010,Caffe Nero,Eating Out,2,456
25,3,2010,Caffe Nero,Eating Out,2,454
25,3,2010,ATM Cash Withdrawal,General,10,444
26,3,2010,Sainsburys,Groceries,77,367
26,3,2010,Pizza Express,Eating Out,57,310
26,3,2010,ATM Cash Withdrawal,General,20,290
27,3,2010,Dominos Pizza,Eating Out,26,264
28,3,2010,Restaurant Gordon RamsayPortland Restaurant,Eating Out,42,222
29,3,2010,South West Trains,Transport,28,194
29,3,2010,Starbucks Coffee,Eating Out,1,193
30,3,2010,Wild Bean Cafe,Eating Out,2,191
30,3,2010,Greggs,Eating Out,4,187
30,3,2010,ATM Cash Withdrawal,General,10,177
31,3,2010,Greggs,Eating Out,6,171
31,3,2010,ATM Cash Withdrawal,General,20,151
1,4,2010,Rhino Sports salary,General,1600,1751
1,4,2010,Caffe Nero,Eating Out,2,1749
1,4,2010,Chicken Cottage,Eating Out,4,1745
2,4,2010,Tescos,Groceries,79,1666
2,4,2010,Starbucks Coffee,Eating Out,2,1664
2,4,2010,Greggs,Eating Out,7,1657
2,4,2010,Restaurant Gordon RamsayPortland Restaurant,Eating Out,38,1619
2,4,2010,ATM Cash Withdrawal,General,20,1599
3,4,2010,Pizza Express,Eating Out,56,1543
4,4,2010,ATM Cash Withdrawal,General,20,1523
5,4,2010,South West Trains,Transport,35,1488
5,4,2010,Wild Bean Cafe,Eating Out,2,1486
6,4,2010,Tool Tec,,4,1482
7,4,2010,Cubit and West rent,Rent,440,1042
7,4,2010,Wild Bean Cafe,Eating Out,2,1040
7,4,2010,The West Cornwall Pasty Company,Eating Out,8,1032
8,4,2010,Subway,Eating Out,8,1024
9,4,2010,Tescos,Groceries,78,946
9,4,2010,Costa Coffee,Eating Out,1,945
9,4,2010,Chicken Cottage,Eating Out,7,938
9,4,2010,Scott's Restaurant,Eating Out,52,886
10,4,2010,Anglo restaurant,Eating Out,32,854
10,4,2010,ATM Cash Withdrawal,General,10,844
11,4,2010,Restaurant Gordon RamsayPortland Restaurant,Eating Out,48,796
11,4,2010,ATM Cash Withdrawal,General,10,786
12,4,2010,South West Trains,Transport,27,759
12,4,2010,Costa Coffee,Eating Out,2,757
12,4,2010,Subway,Eating Out,6,751
12,4,2010,ATM Cash Withdrawal,General,20,731
13,4,2010,Caffe Nero,Eating Out,2,729
13,4,2010,Pret A Manger,Eating Out,8,721
14,4,2010,Wild Bean Cafe,Eating Out,2,719
15,4,2010,BRGAS-Electricity,Bills,36,683
15,4,2010,BRGAS-Gas,Bills,31,652
15,4,2010,Chicken Cottage,Eating Out,8,644
15,4,2010,Tool Tec,,3,641
16,4,2010,LBS Council Tax,Bills,35,606
16,4,2010,Waitrose,Groceries,61,545
16,4,2010,Starbucks Coffee,Eating Out,2,543
17,4,2010,Anglo restaurant,Eating Out,27,516
19,4,2010,South West Trains,Transport,34,482
19,4,2010,Starbucks Coffee,Eating Out,2,480
19,4,2010,ATM Cash Withdrawal,General,20,460
20,4,2010,VIRGIN MEDIA PYMTS,Bills,42,418
21,4,2010,Wild Bean Cafe,Eating Out,2,416
21,4,2010,Subway,Eating Out,6,410
21,4,2010,Red Shop,,3,407
22,4,2010,Starbucks Coffee,Eating Out,2,405
22,4,2010,The West Cornwall Pasty Company,Eating Out,4,401
23,4,2010,Tescos,Groceries,49,352
23,4,2010,Caffe Nero,Eating Out,2,350
24,4,2010,O2,Bills,30,320
24,4,2010,Fabric Club,Eating Out,9,311
24,4,2010,Fabric Club,Eating Out,10,301
24,4,2010,Fabric Club,Eating Out,14,287
25,4,2010,ATM Cash Withdrawal,General,20,267
26,4,2010,South West Trains,Transport,24,243
26,4,2010,Wild Bean Cafe,Eating Out,1,242
26,4,2010,Chicken Cottage,Eating Out,7,235
27,4,2010,Subway,Eating Out,6,229
28,4,2010,Costa Coffee,Eating Out,1,228
28,4,2010,Subway,Eating Out,8,220
29,4,2010,Starbucks Coffee,Eating Out,2,218
29,4,2010,Greggs,Eating Out,8,210
29,4,2010,ATM Cash Withdrawal,General,10,200
30,4,2010,Morrisons,Groceries,40,160
30,4,2010,Costa Coffee,Eating Out,2,158
30,4,2010,Greggs,Eating Out,5,153
1,5,2010,Rhino Sports salary,General,1600,1753
1,5,2010,Scott's Restaurant,Eating Out,32,1721
1,5,2010,Tool Shop,,4,1717
3,5,2010,South West Trains,Transport,38,1679
3,5,2010,Costa Coffee,Eating Out,2,1677
3,5,2010,McDonalds,Eating Out,6,1671
3,5,2010,ATM Cash Withdrawal,General,10,1661
3,5,2010,Tool Tec,,4,1657
4,5,2010,Caffe Nero,Eating Out,1,1656
4,5,2010,Chicken Cottage,Eating Out,4,1652
5,5,2010,Caffe Nero,Eating Out,1,1651
5,5,2010,Subway,Eating Out,6,1645
6,5,2010,Wild Bean Cafe,Eating Out,2,1643
6,5,2010,ATM Cash Withdrawal,General,10,1633
7,5,2010,Cubit and West rent,Rent,440,1193
7,5,2010,Tescos,Groceries,57,1136
7,5,2010,Wild Bean Cafe,Eating Out,2,1134
7,5,2010,Chicken Cottage,Eating Out,4,1130
8,5,2010,Restaurant Gordon RamsayPortland Restaurant,Eating Out,41,1089
9,5,2010,ATM Cash Withdrawal,General,20,1069
10,5,2010,South West Trains,Transport,26,1043
10,5,2010,Chicken Cottage,Eating Out,8,1035
10,5,2010,ATM Cash Withdrawal,General,20,1015
11,5,2010,Wild Bean Cafe,Eating Out,2,1013
11,5,2010,Pret A Manger,Eating Out,8,1005
12,5,2010,Costa Coffee,Eating Out,2,1003
13,5,2010,Starbucks Coffee,Eating Out,2,1001
13,5,2010,Chicken Cottage,Eating Out,4,997
13,5,2010,Civic Shop,,5,992
14,5,2010,Morrisons,Groceries,81,911
14,5,2010,Wild Bean Cafe,Eating Out,2,909
14,5,2010,ATM Cash Withdrawal,General,20,889
14,5,2010,Civic Shop,,6,883
15,5,2010,BRGAS-Electricity,Bills,34,849
15,5,2010,BRGAS-Gas,Bills,31,818
15,5,2010,Pizza Express,Eating Out,43,775
15,5,2010,ATM Cash Withdrawal,General,20,755
16,5,2010,LBS Council Tax,Bills,35,720
17,5,2010,South West Trains,Transport,35,685
17,5,2010,Starbucks Coffee,Eating Out,2,683
17,5,2010,Subway,Eating Out,8,675
17,5,2010,ATM Cash Withdrawal,General,20,655
17,5,2010,Tool Shop,,9,646
18,5,2010,Wild Bean Cafe,Eating Out,2,644
18,5,2010,ATM Cash Withdrawal,General,20,624
19,5,2010,Caffe Nero,Eating Out,2,622
19,5,2010,Chicken Cottage,Eating Out,7,615
20,5,2010,VIRGIN MEDIA PYMTS,Bills,27,588
20,5,2010,Caffe Nero,Eating Out,2,586
20,5,2010,Greggs,Eating Out,5,581
21,5,2010,Waitrose,Groceries,50,531
21,5,2010,Wild Bean Cafe,Eating Out,2,529
21,5,2010,Pret A Manger,Eating Out,5,524
22,5,2010,ATM Cash Withdrawal,General,20,504
22,5,2010,Paying back Julie,,7,497
24,5,2010,O2,Bills,29,468
24,5,2010,South West Trains,Transport,24,444
24,5,2010,Starbucks Coffee,Eating Out,2,442
24,5,2010,Pret A Manger,Eating Out,7,435
25,5,2010,Caffe Nero,Eating Out,2,433
25,5,2010,McDonalds,Eating Out,8,425
25,5,2010,ATM Cash Withdrawal,General,20,405
26,5,2010,Caffe Nero,Eating Out,1,404
27,5,2010,Caffe Nero,Eating Out,2,402
27,5,2010,Subway,Eating Out,8,394
27,5,2010,ATM Cash Withdrawal,General,10,384
28,5,2010,Waitrose,Groceries,49,335
28,5,2010,McDonalds,Eating Out,4,331
28,5,2010,Dominos Pizza,Eating Out,36,295
28,5,2010,ATM Cash Withdrawal,General,10,285
31,5,2010,South West Trains,Transport,26,259
31,5,2010,Caffe Nero,Eating Out,2,257
31,5,2010,Greggs,Eating Out,6,251
31,5,2010,ATM Cash Withdrawal,General,10,241
31,5,2010,Paying back Julie,,1,240
1,6,2010,Rhino Sports salary,General,1600,1840
1,6,2010,Caffe Nero,Eating Out,2,1838
1,6,2010,Chicken Cottage,Eating Out,8,1830
2,6,2010,Wild Bean Cafe,Eating Out,2,1828
2,6,2010,Cheam Service Station,,3,1825
3,6,2010,Wild Bean Cafe,Eating Out,2,1823
3,6,2010,Chicken Cottage,Eating Out,7,1816
3,6,2010,Tool Shop,,2,1814
4,6,2010,Waitrose,Groceries,46,1768
4,6,2010,Wild Bean Cafe,Eating Out,1,1767
4,6,2010,The West Cornwall Pasty Company,Eating Out,7,1760
4,6,2010,Anglo restaurant,Eating Out,55,1705
4,6,2010,ATM Cash Withdrawal,General,10,1695
4,6,2010,British Airways,General,173,1522
5,6,2010,ATM Cash Withdrawal,General,20,1502
7,6,2010,Cubit and West rent,Rent,440,1062
7,6,2010,South West Trains,Transport,26,1036
7,6,2010,Subway,Eating Out,5,1031
8,6,2010,Wild Bean Cafe,Eating Out,2,1029
8,6,2010,Chicken Cottage,Eating Out,4,1025
8,6,2010,Tool Shop,,2,1023
9,6,2010,The West Cornwall Pasty Company,Eating Out,4,1019
10,6,2010,Greggs,Eating Out,6,1013
11,6,2010,Sainsburys,Groceries,45,968
11,6,2010,Starbucks Coffee,Eating Out,2,966
11,6,2010,Scott's Restaurant,Eating Out,42,924
11,6,2010,ATM Cash Withdrawal,General,10,914
12,6,2010,Pizza Express,Eating Out,32,882
14,6,2010,South West Trains,Transport,36,846
14,6,2010,Pret A Manger,Eating Out,6,840
14,6,2010,Tool Tec,,4,836
15,6,2010,BRGAS-Electricity,Bills,32,804
15,6,2010,BRGAS-Gas,Bills,35,769
15,6,2010,Chicken Cottage,Eating Out,6,763
15,6,2010,ATM Cash Withdrawal,General,10,753
15,6,2010,Cheam Service Station,,7,746
16,6,2010,LBS Council Tax,Bills,35,711
16,6,2010,Costa Coffee,Eating Out,2,709
16,6,2010,Chicken Cottage,Eating Out,4,705
16,6,2010,Civic Shop,,3,702
17,6,2010,Caffe Nero,Eating Out,2,700
17,6,2010,Greggs,Eating Out,4,696
17,6,2010,ATM Cash Withdrawal,General,10,686
18,6,2010,Sainsburys,Groceries,56,630
18,6,2010,Wild Bean Cafe,Eating Out,2,628
18,6,2010,Scott's Restaurant,Eating Out,30,598
19,6,2010,Scott's Restaurant,Eating Out,35,563
20,6,2010,VIRGIN MEDIA PYMTS,Bills,25,538
20,6,2010,Scott's Restaurant,Eating Out,51,487
20,6,2010,ATM Cash Withdrawal,General,10,477
21,6,2010,South West Trains,Transport,31,446
21,6,2010,Greggs,Eating Out,7,439
22,6,2010,Caffe Nero,Eating Out,2,437
22,6,2010,Paying back Julie,,6,431
23,6,2010,Starbucks Coffee,Eating Out,2,429
23,6,2010,Pret A Manger,Eating Out,4,425
24,6,2010,O2,Bills,29,396
24,6,2010,Starbucks Coffee,Eating Out,2,394
24,6,2010,ATM Cash Withdrawal,General,20,374
25,6,2010,Waitrose,Groceries,56,318
25,6,2010,Chicken Cottage,Eating Out,8,310
26,6,2010,ATM Cash Withdrawal,General,10,300
28,6,2010,South West Trains,Transport,25,275
28,6,2010,Costa Coffee,Eating Out,1,274
28,6,2010,Pret A Manger,Eating Out,7,267
29,6,2010,Caffe Nero,Eating Out,2,265
29,6,2010,ATM Cash Withdrawal,General,10,255
30,6,2010,Pret A Manger,Eating Out,4,251
30,6,2010,ATM Cash Withdrawal,General,10,241
1,7,2010,Rhino Sports salary,General,1600,1841
1,7,2010,Starbucks Coffee,Eating Out,2,1839
1,7,2010,Greggs,Eating Out,8,1831
2,7,2010,Waitrose,Groceries,78,1753
3,7,2010,The Grand Pub,Eating Out,6,1747
3,7,2010,The Grand Pub,Eating Out,14,1733
3,7,2010,The Grand Pub,Eating Out,13,1720
3,7,2010,The Grand Pub,Eating Out,11,1709
3,7,2010,The Grand Pub,Eating Out,6,1703
3,7,2010,The Grand Pub,Eating Out,9,1694
3,7,2010,Pizza Express,Eating Out,47,1647
4,7,2010,Paying back James,,7,1640
5,7,2010,South West Trains,Transport,33,1607
5,7,2010,Caffe Nero,Eating Out,2,1605
5,7,2010,Subway,Eating Out,7,1598
6,7,2010,Wild Bean Cafe,Eating Out,2,1596
6,7,2010,Pret A Manger,Eating Out,6,1590
7,7,2010,Cubit and West rent,Rent,440,1150
7,7,2010,Costa Coffee,Eating Out,2,1148
7,7,2010,Pret A Manger,Eating Out,6,1142
8,7,2010,Subway,Eating Out,7,1135
9,7,2010,Tescos,Groceries,39,1096
9,7,2010,Starbucks Coffee,Eating Out,2,1094
9,7,2010,Anglo restaurant,Eating Out,36,1058
9,7,2010,ATM Cash Withdrawal,General,10,1048
10,7,2010,Tool Tec,,9,1039
11,7,2010,Pizza Express,Eating Out,42,997
11,7,2010,ATM Cash Withdrawal,General,20,977
12,7,2010,South West Trains,Transport,38,939
12,7,2010,Wild Bean Cafe,Eating Out,2,937
12,7,2010,McDonalds,Eating Out,8,929
13,7,2010,Costa Coffee,Eating Out,1,928
13,7,2010,McDonalds,Eating Out,5,923
14,7,2010,Wild Bean Cafe,Eating Out,1,922
14,7,2010,Pret A Manger,Eating Out,5,917
15,7,2010,BRGAS-Electricity,Bills,31,886
15,7,2010,BRGAS-Gas,Bills,23,863
15,7,2010,Starbucks Coffee,Eating Out,2,861
15,7,2010,The West Cornwall Pasty Company,Eating Out,6,855
16,7,2010,LBS Council Tax,Bills,35,820
16,7,2010,Tescos,Groceries,49,771
16,7,2010,Wild Bean Cafe,Eating Out,2,769
16,7,2010,The West Cornwall Pasty Company,Eating Out,8,761
17,7,2010,Ministry of Sound ClubXOYO Club,Eating Out,12,749
17,7,2010,Ministry of Sound ClubXOYO Club,Eating Out,12,737
17,7,2010,Ministry of Sound ClubXOYO Club,Eating Out,10,727
17,7,2010,Ministry of Sound ClubXOYO Club,Eating Out,5,722
17,7,2010,Ministry of Sound ClubXOYO Club,Eating Out,13,709
17,7,2010,Ministry of Sound ClubXOYO Club,Eating Out,15,694
17,7,2010,Dominos Pizza,Eating Out,42,652
17,7,2010,ATM Cash Withdrawal,General,20,632
19,7,2010,South West Trains,Transport,25,607
19,7,2010,Costa Coffee,Eating Out,2,605
19,7,2010,Greggs,Eating Out,8,597
19,7,2010,Paying back James,,2,595
20,7,2010,VIRGIN MEDIA PYMTS,Bills,32,563
20,7,2010,Starbucks Coffee,Eating Out,2,561
20,7,2010,Greggs,Eating Out,8,553
20,7,2010,ATM Cash Withdrawal,General,10,543
20,7,2010,Civic Shop,,5,538
21,7,2010,Costa Coffee,Eating Out,2,536
21,7,2010,Pret A Manger,Eating Out,5,531
21,7,2010,Paying back James,,9,522
22,7,2010,Costa Coffee,Eating Out,2,520
22,7,2010,McDonalds,Eating Out,7,513
23,7,2010,Waitrose,Groceries,65,448
23,7,2010,Starbucks Coffee,Eating Out,2,446
23,7,2010,Dominos Pizza,Eating Out,56,390
23,7,2010,ATM Cash Withdrawal,General,10,380
24,7,2010,O2,Bills,28,352
24,7,2010,Anglo restaurant,Eating Out,49,303
25,7,2010,Dominos Pizza,Eating Out,45,258
25,7,2010,Tool Tec,,4,254
26,7,2010,South West Trains,Transport,36,218
26,7,2010,Wild Bean Cafe,Eating Out,1,217
26,7,2010,Chicken Cottage,Eating Out,8,209
27,7,2010,Costa Coffee,Eating Out,1,208
27,7,2010,Pret A Manger,Eating Out,5,203
28,7,2010,Wild Bean Cafe,Eating Out,2,201
28,7,2010,ATM Cash Withdrawal,General,20,181
29,7,2010,Costa Coffee,Eating Out,1,180
29,7,2010,Subway,Eating Out,6,174
29,7,2010,Paying back Julie,,2,172
30,7,2010,Tescos,Groceries,73,99
30,7,2010,Wild Bean Cafe,Eating Out,2,97
30,7,2010,Greggs,Eating Out,6,91
30,7,2010,Anglo restaurant,Eating Out,53,38
31,7,2010,Pizza Express,Eating Out,42,-4
1,8,2010,Rhino Sports salary,General,1600,1596
2,8,2010,South West Trains,Transport,29,1567
2,8,2010,Caffe Nero,Eating Out,1,1566
2,8,2010,Greggs,Eating Out,8,1558
2,8,2010,ATM Cash Withdrawal,General,10,1548
3,8,2010,Wild Bean Cafe,Eating Out,2,1546
3,8,2010,Pret A Manger,Eating Out,4,1542
4,8,2010,Starbucks Coffee,Eating Out,2,1540
4,8,2010,ATM Cash Withdrawal,General,20,1520
4,8,2010,Cheam Service Station,,5,1515
5,8,2010,Starbucks Coffee,Eating Out,2,1513
5,8,2010,Greggs,Eating Out,6,1507
5,8,2010,ATM Cash Withdrawal,General,20,1487
6,8,2010,ASDA,Groceries,50,1437
6,8,2010,Wild Bean Cafe,Eating Out,1,1436
6,8,2010,McDonalds,Eating Out,6,1430
6,8,2010,Dominos Pizza,Eating Out,59,1371
6,8,2010,ATM Cash Withdrawal,General,20,1351
7,8,2010,Cubit and West rent,Rent,440,911
7,8,2010,Dominos Pizza,Eating Out,32,879
7,8,2010,ATM Cash Withdrawal,General,20,859
8,8,2010,ATM Cash Withdrawal,General,10,849
9,8,2010,South West Trains,Transport,28,821
9,8,2010,Pret A Manger,Eating Out,6,815
9,8,2010,ATM Cash Withdrawal,General,10,805
10,8,2010,ATM Cash Withdrawal,General,20,785
10,8,2010,Red Shop,,4,781
11,8,2010,Starbucks Coffee,Eating Out,2,779
11,8,2010,Chicken Cottage,Eating Out,8,771
12,8,2010,Starbucks Coffee,Eating Out,1,770
12,8,2010,Subway,Eating Out,4,766
12,8,2010,Paying back James,,7,759
13,8,2010,Tescos,Groceries,57,702
13,8,2010,ATM Cash Withdrawal,General,20,682
14,8,2010,ATM Cash Withdrawal,General,10,672
15,8,2010,BRGAS-Electricity,Bills,26,646
15,8,2010,BRGAS-Gas,Bills,28,618
15,8,2010,Restaurant Gordon RamsayPortland Restaurant,Eating Out,27,591
16,8,2010,LBS Council Tax,Bills,35,556
16,8,2010,South West Trains,Transport,38,518
16,8,2010,Caffe Nero,Eating Out,1,517
16,8,2010,Chicken Cottage,Eating Out,4,513
17,8,2010,Chicken Cottage,Eating Out,4,509
18,8,2010,Chicken Cottage,Eating Out,5,504
19,8,2010,Wild Bean Cafe,Eating Out,1,503
19,8,2010,Greggs,Eating Out,6,497
19,8,2010,ATM Cash Withdrawal,General,20,477
20,8,2010,VIRGIN MEDIA PYMTS,Bills,37,440
20,8,2010,Sainsburys,Groceries,74,366
20,8,2010,Pret A Manger,Eating Out,5,361
20,8,2010,Fabric Club,Eating Out,14,347
20,8,2010,Fabric Club,Eating Out,8,339
20,8,2010,Fabric Club,Eating Out,6,333
20,8,2010,Fabric Club,Eating Out,5,328
20,8,2010,Fabric Club,Eating Out,9,319
20,8,2010,Fabric Club,Eating Out,16,303
21,8,2010,ATM Cash Withdrawal,General,20,283
23,8,2010,South West Trains,Transport,28,255
23,8,2010,Starbucks Coffee,Eating Out,2,253
23,8,2010,ATM Cash Withdrawal,General,10,243
24,8,2010,O2,Bills,26,217
24,8,2010,Costa Coffee,Eating Out,2,215
24,8,2010,McDonalds,Eating Out,6,209
25,8,2010,Costa Coffee,Eating Out,2,207
25,8,2010,Chicken Cottage,Eating Out,6,201
26,8,2010,Starbucks Coffee,Eating Out,2,199
26,8,2010,Greggs,Eating Out,4,195
26,8,2010,ATM Cash Withdrawal,General,20,175
27,8,2010,ASDA,Groceries,78,97
27,8,2010,Starbucks Coffee,Eating Out,1,96
27,8,2010,Restaurant Gordon RamsayPortland Restaurant,Eating Out,46,50
28,8,2010,Restaurant Gordon RamsayPortland Restaurant,Eating Out,30,20
28,8,2010,Tool Shop,,3,17
30,8,2010,South West Trains,Transport,36,-19
30,8,2010,Starbucks Coffee,Eating Out,2,-21
30,8,2010,McDonalds,Eating Out,7,-28
31,8,2010,Starbucks Coffee,Eating Out,1,-29
1,9,2010,Rhino Sports salary,General,1600,1571
1,9,2010,Caffe Nero,Eating Out,2,1569
1,9,2010,Greggs,Eating Out,8,1561
2,9,2010,Subway,Eating Out,8,1553
3,9,2010,Tescos,Groceries,49,1504
3,9,2010,Costa Coffee,Eating Out,1,1503
3,9,2010,Cheam Service Station,,9,1494
6,9,2010,South West Trains,Transport,33,1461
6,9,2010,The West Cornwall Pasty Company,Eating Out,8,1453
7,9,2010,Cubit and West rent,Rent,440,1013
7,9,2010,Wild Bean Cafe,Eating Out,2,1011
9,9,2010,Starbucks Coffee,Eating Out,1,1010
9,9,2010,McDonalds,Eating Out,8,1002
10,9,2010,Sainsburys,Groceries,60,942
10,9,2010,Greggs,Eating Out,8,934
10,9,2010,Paying back Julie,,8,926
12,9,2010,Scott's Restaurant,Eating Out,57,869
13,9,2010,South West Trains,Transport,30,839
13,9,2010,Caffe Nero,Eating Out,2,837
13,9,2010,McDonalds,Eating Out,4,833
13,9,2010,ATM Cash Withdrawal,General,10,823
13,9,2010,Tool Tec,,5,818
14,9,2010,Starbucks Coffee,Eating Out,1,817
14,9,2010,Subway,Eating Out,8,809
15,9,2010,BRGAS-Electricity,Bills,33,776
15,9,2010,BRGAS-Gas,Bills,33,743
15,9,2010,Caffe Nero,Eating Out,1,742
15,9,2010,McDonalds,Eating Out,8,734
16,9,2010,LBS Council Tax,Bills,35,699
16,9,2010,Starbucks Coffee,Eating Out,2,697
16,9,2010,McDonalds,Eating Out,6,691
17,9,2010,Morrisons,Groceries,55,636
17,9,2010,Subway,Eating Out,8,628
17,9,2010,Pizza Express,Eating Out,49,579
17,9,2010,ATM Cash Withdrawal,General,20,559
18,9,2010,Scott's Restaurant,Eating Out,34,525
18,9,2010,ATM Cash Withdrawal,General,10,515
19,9,2010,Dominos Pizza,Eating Out,34,481
19,9,2010,ATM Cash Withdrawal,General,10,471
20,9,2010,VIRGIN MEDIA PYMTS,Bills,31,440
20,9,2010,South West Trains,Transport,29,411
20,9,2010,Wild Bean Cafe,Eating Out,2,409
20,9,2010,The West Cornwall Pasty Company,Eating Out,6,403
20,9,2010,ATM Cash Withdrawal,General,10,393
21,9,2010,Wild Bean Cafe,Eating Out,2,391
21,9,2010,Pret A Manger,Eating Out,8,383
21,9,2010,ATM Cash Withdrawal,General,10,373
22,9,2010,Costa Coffee,Eating Out,2,371
22,9,2010,The West Cornwall Pasty Company,Eating Out,6,365
22,9,2010,ATM Cash Withdrawal,General,10,355
23,9,2010,Caffe Nero,Eating Out,1,354
23,9,2010,Subway,Eating Out,8,346
24,9,2010,O2,Bills,30,316
24,9,2010,Waitrose,Groceries,76,240
24,9,2010,Costa Coffee,Eating Out,2,238
24,9,2010,McDonalds,Eating Out,4,234
24,9,2010,Restaurant Gordon RamsayPortland Restaurant,Eating Out,59,175
26,9,2010,ATM Cash Withdrawal,General,20,155
27,9,2010,South West Trains,Transport,32,123
27,9,2010,Starbucks Coffee,Eating Out,2,121
27,9,2010,Chicken Cottage,Eating Out,8,113
28,9,2010,Costa Coffee,Eating Out,2,111
28,9,2010,ATM Cash Withdrawal,General,20,91
29,9,2010,Caffe Nero,Eating Out,1,90
29,9,2010,The West Cornwall Pasty Company,Eating Out,8,82
30,9,2010,Costa Coffee,Eating Out,2,80
30,9,2010,Chicken Cottage,Eating Out,5,75
30,9,2010,ATM Cash Withdrawal,General,20,55
30,9,2010,Paying back James,,5,50
1,10,2010,Rhino Sports salary,General,1600,1650
1,10,2010,Tescos,Groceries,39,1611
1,10,2010,McDonalds,Eating Out,6,1605
1,10,2010,ATM Cash Withdrawal,General,10,1595
2,10,2010,Ministry of Sound ClubXOYO Club,Eating Out,13,1582
2,10,2010,Ministry of Sound ClubXOYO Club,Eating Out,15,1567
2,10,2010,Ministry of Sound ClubXOYO Club,Eating Out,13,1554
2,10,2010,Ministry of Sound ClubXOYO Club,Eating Out,15,1539
2,10,2010,Ministry of Sound ClubXOYO Club,Eating Out,11,1528
2,10,2010,Ministry of Sound ClubXOYO Club,Eating Out,8,1520
2,10,2010,Restaurant Gordon RamsayPortland Restaurant,Eating Out,41,1479
3,10,2010,Pizza Express,Eating Out,32,1447
3,10,2010,ATM Cash Withdrawal,General,10,1437
4,10,2010,South West Trains,Transport,29,1408
4,10,2010,Pret A Manger,Eating Out,8,1400
5,10,2010,Costa Coffee,Eating Out,2,1398
5,10,2010,The West Cornwall Pasty Company,Eating Out,5,1393
6,10,2010,Costa Coffee,Eating Out,2,1391
6,10,2010,ATM Cash Withdrawal,General,20,1371
7,10,2010,Cubit and West rent,Rent,440,931
7,10,2010,ATM Cash Withdrawal,General,10,921
8,10,2010,Waitrose,Groceries,48,873
8,10,2010,Caffe Nero,Eating Out,2,871
8,10,2010,The West Cornwall Pasty Company,Eating Out,8,863
8,10,2010,Anglo restaurant,Eating Out,54,809
9,10,2010,The Grand Pub,Eating Out,9,800
9,10,2010,The Grand Pub,Eating Out,13,787
9,10,2010,The Grand Pub,Eating Out,15,772
9,10,2010,The Grand Pub,Eating Out,6,766
9,10,2010,The Grand Pub,Eating Out,16,750
11,10,2010,South West Trains,Transport,24,726
11,10,2010,Wild Bean Cafe,Eating Out,2,724
11,10,2010,Subway,Eating Out,8,716
11,10,2010,ATM Cash Withdrawal,General,10,706
12,10,2010,Costa Coffee,Eating Out,1,705
13,10,2010,Chicken Cottage,Eating Out,5,700
14,10,2010,Starbucks Coffee,Eating Out,2,698
14,10,2010,Greggs,Eating Out,5,693
15,10,2010,BRGAS-Electricity,Bills,33,660
15,10,2010,BRGAS-Gas,Bills,18,642
15,10,2010,ASDA,Groceries,43,599
15,10,2010,Wild Bean Cafe,Eating Out,2,597
15,10,2010,Chicken Cottage,Eating Out,4,593
15,10,2010,Ministry of Sound ClubXOYO Club,Eating Out,5,588
16,10,2010,LBS Council Tax,Bills,35,553
17,10,2010,Anglo restaurant,Eating Out,56,497
18,10,2010,South West Trains,Transport,31,466
18,10,2010,Costa Coffee,Eating Out,2,464
18,10,2010,Chicken Cottage,Eating Out,4,460
19,10,2010,Starbucks Coffee,Eating Out,1,459
19,10,2010,Subway,Eating Out,6,453
20,10,2010,VIRGIN MEDIA PYMTS,Bills,21,432
20,10,2010,Wild Bean Cafe,Eating Out,1,431
21,10,2010,Wild Bean Cafe,Eating Out,2,429
21,10,2010,ATM Cash Withdrawal,General,10,419
22,10,2010,Sainsburys,Groceries,71,348
22,10,2010,Costa Coffee,Eating Out,2,346
22,10,2010,Chicken Cottage,Eating Out,4,342
22,10,2010,The Grand Pub,Eating Out,12,330
22,10,2010,The Grand Pub,Eating Out,5,325
24,10,2010,O2,Bills,25,300
25,10,2010,South West Trains,Transport,24,276
25,10,2010,Starbucks Coffee,Eating Out,1,275
25,10,2010,Chicken Cottage,Eating Out,5,270
26,10,2010,Caffe Nero,Eating Out,2,268
26,10,2010,McDonalds,Eating Out,8,260
27,10,2010,McDonalds,Eating Out,6,254
27,10,2010,ATM Cash Withdrawal,General,10,244
27,10,2010,Cheam Service Station,,9,235
28,10,2010,Costa Coffee,Eating Out,2,233
28,10,2010,McDonalds,Eating Out,7,226
28,10,2010,ATM Cash Withdrawal,General,20,206
29,10,2010,Waitrose,Groceries,38,168
29,10,2010,Wild Bean Cafe,Eating Out,1,167
31,10,2010,Scott's Restaurant,Eating Out,45,122
1,11,2010,Rhino Sports salary,General,1600,1722
1,11,2010,South West Trains,Transport,34,1688
1,11,2010,Costa Coffee,Eating Out,1,1687
2,11,2010,Chicken Cottage,Eating Out,6,1681
2,11,2010,ATM Cash Withdrawal,General,10,1671
3,11,2010,Caffe Nero,Eating Out,2,1669
4,11,2010,Tool Shop,,2,1667
5,11,2010,Tescos,Groceries,71,1596
5,11,2010,Caffe Nero,Eating Out,2,1594
5,11,2010,The West Cornwall Pasty Company,Eating Out,6,1588
5,11,2010,ATM Cash Withdrawal,General,20,1568
6,11,2010,Restaurant Gordon RamsayPortland Restaurant,Eating Out,33,1535
7,11,2010,Cubit and West rent,Rent,440,1095
8,11,2010,South West Trains,Transport,30,1065
8,11,2010,Caffe Nero,Eating Out,2,1063
8,11,2010,Pret A Manger,Eating Out,4,1059
9,11,2010,Caffe Nero,Eating Out,2,1057
9,11,2010,The West Cornwall Pasty Company,Eating Out,4,1053
9,11,2010,Red Shop,,5,1048
10,11,2010,Wild Bean Cafe,Eating Out,2,1046
10,11,2010,Pret A Manger,Eating Out,8,1038
11,11,2010,Pret A Manger,Eating Out,5,1033
11,11,2010,Paying back Julie,,4,1029
12,11,2010,ASDA,Groceries,63,966
12,11,2010,Wild Bean Cafe,Eating Out,1,965
12,11,2010,McDonalds,Eating Out,4,961
12,11,2010,Scott's Restaurant,Eating Out,31,930
12,11,2010,ATM Cash Withdrawal,General,10,920
13,11,2010,Civic Shop,,5,915
14,11,2010,Scott's Restaurant,Eating Out,35,880
15,11,2010,BRGAS-Electricity,Bills,81,799
15,11,2010,BRGAS-Gas,Bills,56,743
15,11,2010,South West Trains,Transport,29,714
15,11,2010,Costa Coffee,Eating Out,1,713
16,11,2010,LBS Council Tax,Bills,35,678
16,11,2010,Greggs,Eating Out,7,671
17,11,2010,Costa Coffee,Eating Out,2,669
17,11,2010,Chicken Cottage,Eating Out,8,661
17,11,2010,ATM Cash Withdrawal,General,20,641
18,11,2010,Caffe Nero,Eating Out,2,639
18,11,2010,Greggs,Eating Out,5,634
19,11,2010,Waitrose,Groceries,52,582
19,11,2010,Wild Bean Cafe,Eating Out,2,580
19,11,2010,The West Cornwall Pasty Company,Eating Out,8,572
19,11,2010,Dominos Pizza,Eating Out,48,524
20,11,2010,VIRGIN MEDIA PYMTS,Bills,27,497
20,11,2010,ATM Cash Withdrawal,General,10,487
22,11,2010,South West Trains,Transport,37,450
22,11,2010,Starbucks Coffee,Eating Out,2,448
22,11,2010,Pret A Manger,Eating Out,8,440
23,11,2010,Starbucks Coffee,Eating Out,1,439
24,11,2010,O2,Bills,27,412
24,11,2010,Caffe Nero,Eating Out,1,411
24,11,2010,Subway,Eating Out,5,406
24,11,2010,ATM Cash Withdrawal,General,10,396
25,11,2010,Caffe Nero,Eating Out,2,394
25,11,2010,Subway,Eating Out,8,386
26,11,2010,Morrisons,Groceries,61,325
26,11,2010,Costa Coffee,Eating Out,2,323
26,11,2010,Chicken Cottage,Eating Out,8,315
27,11,2010,Restaurant Gordon RamsayPortland Restaurant,Eating Out,31,284
27,11,2010,ATM Cash Withdrawal,General,20,264
29,11,2010,South West Trains,Transport,34,230
29,11,2010,Costa Coffee,Eating Out,2,228
29,11,2010,ATM Cash Withdrawal,General,20,208
30,11,2010,Costa Coffee,Eating Out,1,207
30,11,2010,McDonalds,Eating Out,8,199
1,12,2010,Rhino Sports salary,General,1600,1799
1,12,2010,The West Cornwall Pasty Company,Eating Out,4,1795
2,12,2010,Wild Bean Cafe,Eating Out,1,1794
2,12,2010,Chicken Cottage,Eating Out,5,1789
3,12,2010,Sainsburys,Groceries,63,1726
3,12,2010,Starbucks Coffee,Eating Out,2,1724
3,12,2010,Pret A Manger,Eating Out,6,1718
4,12,2010,Pizza Express,Eating Out,25,1693
4,12,2010,ATM Cash Withdrawal,General,10,1683
5,12,2010,Restaurant Gordon RamsayPortland Restaurant,Eating Out,34,1649
5,12,2010,ATM Cash Withdrawal,General,10,1639
6,12,2010,South West Trains,Transport,38,1601
6,12,2010,Costa Coffee,Eating Out,1,1600
7,12,2010,Cubit and West rent,Rent,440,1160
7,12,2010,Starbucks Coffee,Eating Out,2,1158
7,12,2010,Pret A Manger,Eating Out,4,1154
9,12,2010,Wild Bean Cafe,Eating Out,1,1153
9,12,2010,Greggs,Eating Out,7,1146
10,12,2010,Sainsburys,Groceries,48,1098
10,12,2010,Costa Coffee,Eating Out,1,1097
10,12,2010,Pret A Manger,Eating Out,7,1090
10,12,2010,The Grand Pub,Eating Out,10,1080
10,12,2010,The Grand Pub,Eating Out,9,1071
10,12,2010,The Grand Pub,Eating Out,14,1057
10,12,2010,Scott's Restaurant,Eating Out,37,1020
10,12,2010,ATM Cash Withdrawal,General,10,1010
13,12,2010,South West Trains,Transport,27,983
13,12,2010,Pret A Manger,Eating Out,7,976
14,12,2010,Wild Bean Cafe,Eating Out,1,975
14,12,2010,The West Cornwall Pasty Company,Eating Out,4,971
15,12,2010,BRGAS-Electricity,Bills,20,951
15,12,2010,BRGAS-Gas,Bills,24,927
15,12,2010,Costa Coffee,Eating Out,2,925
15,12,2010,McDonalds,Eating Out,5,920
15,12,2010,ATM Cash Withdrawal,General,20,900
15,12,2010,Cheam Service Station,,3,897
16,12,2010,LBS Council Tax,Bills,35,862
16,12,2010,Wild Bean Cafe,Eating Out,2,860
16,12,2010,McDonalds,Eating Out,4,856
17,12,2010,Morrisons,Groceries,65,791
17,12,2010,Costa Coffee,Eating Out,2,789
17,12,2010,Pizza Express,Eating Out,47,742
17,12,2010,ATM Cash Withdrawal,General,20,722
18,12,2010,Restaurant Gordon RamsayPortland Restaurant,Eating Out,46,676
19,12,2010,ATM Cash Withdrawal,General,10,666
20,12,2010,VIRGIN MEDIA PYMTS,Bills,25,641
20,12,2010,South West Trains,Transport,33,608
20,12,2010,Wild Bean Cafe,Eating Out,2,606
20,12,2010,Greggs,Eating Out,4,602
20,12,2010,Tool Tec,,3,599
21,12,2010,Costa Coffee,Eating Out,2,597
21,12,2010,The West Cornwall Pasty Company,Eating Out,7,590
21,12,2010,ATM Cash Withdrawal,General,10,580
22,12,2010,Caffe Nero,Eating Out,1,579
22,12,2010,Chicken Cottage,Eating Out,5,574
24,12,2010,O2,Bills,29,545
24,12,2010,Morrisons,Groceries,79,466
24,12,2010,Wild Bean Cafe,Eating Out,1,465
24,12,2010,McDonalds,Eating Out,5,460
25,12,2010,Tool Tec,,3,457
26,12,2010,Restaurant Gordon RamsayPortland Restaurant,Eating Out,37,420
26,12,2010,Cheam Service Station,,8,412
27,12,2010,South West Trains,Transport,25,387
27,12,2010,Costa Coffee,Eating Out,2,385
28,12,2010,Starbucks Coffee,Eating Out,1,384
28,12,2010,Subway,Eating Out,7,377
29,12,2010,Wild Bean Cafe,Eating Out,2,375
29,12,2010,Subway,Eating Out,5,370
29,12,2010,ATM Cash Withdrawal,General,10,360
30,12,2010,McDonalds,Eating Out,6,354
31,12,2010,Sainsburys,Groceries,78,276
31,12,2010,Caffe Nero,Eating Out,1,275
31,12,2010,McDonalds,Eating Out,8,267
31,12,2010,Anglo restaurant,Eating Out,45,222
1,1,2011,Rhino Sports salary,General,1600,1822
3,1,2011,South West Trains,Transport,25,1797
3,1,2011,The West Cornwall Pasty Company,Eating Out,7,1790
4,1,2011,McDonalds,Eating Out,7,1783
5,1,2011,ATM Cash Withdrawal,General,20,1763
6,1,2011,Caffe Nero,Eating Out,2,1761
6,1,2011,Subway,Eating Out,7,1754
7,1,2011,Cubit and West rent,Rent,440,1314
7,1,2011,Morrisons,Groceries,68,1246
7,1,2011,Caffe Nero,Eating Out,2,1244
9,1,2011,Anglo restaurant,Eating Out,46,1198
10,1,2011,South West Trains,Transport,31,1167
10,1,2011,Starbucks Coffee,Eating Out,1,1166
10,1,2011,Pret A Manger,Eating Out,6,1160
10,1,2011,Tool Tec,,3,1157
11,1,2011,Wild Bean Cafe,Eating Out,2,1155
11,1,2011,Greggs,Eating Out,8,1147
11,1,2011,ATM Cash Withdrawal,General,20,1127
11,1,2011,Paying back James,,1,1126
12,1,2011,Starbucks Coffee,Eating Out,2,1124
12,1,2011,The West Cornwall Pasty Company,Eating Out,8,1116
12,1,2011,Cheam Service Station,,9,1107
13,1,2011,Subway,Eating Out,5,1102
14,1,2011,ASDA,Groceries,47,1055
14,1,2011,Greggs,Eating Out,5,1050
14,1,2011,Anglo restaurant,Eating Out,56,994
15,1,2011,BRGAS-Electricity,Bills,55,939
15,1,2011,BRGAS-Gas,Bills,51,888
16,1,2011,LBS Council Tax,Bills,35,853
17,1,2011,South West Trains,Transport,26,827
17,1,2011,Caffe Nero,Eating Out,2,825
17,1,2011,McDonalds,Eating Out,7,818
18,1,2011,Costa Coffee,Eating Out,1,817
19,1,2011,Caffe Nero,Eating Out,2,815
19,1,2011,Chicken Cottage,Eating Out,8,807
20,1,2011,VIRGIN MEDIA PYMTS,Bills,42,765
20,1,2011,Wild Bean Cafe,Eating Out,2,763
20,1,2011,The West Cornwall Pasty Company,Eating Out,7,756
21,1,2011,Waitrose,Groceries,71,685
21,1,2011,Starbucks Coffee,Eating Out,2,683
21,1,2011,The West Cornwall Pasty Company,Eating Out,8,675
21,1,2011,The Grand Pub,Eating Out,15,660
21,1,2011,The Grand Pub,Eating Out,8,652
21,1,2011,The Grand Pub,Eating Out,16,636
21,1,2011,The Grand Pub,Eating Out,9,627
21,1,2011,The Grand Pub,Eating Out,15,612
21,1,2011,The Grand Pub,Eating Out,10,602
21,1,2011,ATM Cash Withdrawal,General,10,592
22,1,2011,ATM Cash Withdrawal,General,10,582
24,1,2011,O2,Bills,25,557
24,1,2011,South West Trains,Transport,34,523
24,1,2011,Wild Bean Cafe,Eating Out,1,522
24,1,2011,Chicken Cottage,Eating Out,8,514
24,1,2011,ATM Cash Withdrawal,General,10,504
24,1,2011,Civic Shop,,9,495
25,1,2011,Wild Bean Cafe,Eating Out,2,493
25,1,2011,ATM Cash Withdrawal,General,20,473
25,1,2011,Red Shop,,4,469
26,1,2011,Caffe Nero,Eating Out,2,467
26,1,2011,Greggs,Eating Out,5,462
26,1,2011,Tool Tec,,3,459
27,1,2011,ATM Cash Withdrawal,General,20,439
28,1,2011,Waitrose,Groceries,51,388
28,1,2011,Caffe Nero,Eating Out,1,387
28,1,2011,ATM Cash Withdrawal,General,10,377
29,1,2011,Dominos Pizza,Eating Out,34,343
29,1,2011,ATM Cash Withdrawal,General,10,333
31,1,2011,South West Trains,Transport,31,302
1,2,2011,Rhino Sports salary,General,1600,1902
1,2,2011,Wild Bean Cafe,Eating Out,1,1901
1,2,2011,Subway,Eating Out,6,1895
2,2,2011,Starbucks Coffee,Eating Out,2,1893
2,2,2011,McDonalds,Eating Out,7,1886
2,2,2011,ATM Cash Withdrawal,General,10,1876
3,2,2011,Caffe Nero,Eating Out,1,1875
3,2,2011,Subway,Eating Out,5,1870
4,2,2011,ASDA,Groceries,48,1822
4,2,2011,Caffe Nero,Eating Out,1,1821
4,2,2011,Anglo restaurant,Eating Out,38,1783
5,2,2011,ATM Cash Withdrawal,General,20,1763
6,2,2011,Pizza Express,Eating Out,28,1735
7,2,2011,Cubit and West rent,Rent,440,1295
7,2,2011,South West Trains,Transport,36,1259
7,2,2011,Subway,Eating Out,7,1252
8,2,2011,Costa Coffee,Eating Out,2,1250
8,2,2011,Pret A Manger,Eating Out,7,1243
8,2,2011,Tool Tec,,6,1237
9,2,2011,Costa Coffee,Eating Out,1,1236
9,2,2011,Tool Shop,,4,1232
10,2,2011,Caffe Nero,Eating Out,1,1231
10,2,2011,ATM Cash Withdrawal,General,20,1211
11,2,2011,Tescos,Groceries,75,1136
11,2,2011,Caffe Nero,Eating Out,2,1134
11,2,2011,Restaurant Gordon RamsayPortland Restaurant,Eating Out,39,1095
11,2,2011,ATM Cash Withdrawal,General,10,1085
11,2,2011,Tool Tec,,6,1079
12,2,2011,Pizza Express,Eating Out,33,1046
13,2,2011,ATM Cash Withdrawal,General,10,1036
14,2,2011,South West Trains,Transport,25,1011
14,2,2011,Starbucks Coffee,Eating Out,1,1010
14,2,2011,McDonalds,Eating Out,6,1004
14,2,2011,ATM Cash Withdrawal,General,10,994
15,2,2011,BRGAS-Electricity,Bills,26,968
15,2,2011,BRGAS-Gas,Bills,28,940
15,2,2011,ATM Cash Withdrawal,General,20,920
16,2,2011,LBS Council Tax,Bills,35,885
16,2,2011,Wild Bean Cafe,Eating Out,2,883
16,2,2011,Chicken Cottage,Eating Out,7,876
17,2,2011,Wild Bean Cafe,Eating Out,2,874
17,2,2011,Greggs,Eating Out,5,869
17,2,2011,ATM Cash Withdrawal,General,20,849
18,2,2011,Morrisons,Groceries,48,801
18,2,2011,Costa Coffee,Eating Out,2,799
18,2,2011,Dominos Pizza,Eating Out,56,743
18,2,2011,ATM Cash Withdrawal,General,20,723
18,2,2011,Civic Shop,,6,717
20,2,2011,VIRGIN MEDIA PYMTS,Bills,33,684
21,2,2011,South West Trains,Transport,28,656
21,2,2011,Caffe Nero,Eating Out,2,654
22,2,2011,Costa Coffee,Eating Out,2,652
22,2,2011,ATM Cash Withdrawal,General,10,642
23,2,2011,McDonalds,Eating Out,6,636
23,2,2011,ATM Cash Withdrawal,General,10,626
24,2,2011,O2,Bills,28,598
24,2,2011,Wild Bean Cafe,Eating Out,1,597
25,2,2011,Sainsburys,Groceries,48,549
25,2,2011,Wild Bean Cafe,Eating Out,2,547
25,2,2011,Chicken Cottage,Eating Out,5,542
25,2,2011,Pizza Express,Eating Out,45,497
25,2,2011,ATM Cash Withdrawal,General,20,477
26,2,2011,Heaven Club,Eating Out,8,469
26,2,2011,Heaven Club,Eating Out,5,464
26,2,2011,Heaven Club,Eating Out,16,448
26,2,2011,Scott's Restaurant,Eating Out,33,415
28,2,2011,South West Trains,Transport,37,378
28,2,2011,Wild Bean Cafe,Eating Out,1,377
1,3,2011,Rhino Sports salary,General,1600,1977
1,3,2011,Costa Coffee,Eating Out,2,1975
1,3,2011,Subway,Eating Out,5,1970
2,3,2011,Costa Coffee,Eating Out,1,1969
2,3,2011,ATM Cash Withdrawal,General,10,1959
3,3,2011,Costa Coffee,Eating Out,2,1957
3,3,2011,McDonalds,Eating Out,8,1949
3,3,2011,Paying back Julie,,8,1941
4,3,2011,Morrisons,Groceries,42,1899
4,3,2011,Costa Coffee,Eating Out,2,1897
4,3,2011,Ministry of Sound ClubXOYO Club,Eating Out,11,1886
4,3,2011,Ministry of Sound ClubXOYO Club,Eating Out,8,1878
4,3,2011,Ministry of Sound ClubXOYO Club,Eating Out,12,1866
4,3,2011,Ministry of Sound ClubXOYO Club,Eating Out,15,1851
5,3,2011,ATM Cash Withdrawal,General,20,1831
6,3,2011,ATM Cash Withdrawal,General,10,1821
7,3,2011,Cubit and West rent,Rent,440,1381
7,3,2011,South West Trains,Transport,38,1343
7,3,2011,ATM Cash Withdrawal,General,20,1323
9,3,2011,Cheam Service Station,,1,1322
10,3,2011,Starbucks Coffee,Eating Out,2,1320
10,3,2011,McDonalds,Eating Out,6,1314
10,3,2011,ATM Cash Withdrawal,General,10,1304
11,3,2011,Waitrose,Groceries,59,1245
11,3,2011,Wild Bean Cafe,Eating Out,1,1244
11,3,2011,Greggs,Eating Out,8,1236
11,3,2011,Paying back Julie,,4,1232
12,3,2011,ATM Cash Withdrawal,General,20,1212
14,3,2011,South West Trains,Transport,32,1180
14,3,2011,Starbucks Coffee,Eating Out,1,1179
14,3,2011,McDonalds,Eating Out,8,1171
15,3,2011,BRGAS-Electricity,Bills,18,1153
15,3,2011,BRGAS-Gas,Bills,17,1136
16,3,2011,LBS Council Tax,Bills,35,1101
16,3,2011,Caffe Nero,Eating Out,2,1099
16,3,2011,Greggs,Eating Out,5,1094
17,3,2011,Wild Bean Cafe,Eating Out,2,1092
17,3,2011,Greggs,Eating Out,5,1087
18,3,2011,Sainsburys,Groceries,71,1016
18,3,2011,Starbucks Coffee,Eating Out,2,1014
18,3,2011,McDonalds,Eating Out,6,1008
18,3,2011,Restaurant Gordon RamsayPortland Restaurant,Eating Out,24,984
18,3,2011,ATM Cash Withdrawal,General,10,974
20,3,2011,VIRGIN MEDIA PYMTS,Bills,26,948
21,3,2011,South West Trains,Transport,25,923
21,3,2011,Wild Bean Cafe,Eating Out,2,921
21,3,2011,Pret A Manger,Eating Out,8,913
22,3,2011,Costa Coffee,Eating Out,2,911
22,3,2011,ATM Cash Withdrawal,General,10,901
23,3,2011,ATM Cash Withdrawal,General,20,881
24,3,2011,O2,Bills,26,855
24,3,2011,Caffe Nero,Eating Out,2,853
24,3,2011,ATM Cash Withdrawal,General,10,843
25,3,2011,Morrisons,Groceries,64,779
25,3,2011,Starbucks Coffee,Eating Out,2,777
25,3,2011,Greggs,Eating Out,7,770
25,3,2011,Pizza Express,Eating Out,36,734
25,3,2011,Tool Shop,,3,731
28,3,2011,South West Trains,Transport,35,696
28,3,2011,Caffe Nero,Eating Out,2,694
29,3,2011,Wild Bean Cafe,Eating Out,2,692
30,3,2011,Caffe Nero,Eating Out,1,691
30,3,2011,The West Cornwall Pasty Company,Eating Out,7,684
31,3,2011,Starbucks Coffee,Eating Out,2,682
31,3,2011,ATM Cash Withdrawal,General,20,662
1,4,2011,Rhino Sports salary,General,1600,2262
1,4,2011,Tescos,Groceries,51,2211
1,4,2011,Starbucks Coffee,Eating Out,2,2209
1,4,2011,Chicken Cottage,Eating Out,8,2201
1,4,2011,Scott's Restaurant,Eating Out,45,2156
2,4,2011,Anglo restaurant,Eating Out,25,2131
2,4,2011,ATM Cash Withdrawal,General,10,2121
2,4,2011,Paying back Julie,,4,2117
3,4,2011,ATM Cash Withdrawal,General,10,2107
4,4,2011,South West Trains,Transport,35,2072
4,4,2011,Caffe Nero,Eating Out,2,2070
4,4,2011,ATM Cash Withdrawal,General,10,2060
5,4,2011,Wild Bean Cafe,Eating Out,2,2058
5,4,2011,Chicken Cottage,Eating Out,8,2050
5,4,2011,ATM Cash Withdrawal,General,20,2030
6,4,2011,Costa Coffee,Eating Out,2,2028
6,4,2011,The West Cornwall Pasty Company,Eating Out,6,2022
6,4,2011,ATM Cash Withdrawal,General,20,2002
7,4,2011,Cubit and West rent,Rent,440,1562
7,4,2011,Starbucks Coffee,Eating Out,1,1561
7,4,2011,Greggs,Eating Out,5,1556
8,4,2011,Morrisons,Groceries,80,1476
8,4,2011,Wild Bean Cafe,Eating Out,1,1475
8,4,2011,The West Cornwall Pasty Company,Eating Out,4,1471
9,4,2011,Tool Tec,,1,1470
10,4,2011,Anglo restaurant,Eating Out,25,1445
10,4,2011,ATM Cash Withdrawal,General,10,1435
11,4,2011,South West Trains,Transport,38,1397
11,4,2011,Costa Coffee,Eating Out,2,1395
12,4,2011,Costa Coffee,Eating Out,2,1393
12,4,2011,Red Shop,,3,1390
13,4,2011,Starbucks Coffee,Eating Out,2,1388
13,4,2011,The West Cornwall Pasty Company,Eating Out,6,1382
14,4,2011,Starbucks Coffee,Eating Out,2,1380
14,4,2011,The West Cornwall Pasty Company,Eating Out,7,1373
14,4,2011,Cheam Service Station,,4,1369
15,4,2011,BRGAS-Electricity,Bills,34,1335
15,4,2011,BRGAS-Gas,Bills,28,1307
15,4,2011,ASDA,Groceries,82,1225
15,4,2011,Costa Coffee,Eating Out,2,1223
15,4,2011,McDonalds,Eating Out,6,1217
16,4,2011,LBS Council Tax,Bills,35,1182
16,4,2011,Scott's Restaurant,Eating Out,58,1124
16,4,2011,ATM Cash Withdrawal,General,20,1104
16,4,2011,Tool Tec,,9,1095
18,4,2011,South West Trains,Transport,35,1060
18,4,2011,The West Cornwall Pasty Company,Eating Out,5,1055
19,4,2011,Costa Coffee,Eating Out,1,1054
19,4,2011,Pret A Manger,Eating Out,7,1047
20,4,2011,VIRGIN MEDIA PYMTS,Bills,23,1024
21,4,2011,Costa Coffee,Eating Out,2,1022
21,4,2011,Chicken Cottage,Eating Out,8,1014
22,4,2011,Morrisons,Groceries,74,940
22,4,2011,Wild Bean Cafe,Eating Out,2,938
24,4,2011,O2,Bills,25,913
24,4,2011,ATM Cash Withdrawal,General,10,903
25,4,2011,South West Trains,Transport,36,867
25,4,2011,Wild Bean Cafe,Eating Out,1,866
26,4,2011,Starbucks Coffee,Eating Out,2,864
26,4,2011,The West Cornwall Pasty Company,Eating Out,6,858
28,4,2011,Wild Bean Cafe,Eating Out,2,856
28,4,2011,ATM Cash Withdrawal,General,20,836
28,4,2011,Civic Shop,,6,830
29,4,2011,Waitrose,Groceries,76,754
29,4,2011,Caffe Nero,Eating Out,2,752
29,4,2011,Subway,Eating Out,7,745
29,4,2011,ATM Cash Withdrawal,General,10,735
30,4,2011,ATM Cash Withdrawal,General,10,725
1,5,2011,Rhino Sports salary,General,1600,2325
2,5,2011,South West Trains,Transport,32,2293
2,5,2011,Wild Bean Cafe,Eating Out,2,2291
3,5,2011,Pret A Manger,Eating Out,6,2285
4,5,2011,Greggs,Eating Out,7,2278
4,5,2011,Paying back James,,3,2275
5,5,2011,Caffe Nero,Eating Out,2,2273
6,5,2011,Morrisons,Groceries,47,2226
6,5,2011,Costa Coffee,Eating Out,1,2225
6,5,2011,Restaurant Gordon RamsayPortland Restaurant,Eating Out,24,2201
7,5,2011,Cubit and West rent,Rent,440,1761
8,5,2011,Restaurant Gordon RamsayPortland Restaurant,Eating Out,58,1703
9,5,2011,South West Trains,Transport,37,1666
9,5,2011,McDonalds,Eating Out,4,1662
10,5,2011,Caffe Nero,Eating Out,1,1661
10,5,2011,Chicken Cottage,Eating Out,6,1655
11,5,2011,Caffe Nero,Eating Out,2,1653
11,5,2011,Greggs,Eating Out,8,1645
12,5,2011,Starbucks Coffee,Eating Out,2,1643
13,5,2011,Tescos,Groceries,73,1570
13,5,2011,Caffe Nero,Eating Out,2,1568
13,5,2011,Scott's Restaurant,Eating Out,54,1514
14,5,2011,ATM Cash Withdrawal,General,20,1494
15,5,2011,BRGAS-Electricity,Bills,30,1464
15,5,2011,BRGAS-Gas,Bills,24,1440
15,5,2011,Anglo restaurant,Eating Out,37,1403
15,5,2011,ATM Cash Withdrawal,General,20,1383
16,5,2011,LBS Council Tax,Bills,35,1348
16,5,2011,South West Trains,Transport,35,1313
16,5,2011,Subway,Eating Out,7,1306
17,5,2011,Caffe Nero,Eating Out,2,1304
17,5,2011,Pret A Manger,Eating Out,6,1298
18,5,2011,Starbucks Coffee,Eating Out,1,1297
18,5,2011,Chicken Cottage,Eating Out,4,1293
18,5,2011,ATM Cash Withdrawal,General,10,1283
19,5,2011,Caffe Nero,Eating Out,2,1281
20,5,2011,VIRGIN MEDIA PYMTS,Bills,39,1242
20,5,2011,Sainsburys,Groceries,61,1181
20,5,2011,Caffe Nero,Eating Out,2,1179
20,5,2011,Greggs,Eating Out,5,1174
20,5,2011,Dominos Pizza,Eating Out,59,1115
21,5,2011,Pizza Express,Eating Out,38,1077
21,5,2011,ATM Cash Withdrawal,General,10,1067
21,5,2011,Civic Shop,,5,1062
23,5,2011,South West Trains,Transport,28,1034
23,5,2011,Greggs,Eating Out,7,1027
23,5,2011,ATM Cash Withdrawal,General,20,1007
24,5,2011,O2,Bills,26,981
24,5,2011,Costa Coffee,Eating Out,1,980
24,5,2011,McDonalds,Eating Out,7,973
25,5,2011,Caffe Nero,Eating Out,2,971
25,5,2011,Chicken Cottage,Eating Out,7,964
25,5,2011,Cheam Service Station,,2,962
26,5,2011,Caffe Nero,Eating Out,2,960
26,5,2011,The West Cornwall Pasty Company,Eating Out,4,956
27,5,2011,Tescos,Groceries,56,900
27,5,2011,Wild Bean Cafe,Eating Out,2,898
27,5,2011,Dominos Pizza,Eating Out,53,845
28,5,2011,Restaurant Gordon RamsayPortland Restaurant,Eating Out,35,810
28,5,2011,ATM Cash Withdrawal,General,10,800
30,5,2011,South West Trains,Transport,36,764
30,5,2011,Starbucks Coffee,Eating Out,2,762
30,5,2011,McDonalds,Eating Out,4,758
1,6,2011,Rhino Sports salary,General,1600,2358
1,6,2011,Subway,Eating Out,6,2352
1,6,2011,ATM Cash Withdrawal,General,20,2332
2,6,2011,Caffe Nero,Eating Out,2,2330
2,6,2011,McDonalds,Eating Out,4,2326
3,6,2011,Sainsburys,Groceries,39,2287
3,6,2011,Anglo restaurant,Eating Out,29,2258
3,6,2011,ATM Cash Withdrawal,General,20,2238
6,6,2011,South West Trains,Transport,36,2202
6,6,2011,Starbucks Coffee,Eating Out,2,2200
7,6,2011,Cubit and West rent,Rent,440,1760
7,6,2011,Starbucks Coffee,Eating Out,2,1758
8,6,2011,Wild Bean Cafe,Eating Out,1,1757
8,6,2011,ATM Cash Withdrawal,General,10,1747
9,6,2011,McDonalds,Eating Out,8,1739
9,6,2011,ATM Cash Withdrawal,General,10,1729
10,6,2011,Morrisons,Groceries,68,1661
10,6,2011,Costa Coffee,Eating Out,2,1659
10,6,2011,Heaven Club,Eating Out,10,1649
10,6,2011,Heaven Club,Eating Out,7,1642
10,6,2011,Heaven Club,Eating Out,12,1630
11,6,2011,Dominos Pizza,Eating Out,33,1597
11,6,2011,ATM Cash Withdrawal,General,20,1577
12,6,2011,Cheam Service Station,,3,1574
13,6,2011,South West Trains,Transport,35,1539
13,6,2011,Wild Bean Cafe,Eating Out,1,1538
13,6,2011,Red Shop,,2,1536
14,6,2011,Starbucks Coffee,Eating Out,2,1534
14,6,2011,Pret A Manger,Eating Out,5,1529
15,6,2011,BRGAS-Electricity,Bills,23,1506
15,6,2011,BRGAS-Gas,Bills,30,1476
15,6,2011,Costa Coffee,Eating Out,2,1474
15,6,2011,The West Cornwall Pasty Company,Eating Out,7,1467
15,6,2011,ATM Cash Withdrawal,General,20,1447
15,6,2011,Red Shop,,2,1445
16,6,2011,LBS Council Tax,Bills,35,1410
16,6,2011,Starbucks Coffee,Eating Out,2,1408
16,6,2011,ATM Cash Withdrawal,General,20,1388
16,6,2011,Tool Tec,,2,1386
17,6,2011,Waitrose,Groceries,48,1338
17,6,2011,McDonalds,Eating Out,4,1334
17,6,2011,Pizza Express,Eating Out,49,1285
18,6,2011,Restaurant Gordon RamsayPortland Restaurant,Eating Out,55,1230
18,6,2011,ATM Cash Withdrawal,General,20,1210
20,6,2011,VIRGIN MEDIA PYMTS,Bills,25,1185
20,6,2011,South West Trains,Transport,36,1149
20,6,2011,The West Cornwall Pasty Company,Eating Out,8,1141
21,6,2011,Starbucks Coffee,Eating Out,1,1140
21,6,2011,McDonalds,Eating Out,7,1133
21,6,2011,ATM Cash Withdrawal,General,10,1123
22,6,2011,Starbucks Coffee,Eating Out,2,1121
23,6,2011,Wild Bean Cafe,Eating Out,2,1119
23,6,2011,Chicken Cottage,Eating Out,8,1111
23,6,2011,ATM Cash Withdrawal,General,20,1091
24,6,2011,O2,Bills,25,1066
24,6,2011,Morrisons,Groceries,69,997
24,6,2011,Caffe Nero,Eating Out,2,995
25,6,2011,Anglo restaurant,Eating Out,25,970
26,6,2011,Anglo restaurant,Eating Out,53,917
27,6,2011,South West Trains,Transport,24,893
27,6,2011,Wild Bean Cafe,Eating Out,2,891
27,6,2011,Greggs,Eating Out,8,883
28,6,2011,Starbucks Coffee,Eating Out,2,881
28,6,2011,Subway,Eating Out,4,877
28,6,2011,Civic Shop,,1,876
29,6,2011,Caffe Nero,Eating Out,2,874
29,6,2011,Subway,Eating Out,5,869
30,6,2011,Starbucks Coffee,Eating Out,1,868
1,7,2011,Rhino Sports salary,General,1600,2468
1,7,2011,Tescos,Groceries,78,2390
1,7,2011,Costa Coffee,Eating Out,2,2388
1,7,2011,Subway,Eating Out,8,2380
1,7,2011,Anglo restaurant,Eating Out,30,2350
2,7,2011,ATM Cash Withdrawal,General,20,2330
4,7,2011,South West Trains,Transport,35,2295
4,7,2011,Wild Bean Cafe,Eating Out,1,2294
4,7,2011,Chicken Cottage,Eating Out,5,2289
5,7,2011,Wild Bean Cafe,Eating Out,2,2287
5,7,2011,Greggs,Eating Out,6,2281
5,7,2011,ATM Cash Withdrawal,General,10,2271
6,7,2011,Caffe Nero,Eating Out,2,2269
7,7,2011,Cubit and West rent,Rent,440,1829
7,7,2011,Caffe Nero,Eating Out,2,1827
7,7,2011,Subway,Eating Out,7,1820
8,7,2011,Sainsburys,Groceries,77,1743
8,7,2011,Starbucks Coffee,Eating Out,1,1742
8,7,2011,ATM Cash Withdrawal,General,10,1732
11,7,2011,South West Trains,Transport,34,1698
11,7,2011,Pret A Manger,Eating Out,8,1690
12,7,2011,Wild Bean Cafe,Eating Out,2,1688
12,7,2011,The West Cornwall Pasty Company,Eating Out,4,1684
13,7,2011,Costa Coffee,Eating Out,2,1682
14,7,2011,Costa Coffee,Eating Out,2,1680
14,7,2011,Greggs,Eating Out,5,1675
15,7,2011,BRGAS-Electricity,Bills,27,1648
15,7,2011,BRGAS-Gas,Bills,33,1615
15,7,2011,Waitrose,Groceries,54,1561
15,7,2011,Caffe Nero,Eating Out,2,1559
15,7,2011,The West Cornwall Pasty Company,Eating Out,6,1553
16,7,2011,LBS Council Tax,Bills,35,1518
18,7,2011,South West Trains,Transport,35,1483
18,7,2011,Starbucks Coffee,Eating Out,2,1481
19,7,2011,Caffe Nero,Eating Out,1,1480
19,7,2011,Greggs,Eating Out,7,1473
19,7,2011,ATM Cash Withdrawal,General,10,1463
20,7,2011,VIRGIN MEDIA PYMTS,Bills,38,1425
20,7,2011,Wild Bean Cafe,Eating Out,2,1423
20,7,2011,ATM Cash Withdrawal,General,20,1403
21,7,2011,Caffe Nero,Eating Out,1,1402
21,7,2011,Subway,Eating Out,8,1394
22,7,2011,Morrisons,Groceries,50,1344
22,7,2011,Costa Coffee,Eating Out,1,1343
22,7,2011,The West Cornwall Pasty Company,Eating Out,8,1335
22,7,2011,Heaven Club,Eating Out,16,1319
22,7,2011,Heaven Club,Eating Out,9,1310
22,7,2011,Heaven Club,Eating Out,10,1300
22,7,2011,Heaven Club,Eating Out,12,1288
22,7,2011,Heaven Club,Eating Out,15,1273
24,7,2011,O2,Bills,26,1247
24,7,2011,Dominos Pizza,Eating Out,24,1223
24,7,2011,ATM Cash Withdrawal,General,10,1213
25,7,2011,South West Trains,Transport,37,1176
25,7,2011,Caffe Nero,Eating Out,2,1174
25,7,2011,McDonalds,Eating Out,6,1168
26,7,2011,Costa Coffee,Eating Out,2,1166
26,7,2011,Cheam Service Station,,9,1157
27,7,2011,Pret A Manger,Eating Out,5,1152
27,7,2011,ATM Cash Withdrawal,General,10,1142
28,7,2011,Costa Coffee,Eating Out,1,1141
28,7,2011,The West Cornwall Pasty Company,Eating Out,7,1134
28,7,2011,ATM Cash Withdrawal,General,10,1124
29,7,2011,Morrisons,Groceries,50,1074
29,7,2011,ATM Cash Withdrawal,General,20,1054
1,8,2011,Rhino Sports salary,General,1600,2654
1,8,2011,South West Trains,Transport,34,2620
1,8,2011,Wild Bean Cafe,Eating Out,2,2618
1,8,2011,Chicken Cottage,Eating Out,6,2612
2,8,2011,Wild Bean Cafe,Eating Out,2,2610
4,8,2011,Costa Coffee,Eating Out,2,2608
4,8,2011,Greggs,Eating Out,4,2604
4,8,2011,ATM Cash Withdrawal,General,20,2584
4,8,2011,Tool Shop,,4,2580
5,8,2011,Morrisons,Groceries,76,2504
5,8,2011,Costa Coffee,Eating Out,2,2502
5,8,2011,Scott's Restaurant,Eating Out,55,2447
7,8,2011,Cubit and West rent,Rent,440,2007
7,8,2011,ATM Cash Withdrawal,General,20,1987
8,8,2011,South West Trains,Transport,26,1961
8,8,2011,Caffe Nero,Eating Out,2,1959
9,8,2011,Red Shop,,1,1958
10,8,2011,McDonalds,Eating Out,5,1953
10,8,2011,ATM Cash Withdrawal,General,20,1933
11,8,2011,Caffe Nero,Eating Out,2,1931
12,8,2011,Tescos,Groceries,55,1876
12,8,2011,Wild Bean Cafe,Eating Out,1,1875
12,8,2011,Chicken Cottage,Eating Out,8,1867
13,8,2011,Scott's Restaurant,Eating Out,25,1842
14,8,2011,Anglo restaurant,Eating Out,56,1786
15,8,2011,BRGAS-Electricity,Bills,28,1758
15,8,2011,BRGAS-Gas,Bills,28,1730
15,8,2011,South West Trains,Transport,37,1693
15,8,2011,Costa Coffee,Eating Out,2,1691
15,8,2011,Chicken Cottage,Eating Out,8,1683
15,8,2011,Paying back Julie,,3,1680
16,8,2011,LBS Council Tax,Bills,35,1645
16,8,2011,Starbucks Coffee,Eating Out,2,1643
17,8,2011,Pret A Manger,Eating Out,5,1638
18,8,2011,McDonalds,Eating Out,5,1633
19,8,2011,Tescos,Groceries,63,1570
19,8,2011,Pret A Manger,Eating Out,8,1562
19,8,2011,Dominos Pizza,Eating Out,45,1517
20,8,2011,VIRGIN MEDIA PYMTS,Bills,33,1484
20,8,2011,The Grand Pub,Eating Out,14,1470
20,8,2011,The Grand Pub,Eating Out,9,1461
20,8,2011,The Grand Pub,Eating Out,9,1452
20,8,2011,The Grand Pub,Eating Out,5,1447
20,8,2011,The Grand Pub,Eating Out,11,1436
21,8,2011,Restaurant Gordon RamsayPortland Restaurant,Eating Out,39,1397
22,8,2011,South West Trains,Transport,31,1366
22,8,2011,Starbucks Coffee,Eating Out,2,1364
22,8,2011,Pret A Manger,Eating Out,7,1357
22,8,2011,ATM Cash Withdrawal,General,10,1347
24,8,2011,O2,Bills,30,1317
24,8,2011,Pret A Manger,Eating Out,6,1311
25,8,2011,Costa Coffee,Eating Out,1,1310
25,8,2011,Chicken Cottage,Eating Out,5,1305
26,8,2011,Sainsburys,Groceries,66,1239
26,8,2011,Costa Coffee,Eating Out,2,1237
26,8,2011,Dominos Pizza,Eating Out,51,1186
26,8,2011,ATM Cash Withdrawal,General,20,1166
28,8,2011,ATM Cash Withdrawal,General,10,1156
29,8,2011,South West Trains,Transport,34,1122
29,8,2011,Wild Bean Cafe,Eating Out,2,1120
30,8,2011,Costa Coffee,Eating Out,2,1118
30,8,2011,Chicken Cottage,Eating Out,5,1113
31,8,2011,Starbucks Coffee,Eating Out,2,1111
31,8,2011,Chicken Cottage,Eating Out,5,1106
1,9,2011,Rhino Sports salary,General,1600,2706
1,9,2011,Wild Bean Cafe,Eating Out,2,2704
1,9,2011,ATM Cash Withdrawal,General,20,2684
2,9,2011,Sainsburys,Groceries,62,2622
2,9,2011,Restaurant Gordon RamsayPortland Restaurant,Eating Out,47,2575
5,9,2011,South West Trains,Transport,24,2551
5,9,2011,Wild Bean Cafe,Eating Out,2,2549
5,9,2011,Chicken Cottage,Eating Out,6,2543
6,9,2011,Costa Coffee,Eating Out,1,2542
6,9,2011,McDonalds,Eating Out,5,2537
7,9,2011,Cubit and West rent,Rent,440,2097
7,9,2011,Caffe Nero,Eating Out,2,2095
7,9,2011,Chicken Cottage,Eating Out,8,2087
8,9,2011,Caffe Nero,Eating Out,2,2085
8,9,2011,The West Cornwall Pasty Company,Eating Out,6,2079
8,9,2011,ATM Cash Withdrawal,General,20,2059
9,9,2011,Sainsburys,Groceries,70,1989
9,9,2011,Starbucks Coffee,Eating Out,1,1988
9,9,2011,Ministry of Sound ClubXOYO Club,Eating Out,15,1973
9,9,2011,Ministry of Sound ClubXOYO Club,Eating Out,8,1965
9,9,2011,Ministry of Sound ClubXOYO Club,Eating Out,9,1956
10,9,2011,The Grand Pub,Eating Out,16,1940
10,9,2011,Pizza Express,Eating Out,54,1886
11,9,2011,Scott's Restaurant,Eating Out,36,1850
12,9,2011,South West Trains,Transport,28,1822
12,9,2011,Caffe Nero,Eating Out,1,1821
12,9,2011,ATM Cash Withdrawal,General,20,1801
13,9,2011,Caffe Nero,Eating Out,2,1799
13,9,2011,Pret A Manger,Eating Out,7,1792
14,9,2011,Starbucks Coffee,Eating Out,1,1791
14,9,2011,ATM Cash Withdrawal,General,20,1771
15,9,2011,BRGAS-Electricity,Bills,19,1752
15,9,2011,BRGAS-Gas,Bills,28,1724
15,9,2011,Starbucks Coffee,Eating Out,2,1722
15,9,2011,McDonalds,Eating Out,6,1716
16,9,2011,LBS Council Tax,Bills,35,1681
16,9,2011,Sainsburys,Groceries,60,1621
16,9,2011,Costa Coffee,Eating Out,2,1619
17,9,2011,Dominos Pizza,Eating Out,53,1566
18,9,2011,ATM Cash Withdrawal,General,20,1546
19,9,2011,South West Trains,Transport,35,1511
19,9,2011,ATM Cash Withdrawal,General,20,1491
20,9,2011,VIRGIN MEDIA PYMTS,Bills,21,1470
20,9,2011,Costa Coffee,Eating Out,1,1469
20,9,2011,McDonalds,Eating Out,7,1462
21,9,2011,Wild Bean Cafe,Eating Out,2,1460
21,9,2011,Pret A Manger,Eating Out,5,1455
21,9,2011,Red Shop,,8,1447
23,9,2011,Morrisons,Groceries,57,1390
23,9,2011,Wild Bean Cafe,Eating Out,1,1389
23,9,2011,The West Cornwall Pasty Company,Eating Out,6,1383
23,9,2011,Scott's Restaurant,Eating Out,45,1338
24,9,2011,O2,Bills,32,1306
24,9,2011,ATM Cash Withdrawal,General,20,1286
24,9,2011,Red Shop,,9,1277
25,9,2011,Restaurant Gordon RamsayPortland Restaurant,Eating Out,25,1252
25,9,2011,ATM Cash Withdrawal,General,20,1232
26,9,2011,South West Trains,Transport,26,1206
26,9,2011,Costa Coffee,Eating Out,2,1204
26,9,2011,Subway,Eating Out,8,1196
27,9,2011,Starbucks Coffee,Eating Out,2,1194
27,9,2011,Civic Shop,,2,1192
28,9,2011,Costa Coffee,Eating Out,2,1190
28,9,2011,McDonalds,Eating Out,4,1186
29,9,2011,Wild Bean Cafe,Eating Out,1,1185
29,9,2011,McDonalds,Eating Out,8,1177
30,9,2011,Waitrose,Groceries,55,1122
30,9,2011,Starbucks Coffee,Eating Out,2,1120
30,9,2011,The West Cornwall Pasty Company,Eating Out,7,1113
30,9,2011,Restaurant Gordon RamsayPortland Restaurant,Eating Out,28,1085
30,9,2011,ATM Cash Withdrawal,General,20,1065
1,10,2011,Rhino Sports salary,General,1600,2665
1,10,2011,Scott's Restaurant,Eating Out,42,2623
3,10,2011,South West Trains,Transport,38,2585
3,10,2011,Starbucks Coffee,Eating Out,2,2583
3,10,2011,ATM Cash Withdrawal,General,10,2573
3,10,2011,Paying back James,,7,2566
5,10,2011,Chicken Cottage,Eating Out,7,2559
6,10,2011,Caffe Nero,Eating Out,2,2557
7,10,2011,Cubit and West rent,Rent,440,2117
7,10,2011,Morrisons,Groceries,61,2056
7,10,2011,Wild Bean Cafe,Eating Out,1,2055
7,10,2011,ATM Cash Withdrawal,General,10,2045
9,10,2011,ATM Cash Withdrawal,General,20,2025
10,10,2011,South West Trains,Transport,26,1999
10,10,2011,The West Cornwall Pasty Company,Eating Out,8,1991
11,10,2011,Starbucks Coffee,Eating Out,2,1989
11,10,2011,Pret A Manger,Eating Out,4,1985
12,10,2011,Starbucks Coffee,Eating Out,2,1983
12,10,2011,ATM Cash Withdrawal,General,20,1963
13,10,2011,Costa Coffee,Eating Out,1,1962
14,10,2011,Morrisons,Groceries,58,1904
14,10,2011,Subway,Eating Out,8,1896
14,10,2011,Anglo restaurant,Eating Out,59,1837
14,10,2011,Tool Tec,,1,1836
15,10,2011,BRGAS-Electricity,Bills,29,1807
15,10,2011,BRGAS-Gas,Bills,32,1775
16,10,2011,LBS Council Tax,Bills,35,1740
17,10,2011,South West Trains,Transport,36,1704
17,10,2011,Costa Coffee,Eating Out,2,1702
17,10,2011,McDonalds,Eating Out,4,1698
18,10,2011,Caffe Nero,Eating Out,2,1696
18,10,2011,The West Cornwall Pasty Company,Eating Out,5,1691
18,10,2011,Cheam Service Station,,4,1687
19,10,2011,Caffe Nero,Eating Out,2,1685
19,10,2011,Subway,Eating Out,8,1677
20,10,2011,VIRGIN MEDIA PYMTS,Bills,40,1637
21,10,2011,Morrisons,Groceries,56,1581
21,10,2011,Caffe Nero,Eating Out,1,1580
21,10,2011,Pret A Manger,Eating Out,6,1574
21,10,2011,The Grand Pub,Eating Out,14,1560
21,10,2011,The Grand Pub,Eating Out,12,1548
21,10,2011,The Grand Pub,Eating Out,9,1539
21,10,2011,The Grand Pub,Eating Out,12,1527
21,10,2011,The Grand Pub,Eating Out,13,1514
21,10,2011,Pizza Express,Eating Out,36,1478
22,10,2011,Heaven Club,Eating Out,16,1462
22,10,2011,Heaven Club,Eating Out,5,1457
22,10,2011,Anglo restaurant,Eating Out,57,1400
24,10,2011,O2,Bills,27,1373
24,10,2011,South West Trains,Transport,33,1340
24,10,2011,Wild Bean Cafe,Eating Out,2,1338
24,10,2011,Pret A Manger,Eating Out,4,1334
24,10,2011,ATM Cash Withdrawal,General,10,1324
25,10,2011,Wild Bean Cafe,Eating Out,1,1323
25,10,2011,McDonalds,Eating Out,8,1315
25,10,2011,Civic Shop,,3,1312
26,10,2011,Caffe Nero,Eating Out,2,1310
27,10,2011,Pret A Manger,Eating Out,4,1306
27,10,2011,ATM Cash Withdrawal,General,20,1286
28,10,2011,ASDA,Groceries,51,1235
28,10,2011,Greggs,Eating Out,6,1229
28,10,2011,Ministry of Sound ClubXOYO Club,Eating Out,6,1223
28,10,2011,Ministry of Sound ClubXOYO Club,Eating Out,11,1212
28,10,2011,Ministry of Sound ClubXOYO Club,Eating Out,8,1204
28,10,2011,ATM Cash Withdrawal,General,10,1194
29,10,2011,Anglo restaurant,Eating Out,55,1139
31,10,2011,South West Trains,Transport,27,1112
31,10,2011,Greggs,Eating Out,7,1105
31,10,2011,ATM Cash Withdrawal,General,20,1085
31,10,2011,Red Shop,,9,1076
1,11,2011,Rhino Sports salary,General,1600,2676
1,11,2011,Wild Bean Cafe,Eating Out,2,2674
1,11,2011,Greggs,Eating Out,6,2668
2,11,2011,Costa Coffee,Eating Out,1,2667
3,11,2011,Wild Bean Cafe,Eating Out,2,2665
3,11,2011,The West Cornwall Pasty Company,Eating Out,6,2659
3,11,2011,ATM Cash Withdrawal,General,20,2639
4,11,2011,ASDA,Groceries,42,2597
4,11,2011,Starbucks Coffee,Eating Out,2,2595
4,11,2011,Restaurant Gordon RamsayPortland Restaurant,Eating Out,28,2567
4,11,2011,ATM Cash Withdrawal,General,10,2557
5,11,2011,Scott's Restaurant,Eating Out,37,2520
5,11,2011,ATM Cash Withdrawal,General,10,2510
7,11,2011,Cubit and West rent,Rent,440,2070
7,11,2011,South West Trains,Transport,32,2038
7,11,2011,Caffe Nero,Eating Out,1,2037
7,11,2011,McDonalds,Eating Out,7,2030
7,11,2011,ATM Cash Withdrawal,General,20,2010
8,11,2011,Starbucks Coffee,Eating Out,2,2008
9,11,2011,Wild Bean Cafe,Eating Out,1,2007
10,11,2011,Caffe Nero,Eating Out,1,2006
10,11,2011,Chicken Cottage,Eating Out,5,2001
11,11,2011,ASDA,Groceries,38,1963
12,11,2011,Pizza Express,Eating Out,47,1916
14,11,2011,South West Trains,Transport,38,1878
14,11,2011,Costa Coffee,Eating Out,1,1877
14,11,2011,Greggs,Eating Out,7,1870
14,11,2011,ATM Cash Withdrawal,General,20,1850
15,11,2011,BRGAS-Electricity,Bills,32,1818
15,11,2011,BRGAS-Gas,Bills,31,1787
15,11,2011,Greggs,Eating Out,5,1782
15,11,2011,ATM Cash Withdrawal,General,20,1762
16,11,2011,LBS Council Tax,Bills,35,1727
16,11,2011,Caffe Nero,Eating Out,1,1726
16,11,2011,The West Cornwall Pasty Company,Eating Out,6,1720
18,11,2011,Sainsburys,Groceries,70,1650
18,11,2011,Costa Coffee,Eating Out,2,1648
18,11,2011,Pret A Manger,Eating Out,5,1643
18,11,2011,ATM Cash Withdrawal,General,20,1623
20,11,2011,VIRGIN MEDIA PYMTS,Bills,22,1601
20,11,2011,ATM Cash Withdrawal,General,10,1591
21,11,2011,South West Trains,Transport,32,1559
21,11,2011,Caffe Nero,Eating Out,2,1557
21,11,2011,Chicken Cottage,Eating Out,4,1553
21,11,2011,Tool Shop,,4,1549
22,11,2011,Wild Bean Cafe,Eating Out,1,1548
22,11,2011,Tool Shop,,2,1546
23,11,2011,Starbucks Coffee,Eating Out,2,1544
23,11,2011,Greggs,Eating Out,4,1540
24,11,2011,O2,Bills,30,1510
24,11,2011,Paying back James,,4,1506
25,11,2011,Sainsburys,Groceries,70,1436
25,11,2011,Caffe Nero,Eating Out,2,1434
25,11,2011,The West Cornwall Pasty Company,Eating Out,7,1427
26,11,2011,Scott's Restaurant,Eating Out,50,1377
28,11,2011,South West Trains,Transport,25,1352
28,11,2011,Starbucks Coffee,Eating Out,1,1351
28,11,2011,McDonalds,Eating Out,7,1344
28,11,2011,ATM Cash Withdrawal,General,10,1334
29,11,2011,Subway,Eating Out,8,1326
30,11,2011,Starbucks Coffee,Eating Out,2,1324
1,12,2011,Rhino Sports salary,General,1600,2924
1,12,2011,Costa Coffee,Eating Out,1,2923
1,12,2011,ATM Cash Withdrawal,General,20,2903
2,12,2011,Morrisons,Groceries,44,2859
2,12,2011,Starbucks Coffee,Eating Out,1,2858
2,12,2011,The West Cornwall Pasty Company,Eating Out,7,2851
3,12,2011,Restaurant Gordon RamsayPortland Restaurant,Eating Out,26,2825
3,12,2011,Red Shop,,7,2818
4,12,2011,Tool Shop,,6,2812
5,12,2011,South West Trains,Transport,32,2780
5,12,2011,Wild Bean Cafe,Eating Out,2,2778
5,12,2011,Greggs,Eating Out,8,2770
6,12,2011,Wild Bean Cafe,Eating Out,2,2768
7,12,2011,Cubit and West rent,Rent,440,2328
7,12,2011,Costa Coffee,Eating Out,1,2327
7,12,2011,The West Cornwall Pasty Company,Eating Out,8,2319
7,12,2011,Paying back James,,2,2317
8,12,2011,Caffe Nero,Eating Out,1,2316
8,12,2011,Pret A Manger,Eating Out,6,2310
9,12,2011,Waitrose,Groceries,77,2233
9,12,2011,Costa Coffee,Eating Out,1,2232
9,12,2011,Pret A Manger,Eating Out,8,2224
10,12,2011,Heaven Club,Eating Out,7,2217
10,12,2011,Heaven Club,Eating Out,11,2206
10,12,2011,Heaven Club,Eating Out,15,2191
10,12,2011,Heaven Club,Eating Out,9,2182
10,12,2011,Heaven Club,Eating Out,14,2168
10,12,2011,Heaven Club,Eating Out,11,2157
12,12,2011,South West Trains,Transport,26,2131
12,12,2011,McDonalds,Eating Out,8,2123
13,12,2011,Starbucks Coffee,Eating Out,1,2122
13,12,2011,Subway,Eating Out,7,2115
13,12,2011,Tool Shop,,3,2112
14,12,2011,Wild Bean Cafe,Eating Out,1,2111
14,12,2011,The West Cornwall Pasty Company,Eating Out,8,2103
14,12,2011,ATM Cash Withdrawal,General,20,2083
15,12,2011,BRGAS-Electricity,Bills,36,2047
15,12,2011,BRGAS-Gas,Bills,29,2018
15,12,2011,Starbucks Coffee,Eating Out,1,2017
15,12,2011,ATM Cash Withdrawal,General,10,2007
16,12,2011,LBS Council Tax,Bills,35,1972
16,12,2011,Morrisons,Groceries,76,1896
16,12,2011,Starbucks Coffee,Eating Out,2,1894
16,12,2011,Red Shop,,2,1892
17,12,2011,Paying back Julie,,5,1887
18,12,2011,Scott's Restaurant,Eating Out,29,1858
18,12,2011,ATM Cash Withdrawal,General,10,1848
19,12,2011,South West Trains,Transport,38,1810
19,12,2011,The West Cornwall Pasty Company,Eating Out,7,1803
20,12,2011,VIRGIN MEDIA PYMTS,Bills,33,1770
20,12,2011,Starbucks Coffee,Eating Out,2,1768
21,12,2011,Greggs,Eating Out,6,1762
22,12,2011,Caffe Nero,Eating Out,2,1760
22,12,2011,Chicken Cottage,Eating Out,8,1752
22,12,2011,Tool Shop,,3,1749
23,12,2011,Waitrose,Groceries,51,1698
23,12,2011,Caffe Nero,Eating Out,2,1696
23,12,2011,Subway,Eating Out,7,1689
24,12,2011,O2,Bills,26,1663
24,12,2011,ATM Cash Withdrawal,General,20,1643
25,12,2011,ATM Cash Withdrawal,General,10,1633
25,12,2011,Paying back James,,5,1628
26,12,2011,South West Trains,Transport,37,1591
26,12,2011,Caffe Nero,Eating Out,1,1590
26,12,2011,Pret A Manger,Eating Out,7,1583
27,12,2011,Wild Bean Cafe,Eating Out,2,1581
29,12,2011,The West Cornwall Pasty Company,Eating Out,5,1576
30,12,2011,Waitrose,Groceries,75,1501
30,12,2011,ATM Cash Withdrawal,General,10,1491
31,12,2011,Ministry of Sound ClubXOYO Club,Eating Out,15,1476
31,12,2011,ATM Cash Withdrawal,General,20,1456
1,1,2012,Rhino Sports salary,General,1600,3056
2,1,2012,South West Trains,Transport,38,3018
2,1,2012,Starbucks Coffee,Eating Out,2,3016
2,1,2012,McDonalds,Eating Out,4,3012
3,1,2012,Wild Bean Cafe,Eating Out,2,3010
3,1,2012,Chicken Cottage,Eating Out,8,3002
5,1,2012,Caffe Nero,Eating Out,2,3000
5,1,2012,Greggs,Eating Out,5,2995
6,1,2012,Sainsburys,Groceries,67,2928
6,1,2012,Costa Coffee,Eating Out,2,2926
6,1,2012,Chicken Cottage,Eating Out,8,2918
6,1,2012,Pizza Express,Eating Out,52,2866
6,1,2012,ATM Cash Withdrawal,General,10,2856
7,1,2012,Cubit and West rent,Rent,440,2416
7,1,2012,Scott's Restaurant,Eating Out,30,2386
8,1,2012,ATM Cash Withdrawal,General,10,2376
9,1,2012,South West Trains,Transport,33,2343
9,1,2012,Caffe Nero,Eating Out,2,2341
10,1,2012,Costa Coffee,Eating Out,2,2339
10,1,2012,The West Cornwall Pasty Company,Eating Out,5,2334
11,1,2012,Costa Coffee,Eating Out,2,2332
11,1,2012,ATM Cash Withdrawal,General,20,2312
11,1,2012,Civic Shop,,7,2305
12,1,2012,Costa Coffee,Eating Out,1,2304
12,1,2012,Greggs,Eating Out,5,2299
13,1,2012,Morrisons,Groceries,39,2260
13,1,2012,Starbucks Coffee,Eating Out,1,2259
13,1,2012,Pret A Manger,Eating Out,6,2253
14,1,2012,ATM Cash Withdrawal,General,10,2243
15,1,2012,BRGAS-Electricity,Bills,46,2197
15,1,2012,BRGAS-Gas,Bills,45,2152
15,1,2012,Scott's Restaurant,Eating Out,40,2112
16,1,2012,LBS Council Tax,Bills,35,2077
16,1,2012,South West Trains,Transport,30,2047
16,1,2012,Costa Coffee,Eating Out,1,2046
16,1,2012,Greggs,Eating Out,8,2038
17,1,2012,Wild Bean Cafe,Eating Out,2,2036
17,1,2012,Greggs,Eating Out,7,2029
18,1,2012,Starbucks Coffee,Eating Out,2,2027
18,1,2012,Pret A Manger,Eating Out,5,2022
18,1,2012,Paying back James,,7,2015
19,1,2012,Caffe Nero,Eating Out,2,2013
19,1,2012,Paying back James,,2,2011
20,1,2012,VIRGIN MEDIA PYMTS,Bills,27,1984
20,1,2012,Tescos,Groceries,70,1914
20,1,2012,Costa Coffee,Eating Out,2,1912
23,1,2012,South West Trains,Transport,31,1881
23,1,2012,Starbucks Coffee,Eating Out,2,1879
23,1,2012,Pret A Manger,Eating Out,4,1875
24,1,2012,O2,Bills,31,1844
24,1,2012,Starbucks Coffee,Eating Out,1,1843
24,1,2012,Greggs,Eating Out,5,1838
24,1,2012,ATM Cash Withdrawal,General,20,1818
25,1,2012,Starbucks Coffee,Eating Out,1,1817
26,1,2012,Pret A Manger,Eating Out,4,1813
27,1,2012,ASDA,Groceries,65,1748
28,1,2012,Heaven Club,Eating Out,9,1739
28,1,2012,Heaven Club,Eating Out,13,1726
28,1,2012,Heaven Club,Eating Out,11,1715
28,1,2012,Tool Tec,,8,1707
29,1,2012,ATM Cash Withdrawal,General,20,1687
30,1,2012,South West Trains,Transport,38,1649
30,1,2012,Wild Bean Cafe,Eating Out,1,1648
30,1,2012,The West Cornwall Pasty Company,Eating Out,5,1643
30,1,2012,ATM Cash Withdrawal,General,10,1633
31,1,2012,Caffe Nero,Eating Out,2,1631
31,1,2012,The West Cornwall Pasty Company,Eating Out,6,1625
1,2,2012,Rhino Sports salary,General,1600,3225
1,2,2012,Wild Bean Cafe,Eating Out,2,3223
1,2,2012,Subway,Eating Out,5,3218
1,2,2012,ATM Cash Withdrawal,General,10,3208
1,2,2012,Paying back James,,4,3204
2,2,2012,Costa Coffee,Eating Out,2,3202
2,2,2012,Pret A Manger,Eating Out,4,3198
2,2,2012,Paying back James,,5,3193
3,2,2012,Morrisons,Groceries,45,3148
3,2,2012,Costa Coffee,Eating Out,2,3146
5,2,2012,Anglo restaurant,Eating Out,30,3116
5,2,2012,ATM Cash Withdrawal,General,20,3096
6,2,2012,South West Trains,Transport,38,3058
6,2,2012,Caffe Nero,Eating Out,1,3057
6,2,2012,Pret A Manger,Eating Out,4,3053
7,2,2012,Cubit and West rent,Rent,440,2613
7,2,2012,Costa Coffee,Eating Out,2,2611
7,2,2012,Paying back James,,1,2610
8,2,2012,Starbucks Coffee,Eating Out,2,2608
8,2,2012,Pret A Manger,Eating Out,5,2603
9,2,2012,Costa Coffee,Eating Out,1,2602
9,2,2012,ATM Cash Withdrawal,General,10,2592
10,2,2012,Morrisons,Groceries,40,2552
12,2,2012,Pizza Express,Eating Out,34,2518
13,2,2012,South West Trains,Transport,31,2487
13,2,2012,Starbucks Coffee,Eating Out,2,2485
13,2,2012,Pret A Manger,Eating Out,7,2478
13,2,2012,Tool Shop,,3,2475
14,2,2012,Costa Coffee,Eating Out,1,2474
14,2,2012,Subway,Eating Out,6,2468
14,2,2012,Tool Tec,,9,2459
15,2,2012,BRGAS-Electricity,Bills,18,2441
15,2,2012,BRGAS-Gas,Bills,27,2414
15,2,2012,Starbucks Coffee,Eating Out,2,2412
15,2,2012,McDonalds,Eating Out,5,2407
15,2,2012,ATM Cash Withdrawal,General,10,2397
16,2,2012,LBS Council Tax,Bills,35,2362
16,2,2012,Costa Coffee,Eating Out,2,2360
16,2,2012,Subway,Eating Out,6,2354
17,2,2012,Morrisons,Groceries,74,2280
17,2,2012,Caffe Nero,Eating Out,1,2279
17,2,2012,The West Cornwall Pasty Company,Eating Out,8,2271
17,2,2012,Pizza Express,Eating Out,25,2246
18,2,2012,Ministry of Sound ClubXOYO Club,Eating Out,16,2230
18,2,2012,Ministry of Sound ClubXOYO Club,Eating Out,14,2216
18,2,2012,Ministry of Sound ClubXOYO Club,Eating Out,9,2207
18,2,2012,ATM Cash Withdrawal,General,20,2187
20,2,2012,VIRGIN MEDIA PYMTS,Bills,36,2151
20,2,2012,South West Trains,Transport,36,2115
20,2,2012,Wild Bean Cafe,Eating Out,2,2113
20,2,2012,The West Cornwall Pasty Company,Eating Out,5,2108
20,2,2012,ATM Cash Withdrawal,General,20,2088
20,2,2012,Red Shop,,1,2087
21,2,2012,Caffe Nero,Eating Out,1,2086
22,2,2012,Costa Coffee,Eating Out,2,2084
23,2,2012,Caffe Nero,Eating Out,2,2082
23,2,2012,The West Cornwall Pasty Company,Eating Out,8,2074
24,2,2012,O2,Bills,29,2045
24,2,2012,Waitrose,Groceries,67,1978
24,2,2012,Caffe Nero,Eating Out,2,1976
24,2,2012,Chicken Cottage,Eating Out,5,1971
24,2,2012,Dominos Pizza,Eating Out,56,1915
25,2,2012,Ministry of Sound ClubXOYO Club,Eating Out,12,1903
25,2,2012,Ministry of Sound ClubXOYO Club,Eating Out,11,1892
25,2,2012,Ministry of Sound ClubXOYO Club,Eating Out,5,1887
25,2,2012,Ministry of Sound ClubXOYO Club,Eating Out,7,1880
25,2,2012,Ministry of Sound ClubXOYO Club,Eating Out,11,1869
25,2,2012,Ministry of Sound ClubXOYO Club,Eating Out,12,1857
25,2,2012,ATM Cash Withdrawal,General,20,1837
26,2,2012,ATM Cash Withdrawal,General,10,1827
27,2,2012,South West Trains,Transport,33,1794
27,2,2012,Caffe Nero,Eating Out,2,1792
27,2,2012,Chicken Cottage,Eating Out,4,1788
28,2,2012,Costa Coffee,Eating Out,2,1786
28,2,2012,McDonalds,Eating Out,7,1779
28,2,2012,ATM Cash Withdrawal,General,10,1769
29,2,2012,ATM Cash Withdrawal,General,10,1759
1,3,2012,Rhino Sports salary,General,1600,3359
1,3,2012,Starbucks Coffee,Eating Out,1,3358
2,3,2012,Morrisons,Groceries,48,3310
2,3,2012,Chicken Cottage,Eating Out,7,3303
2,3,2012,Restaurant Gordon RamsayPortland Restaurant,Eating Out,30,3273
2,3,2012,Tool Shop,,5,3268
3,3,2012,The Grand Pub,Eating Out,9,3259
3,3,2012,The Grand Pub,Eating Out,16,3243
3,3,2012,The Grand Pub,Eating Out,14,3229
3,3,2012,The Grand Pub,Eating Out,15,3214
3,3,2012,Pizza Express,Eating Out,30,3184
4,3,2012,Pizza Express,Eating Out,24,3160
5,3,2012,South West Trains,Transport,29,3131
5,3,2012,Caffe Nero,Eating Out,1,3130
5,3,2012,Subway,Eating Out,6,3124
6,3,2012,Wild Bean Cafe,Eating Out,2,3122
6,3,2012,Chicken Cottage,Eating Out,6,3116
6,3,2012,ATM Cash Withdrawal,General,10,3106
7,3,2012,Cubit and West rent,Rent,440,2666
7,3,2012,Wild Bean Cafe,Eating Out,2,2664
7,3,2012,Chicken Cottage,Eating Out,8,2656
8,3,2012,Starbucks Coffee,Eating Out,2,2654
8,3,2012,Paying back James,,8,2646
9,3,2012,Waitrose,Groceries,82,2564
9,3,2012,Wild Bean Cafe,Eating Out,2,2562
9,3,2012,McDonalds,Eating Out,7,2555
9,3,2012,Paying back Julie,,9,2546
10,3,2012,Scott's Restaurant,Eating Out,30,2516
12,3,2012,South West Trains,Transport,27,2489
12,3,2012,Caffe Nero,Eating Out,2,2487
12,3,2012,ATM Cash Withdrawal,General,10,2477
13,3,2012,Wild Bean Cafe,Eating Out,1,2476
13,3,2012,Cheam Service Station,,2,2474
14,3,2012,Caffe Nero,Eating Out,1,2473
14,3,2012,The West Cornwall Pasty Company,Eating Out,7,2466
15,3,2012,BRGAS-Electricity,Bills,36,2430
15,3,2012,BRGAS-Gas,Bills,18,2412
15,3,2012,Starbucks Coffee,Eating Out,2,2410
15,3,2012,Greggs,Eating Out,7,2403
16,3,2012,LBS Council Tax,Bills,35,2368
16,3,2012,Tescos,Groceries,78,2290
16,3,2012,Pret A Manger,Eating Out,4,2286
17,3,2012,Ministry of Sound ClubXOYO Club,Eating Out,5,2281
17,3,2012,Ministry of Sound ClubXOYO Club,Eating Out,13,2268
17,3,2012,Ministry of Sound ClubXOYO Club,Eating Out,10,2258
17,3,2012,Ministry of Sound ClubXOYO Club,Eating Out,7,2251
17,3,2012,Ministry of Sound ClubXOYO Club,Eating Out,16,2235
17,3,2012,Ministry of Sound ClubXOYO Club,Eating Out,5,2230
17,3,2012,Restaurant Gordon RamsayPortland Restaurant,Eating Out,33,2197
18,3,2012,Dominos Pizza,Eating Out,25,2172
19,3,2012,South West Trains,Transport,24,2148
19,3,2012,Costa Coffee,Eating Out,2,2146
19,3,2012,The West Cornwall Pasty Company,Eating Out,6,2140
19,3,2012,ATM Cash Withdrawal,General,20,2120
20,3,2012,VIRGIN MEDIA PYMTS,Bills,37,2083
20,3,2012,Caffe Nero,Eating Out,1,2082
20,3,2012,Greggs,Eating Out,8,2074
20,3,2012,ATM Cash Withdrawal,General,20,2054
20,3,2012,Paying back James,,9,2045
21,3,2012,Chicken Cottage,Eating Out,4,2041
22,3,2012,Wild Bean Cafe,Eating Out,2,2039
22,3,2012,McDonalds,Eating Out,7,2032
22,3,2012,ATM Cash Withdrawal,General,10,2022
23,3,2012,Morrisons,Groceries,79,1943
23,3,2012,Chicken Cottage,Eating Out,5,1938
23,3,2012,Fabric Club,Eating Out,8,1930
23,3,2012,Fabric Club,Eating Out,15,1915
23,3,2012,Fabric Club,Eating Out,5,1910
23,3,2012,Fabric Club,Eating Out,15,1895
23,3,2012,Fabric Club,Eating Out,13,1882
23,3,2012,Fabric Club,Eating Out,7,1875
23,3,2012,Scott's Restaurant,Eating Out,32,1843
24,3,2012,O2,Bills,26,1817
24,3,2012,Paying back Julie,,5,1812
25,3,2012,Red Shop,,2,1810
26,3,2012,South West Trains,Transport,35,1775
26,3,2012,Starbucks Coffee,Eating Out,2,1773
26,3,2012,Subway,Eating Out,7,1766
27,3,2012,Pret A Manger,Eating Out,4,1762
28,3,2012,Subway,Eating Out,5,1757
28,3,2012,ATM Cash Withdrawal,General,20,1737
30,3,2012,Morrisons,Groceries,50,1687
30,3,2012,Chicken Cottage,Eating Out,6,1681
30,3,2012,Scott's Restaurant,Eating Out,50,1631
30,3,2012,ATM Cash Withdrawal,General,20,1611
31,3,2012,Tool Tec,,2,1609
1,4,2012,Rhino Sports salary,General,1600,3209
1,4,2012,Restaurant Gordon RamsayPortland Restaurant,Eating Out,56,3153
1,4,2012,ATM Cash Withdrawal,General,20,3133
2,4,2012,South West Trains,Transport,33,3100
2,4,2012,Caffe Nero,Eating Out,1,3099
2,4,2012,Subway,Eating Out,5,3094
3,4,2012,The West Cornwall Pasty Company,Eating Out,4,3090
4,4,2012,Starbucks Coffee,Eating Out,2,3088
4,4,2012,The West Cornwall Pasty Company,Eating Out,8,3080
5,4,2012,Caffe Nero,Eating Out,2,3078
6,4,2012,ASDA,Groceries,63,3015
6,4,2012,Starbucks Coffee,Eating Out,2,3013
6,4,2012,Chicken Cottage,Eating Out,6,3007
6,4,2012,Anglo restaurant,Eating Out,46,2961
6,4,2012,ATM Cash Withdrawal,General,20,2941
7,4,2012,Cubit and West rent,Rent,440,2501
9,4,2012,South West Trains,Transport,38,2463
9,4,2012,McDonalds,Eating Out,7,2456
10,4,2012,Caffe Nero,Eating Out,2,2454
11,4,2012,Starbucks Coffee,Eating Out,2,2452
11,4,2012,ATM Cash Withdrawal,General,20,2432
12,4,2012,Wild Bean Cafe,Eating Out,1,2431
12,4,2012,Pret A Manger,Eating Out,8,2423
13,4,2012,Morrisons,Groceries,52,2371
13,4,2012,Wild Bean Cafe,Eating Out,1,2370
13,4,2012,McDonalds,Eating Out,5,2365
13,4,2012,Ministry of Sound ClubXOYO Club,Eating Out,7,2358
13,4,2012,Ministry of Sound ClubXOYO Club,Eating Out,15,2343
13,4,2012,Ministry of Sound ClubXOYO Club,Eating Out,13,2330
13,4,2012,Ministry of Sound ClubXOYO Club,Eating Out,7,2323
14,4,2012,Paying back James,,9,2314
15,4,2012,BRGAS-Electricity,Bills,23,2291
15,4,2012,BRGAS-Gas,Bills,19,2272
16,4,2012,LBS Council Tax,Bills,35,2237
16,4,2012,South West Trains,Transport,35,2202
16,4,2012,Costa Coffee,Eating Out,2,2200
16,4,2012,Pret A Manger,Eating Out,7,2193
17,4,2012,Starbucks Coffee,Eating Out,2,2191
17,4,2012,Pret A Manger,Eating Out,4,2187
18,4,2012,Pret A Manger,Eating Out,8,2179
18,4,2012,ATM Cash Withdrawal,General,20,2159
19,4,2012,Caffe Nero,Eating Out,2,2157
20,4,2012,VIRGIN MEDIA PYMTS,Bills,29,2128
20,4,2012,Waitrose,Groceries,43,2085
20,4,2012,Caffe Nero,Eating Out,2,2083
20,4,2012,Chicken Cottage,Eating Out,7,2076
20,4,2012,Heaven Club,Eating Out,13,2063
20,4,2012,Heaven Club,Eating Out,11,2052
20,4,2012,Heaven Club,Eating Out,9,2043
20,4,2012,Heaven Club,Eating Out,8,2035
20,4,2012,Heaven Club,Eating Out,10,2025
20,4,2012,Heaven Club,Eating Out,9,2016
21,4,2012,Fabric Club,Eating Out,15,2001
23,4,2012,South West Trains,Transport,27,1974
23,4,2012,Costa Coffee,Eating Out,2,1972
23,4,2012,ATM Cash Withdrawal,General,10,1962
24,4,2012,O2,Bills,27,1935
24,4,2012,Caffe Nero,Eating Out,2,1933
25,4,2012,Costa Coffee,Eating Out,1,1932
25,4,2012,Subway,Eating Out,5,1927
26,4,2012,Wild Bean Cafe,Eating Out,1,1926
26,4,2012,Subway,Eating Out,6,1920
27,4,2012,ASDA,Groceries,49,1871
27,4,2012,Costa Coffee,Eating Out,2,1869
29,4,2012,Anglo restaurant,Eating Out,27,1842
30,4,2012,South West Trains,Transport,38,1804
1,5,2012,Rhino Sports salary,General,1600,3404
1,5,2012,Costa Coffee,Eating Out,2,3402
1,5,2012,Pret A Manger,Eating Out,8,3394
2,5,2012,Costa Coffee,Eating Out,2,3392
2,5,2012,Pret A Manger,Eating Out,7,3385
3,5,2012,Starbucks Coffee,Eating Out,2,3383
3,5,2012,Greggs,Eating Out,7,3376
3,5,2012,ATM Cash Withdrawal,General,20,3356
4,5,2012,Tescos,Groceries,59,3297
4,5,2012,Heaven Club,Eating Out,9,3288
4,5,2012,Heaven Club,Eating Out,6,3282
4,5,2012,Heaven Club,Eating Out,8,3274
5,5,2012,Anglo restaurant,Eating Out,35,3239
6,5,2012,ATM Cash Withdrawal,General,10,3229
7,5,2012,Cubit and West rent,Rent,440,2789
7,5,2012,South West Trains,Transport,25,2764
8,5,2012,The West Cornwall Pasty Company,Eating Out,8,2756
8,5,2012,Tool Tec,,7,2749
9,5,2012,Caffe Nero,Eating Out,1,2748
9,5,2012,McDonalds,Eating Out,8,2740
10,5,2012,Wild Bean Cafe,Eating Out,2,2738
10,5,2012,The West Cornwall Pasty Company,Eating Out,8,2730
11,5,2012,Morrisons,Groceries,53,2677
11,5,2012,Caffe Nero,Eating Out,1,2676
11,5,2012,Dominos Pizza,Eating Out,32,2644
11,5,2012,ATM Cash Withdrawal,General,20,2624
11,5,2012,Paying back James,,1,2623
12,5,2012,ATM Cash Withdrawal,General,20,2603
13,5,2012,Pizza Express,Eating Out,59,2544
14,5,2012,South West Trains,Transport,31,2513
14,5,2012,Caffe Nero,Eating Out,1,2512
15,5,2012,BRGAS-Electricity,Bills,30,2482
15,5,2012,BRGAS-Gas,Bills,27,2455
15,5,2012,Starbucks Coffee,Eating Out,1,2454
15,5,2012,ATM Cash Withdrawal,General,20,2434
16,5,2012,LBS Council Tax,Bills,35,2399
16,5,2012,Costa Coffee,Eating Out,2,2397
17,5,2012,Wild Bean Cafe,Eating Out,2,2395
18,5,2012,Waitrose,Groceries,64,2331
18,5,2012,ATM Cash Withdrawal,General,10,2321
20,5,2012,VIRGIN MEDIA PYMTS,Bills,37,2284
21,5,2012,South West Trains,Transport,35,2249
21,5,2012,Wild Bean Cafe,Eating Out,1,2248
21,5,2012,McDonalds,Eating Out,7,2241
21,5,2012,ATM Cash Withdrawal,General,10,2231
22,5,2012,Caffe Nero,Eating Out,1,2230
23,5,2012,Wild Bean Cafe,Eating Out,1,2229
24,5,2012,O2,Bills,27,2202
24,5,2012,Wild Bean Cafe,Eating Out,2,2200
24,5,2012,The West Cornwall Pasty Company,Eating Out,4,2196
25,5,2012,Tescos,Groceries,70,2126
25,5,2012,Pret A Manger,Eating Out,6,2120
25,5,2012,ATM Cash Withdrawal,General,20,2100
25,5,2012,Tool Tec,,7,2093
27,5,2012,Anglo restaurant,Eating Out,56,2037
27,5,2012,Paying back Julie,,9,2028
28,5,2012,South West Trains,Transport,26,2002
28,5,2012,Costa Coffee,Eating Out,2,2000
28,5,2012,Chicken Cottage,Eating Out,8,1992
28,5,2012,ATM Cash Withdrawal,General,20,1972
29,5,2012,Starbucks Coffee,Eating Out,2,1970
29,5,2012,ATM Cash Withdrawal,General,20,1950
30,5,2012,Starbucks Coffee,Eating Out,2,1948
30,5,2012,McDonalds,Eating Out,7,1941
31,5,2012,Costa Coffee,Eating Out,1,1940
1,6,2012,Rhino Sports salary,General,1600,3540
1,6,2012,Tescos,Groceries,78,3462
1,6,2012,Wild Bean Cafe,Eating Out,1,3461
1,6,2012,Pret A Manger,Eating Out,5,3456
2,6,2012,ATM Cash Withdrawal,General,20,3436
2,6,2012,Tool Tec,,3,3433
3,6,2012,Dominos Pizza,Eating Out,49,3384
4,6,2012,South West Trains,Transport,27,3357
4,6,2012,Costa Coffee,Eating Out,1,3356
4,6,2012,Subway,Eating Out,6,3350
4,6,2012,ATM Cash Withdrawal,General,10,3340
5,6,2012,Wild Bean Cafe,Eating Out,2,3338
5,6,2012,Pret A Manger,Eating Out,4,3334
5,6,2012,ATM Cash Withdrawal,General,10,3324
6,6,2012,Greggs,Eating Out,5,3319
7,6,2012,Cubit and West rent,Rent,440,2879
7,6,2012,Wild Bean Cafe,Eating Out,2,2877
7,6,2012,Subway,Eating Out,8,2869
8,6,2012,Tescos,Groceries,45,2824
8,6,2012,Starbucks Coffee,Eating Out,1,2823
8,6,2012,Heaven Club,Eating Out,6,2817
8,6,2012,Heaven Club,Eating Out,13,2804
8,6,2012,Tool Shop,,2,2802
10,6,2012,Restaurant Gordon RamsayPortland Restaurant,Eating Out,52,2750
10,6,2012,Paying back James,,6,2744
11,6,2012,South West Trains,Transport,38,2706
11,6,2012,Chicken Cottage,Eating Out,5,2701
12,6,2012,Subway,Eating Out,6,2695
13,6,2012,ATM Cash Withdrawal,General,20,2675
14,6,2012,ATM Cash Withdrawal,General,10,2665
15,6,2012,BRGAS-Electricity,Bills,22,2643
15,6,2012,BRGAS-Gas,Bills,36,2607
15,6,2012,Waitrose,Groceries,71,2536
15,6,2012,Costa Coffee,Eating Out,2,2534
15,6,2012,The West Cornwall Pasty Company,Eating Out,6,2528
15,6,2012,Fabric Club,Eating Out,6,2522
15,6,2012,Fabric Club,Eating Out,12,2510
15,6,2012,Fabric Club,Eating Out,10,2500
15,6,2012,Dominos Pizza,Eating Out,30,2470
16,6,2012,LBS Council Tax,Bills,35,2435
16,6,2012,Anglo restaurant,Eating Out,55,2380
16,6,2012,ATM Cash Withdrawal,General,10,2370
17,6,2012,Red Shop,,6,2364
18,6,2012,South West Trains,Transport,27,2337
18,6,2012,Costa Coffee,Eating Out,2,2335
18,6,2012,Subway,Eating Out,4,2331
19,6,2012,Starbucks Coffee,Eating Out,1,2330
19,6,2012,The West Cornwall Pasty Company,Eating Out,8,2322
20,6,2012,VIRGIN MEDIA PYMTS,Bills,25,2297
20,6,2012,Wild Bean Cafe,Eating Out,1,2296
21,6,2012,Greggs,Eating Out,7,2289
22,6,2012,Morrisons,Groceries,70,2219
22,6,2012,Pret A Manger,Eating Out,8,2211
22,6,2012,Ministry of Sound ClubXOYO Club,Eating Out,7,2204
22,6,2012,Ministry of Sound ClubXOYO Club,Eating Out,12,2192
22,6,2012,Ministry of Sound ClubXOYO Club,Eating Out,5,2187
22,6,2012,Cheam Service Station,,6,2181
24,6,2012,O2,Bills,28,2153
24,6,2012,Restaurant Gordon RamsayPortland Restaurant,Eating Out,31,2122
25,6,2012,South West Trains,Transport,29,2093
25,6,2012,Wild Bean Cafe,Eating Out,1,2092
25,6,2012,Subway,Eating Out,7,2085
26,6,2012,Wild Bean Cafe,Eating Out,2,2083
26,6,2012,Subway,Eating Out,7,2076
27,6,2012,Caffe Nero,Eating Out,1,2075
27,6,2012,The West Cornwall Pasty Company,Eating Out,6,2069
28,6,2012,Wild Bean Cafe,Eating Out,2,2067
28,6,2012,Subway,Eating Out,6,2061
28,6,2012,ATM Cash Withdrawal,General,10,2051
28,6,2012,Tool Shop,,1,2050
29,6,2012,Waitrose,Groceries,55,1995
29,6,2012,Caffe Nero,Eating Out,2,1993
29,6,2012,Pret A Manger,Eating Out,8,1985
29,6,2012,Heaven Club,Eating Out,5,1980
29,6,2012,Heaven Club,Eating Out,15,1965
29,6,2012,Heaven Club,Eating Out,12,1953
29,6,2012,Heaven Club,Eating Out,6,1947
29,6,2012,Restaurant Gordon RamsayPortland Restaurant,Eating Out,47,1900
1,7,2012,Rhino Sports salary,General,1600,3500
2,7,2012,South West Trains,Transport,31,3469
2,7,2012,Costa Coffee,Eating Out,2,3467
2,7,2012,Greggs,Eating Out,7,3460
2,7,2012,ATM Cash Withdrawal,General,20,3440
3,7,2012,Costa Coffee,Eating Out,2,3438
3,7,2012,Chicken Cottage,Eating Out,8,3430
4,7,2012,Costa Coffee,Eating Out,2,3428
4,7,2012,ATM Cash Withdrawal,General,10,3418
5,7,2012,Caffe Nero,Eating Out,2,3416
5,7,2012,Subway,Eating Out,4,3412
6,7,2012,Waitrose,Groceries,61,3351
6,7,2012,Starbucks Coffee,Eating Out,2,3349
6,7,2012,Chicken Cottage,Eating Out,6,3343
7,7,2012,Cubit and West rent,Rent,440,2903
7,7,2012,ATM Cash Withdrawal,General,20,2883
8,7,2012,Anglo restaurant,Eating Out,48,2835
9,7,2012,South West Trains,Transport,26,2809
9,7,2012,The West Cornwall Pasty Company,Eating Out,6,2803
10,7,2012,Wild Bean Cafe,Eating Out,1,2802
10,7,2012,The West Cornwall Pasty Company,Eating Out,8,2794
10,7,2012,ATM Cash Withdrawal,General,20,2774
11,7,2012,Starbucks Coffee,Eating Out,2,2772
11,7,2012,Subway,Eating Out,6,2766
12,7,2012,Wild Bean Cafe,Eating Out,1,2765
12,7,2012,ATM Cash Withdrawal,General,20,2745
13,7,2012,Tescos,Groceries,44,2701
13,7,2012,Starbucks Coffee,Eating Out,1,2700
13,7,2012,Scott's Restaurant,Eating Out,54,2646
14,7,2012,Scott's Restaurant,Eating Out,32,2614
15,7,2012,BRGAS-Electricity,Bills,34,2580
15,7,2012,BRGAS-Gas,Bills,32,2548
16,7,2012,LBS Council Tax,Bills,35,2513
16,7,2012,South West Trains,Transport,38,2475
16,7,2012,Subway,Eating Out,6,2469
17,7,2012,Greggs,Eating Out,5,2464
18,7,2012,Caffe Nero,Eating Out,2,2462
19,7,2012,Costa Coffee,Eating Out,1,2461
20,7,2012,VIRGIN MEDIA PYMTS,Bills,26,2435
20,7,2012,Waitrose,Groceries,58,2377
20,7,2012,Wild Bean Cafe,Eating Out,2,2375
20,7,2012,The West Cornwall Pasty Company,Eating Out,6,2369
21,7,2012,Dominos Pizza,Eating Out,47,2322
21,7,2012,Tool Shop,,5,2317
23,7,2012,South West Trains,Transport,26,2291
23,7,2012,Starbucks Coffee,Eating Out,2,2289
24,7,2012,O2,Bills,26,2263
24,7,2012,Costa Coffee,Eating Out,2,2261
25,7,2012,Starbucks Coffee,Eating Out,2,2259
26,7,2012,Pret A Manger,Eating Out,5,2254
27,7,2012,Morrisons,Groceries,70,2184
27,7,2012,Costa Coffee,Eating Out,2,2182
27,7,2012,Pret A Manger,Eating Out,8,2174
27,7,2012,Fabric Club,Eating Out,11,2163
27,7,2012,Fabric Club,Eating Out,8,2155
27,7,2012,ATM Cash Withdrawal,General,10,2145
28,7,2012,ATM Cash Withdrawal,General,20,2125
30,7,2012,South West Trains,Transport,35,2090
30,7,2012,Caffe Nero,Eating Out,1,2089
30,7,2012,Subway,Eating Out,8,2081
31,7,2012,Caffe Nero,Eating Out,1,2080
1,8,2012,Rhino Sports salary,General,1600,3680
1,8,2012,Costa Coffee,Eating Out,2,3678
2,8,2012,ATM Cash Withdrawal,General,10,3668
3,8,2012,Sainsburys,Groceries,80,3588
3,8,2012,Starbucks Coffee,Eating Out,1,3587
3,8,2012,Subway,Eating Out,7,3580
4,8,2012,Restaurant Gordon RamsayPortland Restaurant,Eating Out,47,3533
5,8,2012,Scott's Restaurant,Eating Out,44,3489
5,8,2012,ATM Cash Withdrawal,General,10,3479
6,8,2012,South West Trains,Transport,32,3447
6,8,2012,Caffe Nero,Eating Out,2,3445
6,8,2012,The West Cornwall Pasty Company,Eating Out,8,3437
6,8,2012,ATM Cash Withdrawal,General,20,3417
7,8,2012,Cubit and West rent,Rent,440,2977
7,8,2012,Caffe Nero,Eating Out,1,2976
7,8,2012,Chicken Cottage,Eating Out,4,2972
8,8,2012,Caffe Nero,Eating Out,2,2970
9,8,2012,Costa Coffee,Eating Out,1,2969
10,8,2012,Tescos,Groceries,40,2929
10,8,2012,Wild Bean Cafe,Eating Out,2,2927
10,8,2012,Anglo restaurant,Eating Out,39,2888
11,8,2012,Pizza Express,Eating Out,41,2847
11,8,2012,Red Shop,,4,2843
12,8,2012,ATM Cash Withdrawal,General,10,2833
13,8,2012,South West Trains,Transport,38,2795
13,8,2012,Caffe Nero,Eating Out,2,2793
14,8,2012,Caffe Nero,Eating Out,1,2792
14,8,2012,Greggs,Eating Out,4,2788
14,8,2012,ATM Cash Withdrawal,General,10,2778
15,8,2012,BRGAS-Electricity,Bills,25,2753
15,8,2012,BRGAS-Gas,Bills,34,2719
15,8,2012,ATM Cash Withdrawal,General,20,2699
16,8,2012,LBS Council Tax,Bills,35,2664
16,8,2012,Chicken Cottage,Eating Out,7,2657
16,8,2012,Cheam Service Station,,7,2650
17,8,2012,ASDA,Groceries,49,2601
17,8,2012,Costa Coffee,Eating Out,1,2600
17,8,2012,Restaurant Gordon RamsayPortland Restaurant,Eating Out,37,2563
17,8,2012,ATM Cash Withdrawal,General,10,2553
18,8,2012,Anglo restaurant,Eating Out,40,2513
18,8,2012,ATM Cash Withdrawal,General,20,2493
19,8,2012,Dominos Pizza,Eating Out,53,2440
20,8,2012,VIRGIN MEDIA PYMTS,Bills,23,2417
20,8,2012,South West Trains,Transport,35,2382
20,8,2012,Caffe Nero,Eating Out,1,2381
21,8,2012,Wild Bean Cafe,Eating Out,1,2380
21,8,2012,ATM Cash Withdrawal,General,10,2370
22,8,2012,Wild Bean Cafe,Eating Out,2,2368
22,8,2012,ATM Cash Withdrawal,General,10,2358
22,8,2012,Tool Tec,,6,2352
23,8,2012,Greggs,Eating Out,5,2347
24,8,2012,O2,Bills,30,2317
24,8,2012,Tescos,Groceries,73,2244
24,8,2012,Caffe Nero,Eating Out,2,2242
25,8,2012,The Grand Pub,Eating Out,12,2230
25,8,2012,The Grand Pub,Eating Out,10,2220
25,8,2012,The Grand Pub,Eating Out,6,2214
27,8,2012,South West Trains,Transport,34,2180
27,8,2012,Costa Coffee,Eating Out,1,2179
27,8,2012,The West Cornwall Pasty Company,Eating Out,8,2171
27,8,2012,ATM Cash Withdrawal,General,10,2161
27,8,2012,Cheam Service Station,,3,2158
28,8,2012,Caffe Nero,Eating Out,2,2156
29,8,2012,Wild Bean Cafe,Eating Out,2,2154
30,8,2012,Starbucks Coffee,Eating Out,2,2152
30,8,2012,Pret A Manger,Eating Out,6,2146
30,8,2012,Paying back James,,4,2142
31,8,2012,Tescos,Groceries,80,2062
31,8,2012,Caffe Nero,Eating Out,2,2060
31,8,2012,McDonalds,Eating Out,6,2054
31,8,2012,ATM Cash Withdrawal,General,10,2044
1,9,2012,Rhino Sports salary,General,1600,3644
1,9,2012,Pizza Express,Eating Out,39,3605
1,9,2012,Paying back Julie,,8,3597
2,9,2012,Civic Shop,,4,3593
3,9,2012,South West Trains,Transport,32,3561
3,9,2012,Caffe Nero,Eating Out,2,3559
3,9,2012,McDonalds,Eating Out,4,3555
3,9,2012,Tool Tec,,4,3551
4,9,2012,Costa Coffee,Eating Out,2,3549
4,9,2012,Pret A Manger,Eating Out,5,3544
4,9,2012,Tool Tec,,2,3542
5,9,2012,Starbucks Coffee,Eating Out,1,3541
5,9,2012,McDonalds,Eating Out,7,3534
6,9,2012,Starbucks Coffee,Eating Out,2,3532
6,9,2012,Chicken Cottage,Eating Out,7,3525
6,9,2012,Cheam Service Station,,4,3521
7,9,2012,Cubit and West rent,Rent,440,3081
7,9,2012,Tescos,Groceries,75,3006
7,9,2012,Wild Bean Cafe,Eating Out,2,3004
7,9,2012,The West Cornwall Pasty Company,Eating Out,8,2996
8,9,2012,Restaurant Gordon RamsayPortland Restaurant,Eating Out,32,2964
8,9,2012,Cheam Service Station,,6,2958
10,9,2012,South West Trains,Transport,25,2933
10,9,2012,Costa Coffee,Eating Out,2,2931
10,9,2012,Chicken Cottage,Eating Out,4,2927
10,9,2012,ATM Cash Withdrawal,General,20,2907
10,9,2012,Cheam Service Station,,4,2903
11,9,2012,Starbucks Coffee,Eating Out,1,2902
11,9,2012,Subway,Eating Out,8,2894
11,9,2012,ATM Cash Withdrawal,General,20,2874
12,9,2012,Caffe Nero,Eating Out,1,2873
12,9,2012,Greggs,Eating Out,4,2869
12,9,2012,Paying back Julie,,2,2867
13,9,2012,Starbucks Coffee,Eating Out,2,2865
13,9,2012,Greggs,Eating Out,7,2858
14,9,2012,Morrisons,Groceries,45,2813
14,9,2012,Starbucks Coffee,Eating Out,2,2811
14,9,2012,Pret A Manger,Eating Out,6,2805
14,9,2012,ATM Cash Withdrawal,General,10,2795
15,9,2012,BRGAS-Electricity,Bills,26,2769
15,9,2012,BRGAS-Gas,Bills,33,2736
15,9,2012,Pizza Express,Eating Out,52,2684
16,9,2012,LBS Council Tax,Bills,35,2649
17,9,2012,South West Trains,Transport,34,2615
17,9,2012,Costa Coffee,Eating Out,1,2614
17,9,2012,McDonalds,Eating Out,4,2610
18,9,2012,Starbucks Coffee,Eating Out,2,2608
18,9,2012,ATM Cash Withdrawal,General,20,2588
19,9,2012,Subway,Eating Out,8,2580
20,9,2012,VIRGIN MEDIA PYMTS,Bills,43,2537
20,9,2012,Wild Bean Cafe,Eating Out,2,2535
20,9,2012,Chicken Cottage,Eating Out,6,2529
21,9,2012,Tescos,Groceries,49,2480
21,9,2012,Costa Coffee,Eating Out,1,2479
21,9,2012,ATM Cash Withdrawal,General,10,2469
23,9,2012,Scott's Restaurant,Eating Out,42,2427
24,9,2012,O2,Bills,27,2400
24,9,2012,South West Trains,Transport,38,2362
24,9,2012,Wild Bean Cafe,Eating Out,1,2361
24,9,2012,Pret A Manger,Eating Out,5,2356
25,9,2012,ATM Cash Withdrawal,General,10,2346
26,9,2012,Tool Tec,,9,2337
27,9,2012,Red Shop,,4,2333
28,9,2012,Morrisons,Groceries,39,2294
28,9,2012,Pizza Express,Eating Out,40,2254
29,9,2012,ATM Cash Withdrawal,General,10,2244
30,9,2012,Pizza Express,Eating Out,35,2209
1,10,2012,Rhino Sports salary,General,1600,3809
1,10,2012,South West Trains,Transport,36,3773
1,10,2012,Starbucks Coffee,Eating Out,1,3772
1,10,2012,Cheam Service Station,,6,3766
3,10,2012,Wild Bean Cafe,Eating Out,2,3764
3,10,2012,Subway,Eating Out,8,3756
3,10,2012,ATM Cash Withdrawal,General,10,3746
3,10,2012,Civic Shop,,9,3737
4,10,2012,Caffe Nero,Eating Out,1,3736
4,10,2012,McDonalds,Eating Out,6,3730
4,10,2012,ATM Cash Withdrawal,General,10,3720
5,10,2012,ASDA,Groceries,65,3655
5,10,2012,Caffe Nero,Eating Out,2,3653
5,10,2012,Pret A Manger,Eating Out,5,3648
5,10,2012,Ministry of Sound ClubXOYO Club,Eating Out,14,3634
5,10,2012,Ministry of Sound ClubXOYO Club,Eating Out,13,3621
5,10,2012,Ministry of Sound ClubXOYO Club,Eating Out,11,3610
5,10,2012,Ministry of Sound ClubXOYO Club,Eating Out,16,3594
5,10,2012,Ministry of Sound ClubXOYO Club,Eating Out,15,3579
5,10,2012,Ministry of Sound ClubXOYO Club,Eating Out,7,3572
5,10,2012,ATM Cash Withdrawal,General,10,3562
6,10,2012,ATM Cash Withdrawal,General,20,3542
7,10,2012,Cubit and West rent,Rent,440,3102
8,10,2012,South West Trains,Transport,35,3067
8,10,2012,Starbucks Coffee,Eating Out,2,3065
8,10,2012,McDonalds,Eating Out,7,3058
9,10,2012,Subway,Eating Out,8,3050
9,10,2012,ATM Cash Withdrawal,General,10,3040
10,10,2012,Starbucks Coffee,Eating Out,2,3038
11,10,2012,Wild Bean Cafe,Eating Out,2,3036
11,10,2012,Cheam Service Station,,9,3027
12,10,2012,Morrisons,Groceries,51,2976
12,10,2012,Restaurant Gordon RamsayPortland Restaurant,Eating Out,33,2943
13,10,2012,ATM Cash Withdrawal,General,20,2923
14,10,2012,Restaurant Gordon RamsayPortland Restaurant,Eating Out,36,2887
15,10,2012,BRGAS-Electricity,Bills,36,2851
15,10,2012,BRGAS-Gas,Bills,19,2832
15,10,2012,South West Trains,Transport,33,2799
15,10,2012,Wild Bean Cafe,Eating Out,2,2797
16,10,2012,LBS Council Tax,Bills,35,2762
16,10,2012,Wild Bean Cafe,Eating Out,1,2761
16,10,2012,Subway,Eating Out,6,2755
17,10,2012,Wild Bean Cafe,Eating Out,2,2753
17,10,2012,ATM Cash Withdrawal,General,10,2743
18,10,2012,Paying back Julie,,5,2738
19,10,2012,Tescos,Groceries,52,2686
19,10,2012,Caffe Nero,Eating Out,1,2685
19,10,2012,Subway,Eating Out,4,2681
19,10,2012,ATM Cash Withdrawal,General,20,2661
20,10,2012,VIRGIN MEDIA PYMTS,Bills,41,2620
22,10,2012,South West Trains,Transport,31,2589
22,10,2012,Wild Bean Cafe,Eating Out,2,2587
22,10,2012,Greggs,Eating Out,7,2580
23,10,2012,Starbucks Coffee,Eating Out,2,2578
23,10,2012,ATM Cash Withdrawal,General,10,2568
24,10,2012,O2,Bills,27,2541
24,10,2012,Caffe Nero,Eating Out,2,2539
24,10,2012,Greggs,Eating Out,8,2531
24,10,2012,ATM Cash Withdrawal,General,20,2511
25,10,2012,Wild Bean Cafe,Eating Out,1,2510
25,10,2012,Chicken Cottage,Eating Out,5,2505
26,10,2012,Waitrose,Groceries,78,2427
26,10,2012,Caffe Nero,Eating Out,2,2425
26,10,2012,Chicken Cottage,Eating Out,8,2417
26,10,2012,Ministry of Sound ClubXOYO Club,Eating Out,12,2405
26,10,2012,Ministry of Sound ClubXOYO Club,Eating Out,16,2389
26,10,2012,Ministry of Sound ClubXOYO Club,Eating Out,5,2384
26,10,2012,Ministry of Sound ClubXOYO Club,Eating Out,9,2375
26,10,2012,Scott's Restaurant,Eating Out,34,2341
26,10,2012,Tool Tec,,3,2338
27,10,2012,Fabric Club,Eating Out,11,2327
27,10,2012,ATM Cash Withdrawal,General,20,2307
29,10,2012,South West Trains,Transport,25,2282
29,10,2012,Wild Bean Cafe,Eating Out,2,2280
30,10,2012,Caffe Nero,Eating Out,1,2279
30,10,2012,Tool Shop,,9,2270
31,10,2012,Chicken Cottage,Eating Out,5,2265
31,10,2012,ATM Cash Withdrawal,General,20,2245
1,11,2012,Rhino Sports salary,General,1600,3845
1,11,2012,Costa Coffee,Eating Out,1,3844
2,11,2012,Morrisons,Groceries,60,3784
2,11,2012,Caffe Nero,Eating Out,1,3783
2,11,2012,Pret A Manger,Eating Out,4,3779
2,11,2012,Scott's Restaurant,Eating Out,40,3739
2,11,2012,ATM Cash Withdrawal,General,10,3729
2,11,2012,Tool Tec,,2,3727
3,11,2012,Scott's Restaurant,Eating Out,27,3700
4,11,2012,Paying back James,,5,3695
5,11,2012,South West Trains,Transport,29,3666
5,11,2012,Starbucks Coffee,Eating Out,2,3664
5,11,2012,McDonalds,Eating Out,6,3658
6,11,2012,Starbucks Coffee,Eating Out,2,3656
6,11,2012,Greggs,Eating Out,6,3650
7,11,2012,Cubit and West rent,Rent,440,3210
7,11,2012,Starbucks Coffee,Eating Out,2,3208
7,11,2012,McDonalds,Eating Out,7,3201
8,11,2012,Wild Bean Cafe,Eating Out,2,3199
8,11,2012,Pret A Manger,Eating Out,4,3195
9,11,2012,Waitrose,Groceries,79,3116
9,11,2012,Caffe Nero,Eating Out,2,3114
9,11,2012,The Grand Pub,Eating Out,12,3102
9,11,2012,The Grand Pub,Eating Out,13,3089
9,11,2012,The Grand Pub,Eating Out,5,3084
9,11,2012,The Grand Pub,Eating Out,6,3078
9,11,2012,The Grand Pub,Eating Out,5,3073
9,11,2012,The Grand Pub,Eating Out,7,3066
11,11,2012,Dominos Pizza,Eating Out,37,3029
11,11,2012,ATM Cash Withdrawal,General,20,3009
12,11,2012,South West Trains,Transport,38,2971
12,11,2012,The West Cornwall Pasty Company,Eating Out,8,2963
13,11,2012,Starbucks Coffee,Eating Out,1,2962
13,11,2012,McDonalds,Eating Out,4,2958
14,11,2012,Starbucks Coffee,Eating Out,1,2957
14,11,2012,Greggs,Eating Out,7,2950
15,11,2012,BRGAS-Electricity,Bills,50,2900
15,11,2012,BRGAS-Gas,Bills,60,2840
15,11,2012,ATM Cash Withdrawal,General,20,2820
16,11,2012,LBS Council Tax,Bills,35,2785
16,11,2012,ASDA,Groceries,45,2740
16,11,2012,Subway,Eating Out,7,2733
16,11,2012,ATM Cash Withdrawal,General,10,2723
17,11,2012,ATM Cash Withdrawal,General,20,2703
17,11,2012,Civic Shop,,1,2702
18,11,2012,Anglo restaurant,Eating Out,58,2644
19,11,2012,South West Trains,Transport,29,2615
19,11,2012,The West Cornwall Pasty Company,Eating Out,6,2609
20,11,2012,VIRGIN MEDIA PYMTS,Bills,35,2574
20,11,2012,Starbucks Coffee,Eating Out,2,2572
20,11,2012,McDonalds,Eating Out,6,2566
21,11,2012,Starbucks Coffee,Eating Out,1,2565
21,11,2012,ATM Cash Withdrawal,General,20,2545
22,11,2012,Pret A Manger,Eating Out,6,2539
22,11,2012,ATM Cash Withdrawal,General,10,2529
23,11,2012,Waitrose,Groceries,65,2464
23,11,2012,Pret A Manger,Eating Out,4,2460
23,11,2012,Dominos Pizza,Eating Out,53,2407
24,11,2012,O2,Bills,29,2378
24,11,2012,Scott's Restaurant,Eating Out,57,2321
24,11,2012,ATM Cash Withdrawal,General,10,2311
24,11,2012,Civic Shop,,1,2310
25,11,2012,ATM Cash Withdrawal,General,10,2300
25,11,2012,Tool Tec,,6,2294
26,11,2012,South West Trains,Transport,30,2264
26,11,2012,Starbucks Coffee,Eating Out,2,2262
26,11,2012,Pret A Manger,Eating Out,7,2255
26,11,2012,ATM Cash Withdrawal,General,10,2245
27,11,2012,Caffe Nero,Eating Out,2,2243
27,11,2012,The West Cornwall Pasty Company,Eating Out,4,2239
28,11,2012,ATM Cash Withdrawal,General,10,2229
28,11,2012,Paying back Julie,,3,2226
29,11,2012,Wild Bean Cafe,Eating Out,2,2224
29,11,2012,ATM Cash Withdrawal,General,10,2214
30,11,2012,ASDA,Groceries,50,2164
30,11,2012,Starbucks Coffee,Eating Out,2,2162
30,11,2012,Fabric Club,Eating Out,6,2156
30,11,2012,Fabric Club,Eating Out,8,2148
30,11,2012,Fabric Club,Eating Out,12,2136
30,11,2012,Anglo restaurant,Eating Out,26,2110
1,12,2012,Rhino Sports salary,General,1600,3710
1,12,2012,ATM Cash Withdrawal,General,20,3690
1,12,2012,Paying back James,,6,3684
3,12,2012,South West Trains,Transport,32,3652
3,12,2012,Greggs,Eating Out,8,3644
4,12,2012,Caffe Nero,Eating Out,2,3642
4,12,2012,Chicken Cottage,Eating Out,6,3636
5,12,2012,ATM Cash Withdrawal,General,10,3626
6,12,2012,Wild Bean Cafe,Eating Out,2,3624
6,12,2012,The West Cornwall Pasty Company,Eating Out,6,3618
7,12,2012,Cubit and West rent,Rent,440,3178
7,12,2012,Sainsburys,Groceries,58,3120
7,12,2012,Wild Bean Cafe,Eating Out,1,3119
7,12,2012,McDonalds,Eating Out,4,3115
7,12,2012,Scott's Restaurant,Eating Out,29,3086
9,12,2012,Red Shop,,7,3079
10,12,2012,South West Trains,Transport,36,3043
11,12,2012,Pret A Manger,Eating Out,6,3037
12,12,2012,Wild Bean Cafe,Eating Out,2,3035
13,12,2012,Caffe Nero,Eating Out,2,3033
14,12,2012,Tescos,Groceries,54,2979
14,12,2012,Wild Bean Cafe,Eating Out,1,2978
14,12,2012,The West Cornwall Pasty Company,Eating Out,5,2973
15,12,2012,BRGAS-Electricity,Bills,32,2941
15,12,2012,BRGAS-Gas,Bills,32,2909
15,12,2012,Scott's Restaurant,Eating Out,45,2864
16,12,2012,LBS Council Tax,Bills,35,2829
16,12,2012,Restaurant Gordon RamsayPortland Restaurant,Eating Out,46,2783
16,12,2012,ATM Cash Withdrawal,General,10,2773
16,12,2012,Tool Shop,,7,2766
17,12,2012,South West Trains,Transport,26,2740
17,12,2012,Costa Coffee,Eating Out,1,2739
17,12,2012,The West Cornwall Pasty Company,Eating Out,6,2733
18,12,2012,Wild Bean Cafe,Eating Out,2,2731
18,12,2012,McDonalds,Eating Out,7,2724
18,12,2012,Civic Shop,,1,2723
19,12,2012,Wild Bean Cafe,Eating Out,1,2722
20,12,2012,VIRGIN MEDIA PYMTS,Bills,30,2692
20,12,2012,Wild Bean Cafe,Eating Out,2,2690
20,12,2012,ATM Cash Withdrawal,General,20,2670
21,12,2012,Tescos,Groceries,68,2602
21,12,2012,Wild Bean Cafe,Eating Out,2,2600
21,12,2012,The Grand Pub,Eating Out,6,2594
21,12,2012,The Grand Pub,Eating Out,5,2589
21,12,2012,The Grand Pub,Eating Out,11,2578
21,12,2012,The Grand Pub,Eating Out,10,2568
21,12,2012,The Grand Pub,Eating Out,11,2557
21,12,2012,The Grand Pub,Eating Out,14,2543
21,12,2012,Dominos Pizza,Eating Out,51,2492
22,12,2012,ATM Cash Withdrawal,General,20,2472
23,12,2012,ATM Cash Withdrawal,General,10,2462
24,12,2012,O2,Bills,31,2431
24,12,2012,South West Trains,Transport,36,2395
24,12,2012,Chicken Cottage,Eating Out,7,2388
24,12,2012,ATM Cash Withdrawal,General,10,2378
24,12,2012,Cheam Service Station,,4,2374
25,12,2012,Wild Bean Cafe,Eating Out,2,2372
25,12,2012,The West Cornwall Pasty Company,Eating Out,5,2367
26,12,2012,Caffe Nero,Eating Out,1,2366
26,12,2012,Greggs,Eating Out,4,2362
27,12,2012,Cheam Service Station,,4,2358
28,12,2012,ASDA,Groceries,49,2309
28,12,2012,Greggs,Eating Out,8,2301
28,12,2012,Anglo restaurant,Eating Out,44,2257
29,12,2012,ATM Cash Withdrawal,General,10,2247
30,12,2012,Restaurant Gordon RamsayPortland Restaurant,Eating Out,43,2204
31,12,2012,South West Trains,Transport,29,2175
31,12,2012,ATM Cash Withdrawal,General,10,2165
1,1,2013,Rhino Sports salary,General,1600,3765
1,1,2013,Costa Coffee,Eating Out,1,3764
1,1,2013,The West Cornwall Pasty Company,Eating Out,6,3758
2,1,2013,Chicken Cottage,Eating Out,7,3751
2,1,2013,ATM Cash Withdrawal,General,20,3731
3,1,2013,Greggs,Eating Out,8,3723
4,1,2013,ASDA,Groceries,65,3658
4,1,2013,Anglo restaurant,Eating Out,57,3601
6,1,2013,Dominos Pizza,Eating Out,40,3561
7,1,2013,Cubit and West rent,Rent,440,3121
7,1,2013,South West Trains,Transport,27,3094
7,1,2013,Wild Bean Cafe,Eating Out,2,3092
7,1,2013,The West Cornwall Pasty Company,Eating Out,5,3087
7,1,2013,ATM Cash Withdrawal,General,20,3067
8,1,2013,Caffe Nero,Eating Out,2,3065
8,1,2013,Greggs,Eating Out,5,3060
8,1,2013,ATM Cash Withdrawal,General,10,3050
8,1,2013,Paying back Julie,,8,3042
9,1,2013,Wild Bean Cafe,Eating Out,2,3040
9,1,2013,The West Cornwall Pasty Company,Eating Out,5,3035
10,1,2013,Caffe Nero,Eating Out,2,3033
10,1,2013,ATM Cash Withdrawal,General,20,3013
11,1,2013,Tescos,Groceries,51,2962
11,1,2013,Starbucks Coffee,Eating Out,2,2960
11,1,2013,McDonalds,Eating Out,6,2954
11,1,2013,The Grand Pub,Eating Out,5,2949
11,1,2013,The Grand Pub,Eating Out,14,2935
11,1,2013,The Grand Pub,Eating Out,10,2925
11,1,2013,The Grand Pub,Eating Out,6,2919
12,1,2013,The Grand Pub,Eating Out,7,2912
12,1,2013,The Grand Pub,Eating Out,16,2896
12,1,2013,Dominos Pizza,Eating Out,42,2854
12,1,2013,ATM Cash Withdrawal,General,10,2844
13,1,2013,Dominos Pizza,Eating Out,33,2811
13,1,2013,ATM Cash Withdrawal,General,10,2801
14,1,2013,South West Trains,Transport,32,2769
14,1,2013,Wild Bean Cafe,Eating Out,2,2767
14,1,2013,ATM Cash Withdrawal,General,10,2757
15,1,2013,BRGAS-Electricity,Bills,26,2731
15,1,2013,BRGAS-Gas,Bills,36,2695
15,1,2013,Starbucks Coffee,Eating Out,2,2693
16,1,2013,LBS Council Tax,Bills,35,2658
16,1,2013,Caffe Nero,Eating Out,2,2656
16,1,2013,The West Cornwall Pasty Company,Eating Out,8,2648
17,1,2013,Costa Coffee,Eating Out,2,2646
17,1,2013,McDonalds,Eating Out,5,2641
18,1,2013,Morrisons,Groceries,39,2602
18,1,2013,Costa Coffee,Eating Out,2,2600
18,1,2013,Heaven Club,Eating Out,5,2595
18,1,2013,Heaven Club,Eating Out,6,2589
18,1,2013,Heaven Club,Eating Out,13,2576
18,1,2013,Dominos Pizza,Eating Out,40,2536
18,1,2013,Civic Shop,,5,2531
19,1,2013,Anglo restaurant,Eating Out,57,2474
19,1,2013,ATM Cash Withdrawal,General,10,2464
20,1,2013,VIRGIN MEDIA PYMTS,Bills,25,2439
20,1,2013,Scott's Restaurant,Eating Out,50,2389
21,1,2013,South West Trains,Transport,38,2351
21,1,2013,Costa Coffee,Eating Out,2,2349
22,1,2013,Starbucks Coffee,Eating Out,2,2347
22,1,2013,The West Cornwall Pasty Company,Eating Out,8,2339
22,1,2013,ATM Cash Withdrawal,General,10,2329
23,1,2013,Starbucks Coffee,Eating Out,2,2327
24,1,2013,O2,Bills,25,2302
24,1,2013,Costa Coffee,Eating Out,2,2300
24,1,2013,McDonalds,Eating Out,4,2296
24,1,2013,ATM Cash Withdrawal,General,10,2286
25,1,2013,ASDA,Groceries,55,2231
25,1,2013,Costa Coffee,Eating Out,2,2229
25,1,2013,Scott's Restaurant,Eating Out,48,2181
25,1,2013,ATM Cash Withdrawal,General,10,2171
26,1,2013,The Grand Pub,Eating Out,13,2158
26,1,2013,The Grand Pub,Eating Out,11,2147
26,1,2013,The Grand Pub,Eating Out,13,2134
26,1,2013,The Grand Pub,Eating Out,14,2120
26,1,2013,The Grand Pub,Eating Out,12,2108
26,1,2013,Dominos Pizza,Eating Out,51,2057
28,1,2013,South West Trains,Transport,29,2028
28,1,2013,Starbucks Coffee,Eating Out,2,2026
28,1,2013,Pret A Manger,Eating Out,5,2021
29,1,2013,Wild Bean Cafe,Eating Out,2,2019
30,1,2013,Starbucks Coffee,Eating Out,1,2018
31,1,2013,Starbucks Coffee,Eating Out,2,2016
31,1,2013,Pret A Manger,Eating Out,5,2011
1,2,2013,Rhino Sports salary,General,1600,3611
1,2,2013,Waitrose,Groceries,40,3571
1,2,2013,Scott's Restaurant,Eating Out,29,3542
1,2,2013,ATM Cash Withdrawal,General,10,3532
1,2,2013,Tool Shop,,8,3524
3,2,2013,Scott's Restaurant,Eating Out,39,3485
4,2,2013,South West Trains,Transport,35,3450
4,2,2013,Starbucks Coffee,Eating Out,2,3448
4,2,2013,McDonalds,Eating Out,6,3442
5,2,2013,Caffe Nero,Eating Out,1,3441
5,2,2013,Pret A Manger,Eating Out,4,3437
5,2,2013,ATM Cash Withdrawal,General,20,3417
6,2,2013,Wild Bean Cafe,Eating Out,2,3415
6,2,2013,ATM Cash Withdrawal,General,20,3395
7,2,2013,Cubit and West rent,Rent,440,2955
7,2,2013,ATM Cash Withdrawal,General,10,2945
8,2,2013,ASDA,Groceries,41,2904
8,2,2013,Pret A Manger,Eating Out,7,2897
8,2,2013,Heaven Club,Eating Out,12,2885
8,2,2013,Heaven Club,Eating Out,9,2876
8,2,2013,Tool Tec,,9,2867
9,2,2013,Pizza Express,Eating Out,40,2827
11,2,2013,South West Trains,Transport,34,2793
11,2,2013,Caffe Nero,Eating Out,2,2791
12,2,2013,Caffe Nero,Eating Out,2,2789
13,2,2013,Wild Bean Cafe,Eating Out,1,2788
14,2,2013,Starbucks Coffee,Eating Out,1,2787
14,2,2013,The West Cornwall Pasty Company,Eating Out,7,2780
15,2,2013,BRGAS-Electricity,Bills,30,2750
15,2,2013,BRGAS-Gas,Bills,27,2723
15,2,2013,Sainsburys,Groceries,67,2656
15,2,2013,Caffe Nero,Eating Out,2,2654
15,2,2013,Pizza Express,Eating Out,33,2621
15,2,2013,ATM Cash Withdrawal,General,10,2611
16,2,2013,LBS Council Tax,Bills,35,2576
16,2,2013,Anglo restaurant,Eating Out,49,2527
17,2,2013,Anglo restaurant,Eating Out,42,2485
18,2,2013,South West Trains,Transport,29,2456
18,2,2013,Costa Coffee,Eating Out,2,2454
18,2,2013,Chicken Cottage,Eating Out,7,2447
18,2,2013,ATM Cash Withdrawal,General,20,2427
19,2,2013,Wild Bean Cafe,Eating Out,2,2425
20,2,2013,VIRGIN MEDIA PYMTS,Bills,35,2390
22,2,2013,Tescos,Groceries,56,2334
23,2,2013,Fabric Club,Eating Out,7,2327
23,2,2013,Fabric Club,Eating Out,9,2318
23,2,2013,Fabric Club,Eating Out,8,2310
24,2,2013,O2,Bills,31,2279
24,2,2013,Dominos Pizza,Eating Out,24,2255
25,2,2013,South West Trains,Transport,35,2220
25,2,2013,Pret A Manger,Eating Out,6,2214
27,2,2013,Caffe Nero,Eating Out,1,2213
27,2,2013,ATM Cash Withdrawal,General,10,2203
27,2,2013,Cheam Service Station,,9,2194
28,2,2013,Starbucks Coffee,Eating Out,2,2192
1,3,2013,Rhino Sports salary,General,1600,3792
1,3,2013,ASDA,Groceries,47,3745
2,3,2013,The Grand Pub,Eating Out,5,3740
2,3,2013,Tool Tec,,8,3732
3,3,2013,Scott's Restaurant,Eating Out,58,3674
4,3,2013,South West Trains,Transport,31,3643
4,3,2013,Caffe Nero,Eating Out,2,3641
4,3,2013,Pret A Manger,Eating Out,7,3634
5,3,2013,Wild Bean Cafe,Eating Out,2,3632
6,3,2013,Starbucks Coffee,Eating Out,1,3631
6,3,2013,Chicken Cottage,Eating Out,8,3623
6,3,2013,ATM Cash Withdrawal,General,20,3603
7,3,2013,Cubit and West rent,Rent,440,3163
7,3,2013,Caffe Nero,Eating Out,1,3162
7,3,2013,Pret A Manger,Eating Out,6,3156
7,3,2013,Tool Tec,,6,3150
8,3,2013,Sainsburys,Groceries,58,3092
8,3,2013,Caffe Nero,Eating Out,2,3090
8,3,2013,Chicken Cottage,Eating Out,4,3086
8,3,2013,The Grand Pub,Eating Out,12,3074
8,3,2013,The Grand Pub,Eating Out,6,3068
8,3,2013,The Grand Pub,Eating Out,6,3062
9,3,2013,ATM Cash Withdrawal,General,20,3042
10,3,2013,Anglo restaurant,Eating Out,34,3008
11,3,2013,South West Trains,Transport,25,2983
11,3,2013,Wild Bean Cafe,Eating Out,1,2982
11,3,2013,Chicken Cottage,Eating Out,4,2978
12,3,2013,Caffe Nero,Eating Out,2,2976
13,3,2013,Caffe Nero,Eating Out,1,2975
13,3,2013,Subway,Eating Out,5,2970
13,3,2013,Tool Shop,,8,2962
15,3,2013,BRGAS-Electricity,Bills,27,2935
15,3,2013,BRGAS-Gas,Bills,25,2910
15,3,2013,ASDA,Groceries,43,2867
15,3,2013,Costa Coffee,Eating Out,1,2866
15,3,2013,Restaurant Gordon RamsayPortland Restaurant,Eating Out,42,2824
15,3,2013,ATM Cash Withdrawal,General,10,2814
16,3,2013,LBS Council Tax,Bills,35,2779
16,3,2013,Scott's Restaurant,Eating Out,45,2734
17,3,2013,ATM Cash Withdrawal,General,20,2714
18,3,2013,South West Trains,Transport,33,2681
18,3,2013,Caffe Nero,Eating Out,2,2679
18,3,2013,ATM Cash Withdrawal,General,20,2659
19,3,2013,Wild Bean Cafe,Eating Out,2,2657
20,3,2013,VIRGIN MEDIA PYMTS,Bills,26,2631
20,3,2013,Costa Coffee,Eating Out,2,2629
20,3,2013,ATM Cash Withdrawal,General,10,2619
22,3,2013,ASDA,Groceries,48,2571
22,3,2013,ATM Cash Withdrawal,General,10,2561
23,3,2013,ATM Cash Withdrawal,General,20,2541
24,3,2013,O2,Bills,32,2509
24,3,2013,Dominos Pizza,Eating Out,45,2464
25,3,2013,South West Trains,Transport,32,2432
25,3,2013,Caffe Nero,Eating Out,1,2431
26,3,2013,Costa Coffee,Eating Out,2,2429
27,3,2013,Chicken Cottage,Eating Out,7,2422
28,3,2013,Starbucks Coffee,Eating Out,2,2420
28,3,2013,The West Cornwall Pasty Company,Eating Out,7,2413
28,3,2013,ATM Cash Withdrawal,General,10,2403
29,3,2013,Morrisons,Groceries,55,2348
29,3,2013,Costa Coffee,Eating Out,2,2346
29,3,2013,The West Cornwall Pasty Company,Eating Out,5,2341
29,3,2013,ATM Cash Withdrawal,General,20,2321
30,3,2013,Anglo restaurant,Eating Out,35,2286
31,3,2013,Pizza Express,Eating Out,35,2251
31,3,2013,ATM Cash Withdrawal,General,20,2231
1,4,2013,Rhino Sports salary,General,1600,3831
1,4,2013,South West Trains,Transport,27,3804
1,4,2013,The West Cornwall Pasty Company,Eating Out,6,3798
2,4,2013,Wild Bean Cafe,Eating Out,2,3796
2,4,2013,Greggs,Eating Out,6,3790
2,4,2013,ATM Cash Withdrawal,General,10,3780
3,4,2013,Costa Coffee,Eating Out,2,3778
3,4,2013,ATM Cash Withdrawal,General,10,3768
4,4,2013,Costa Coffee,Eating Out,1,3767
4,4,2013,Subway,Eating Out,6,3761
5,4,2013,Waitrose,Groceries,61,3700
5,4,2013,Wild Bean Cafe,Eating Out,2,3698
5,4,2013,McDonalds,Eating Out,6,3692
5,4,2013,ATM Cash Withdrawal,General,10,3682
5,4,2013,Paying back James,,8,3674
7,4,2013,Cubit and West rent,Rent,440,3234
7,4,2013,ATM Cash Withdrawal,General,20,3214
8,4,2013,South West Trains,Transport,35,3179
8,4,2013,Starbucks Coffee,Eating Out,1,3178
9,4,2013,Starbucks Coffee,Eating Out,2,3176
10,4,2013,Wild Bean Cafe,Eating Out,2,3174
10,4,2013,Pret A Manger,Eating Out,8,3166
10,4,2013,ATM Cash Withdrawal,General,20,3146
11,4,2013,Costa Coffee,Eating Out,2,3144
11,4,2013,The West Cornwall Pasty Company,Eating Out,6,3138
12,4,2013,Tescos,Groceries,81,3057
12,4,2013,Caffe Nero,Eating Out,1,3056
12,4,2013,Chicken Cottage,Eating Out,5,3051
12,4,2013,ATM Cash Withdrawal,General,20,3031
13,4,2013,The Grand Pub,Eating Out,10,3021
13,4,2013,The Grand Pub,Eating Out,13,3008
13,4,2013,The Grand Pub,Eating Out,13,2995
13,4,2013,The Grand Pub,Eating Out,6,2989
13,4,2013,The Grand Pub,Eating Out,8,2981
13,4,2013,The Grand Pub,Eating Out,6,2975
14,4,2013,Anglo restaurant,Eating Out,55,2920
14,4,2013,ATM Cash Withdrawal,General,20,2900
15,4,2013,BRGAS-Electricity,Bills,33,2867
15,4,2013,BRGAS-Gas,Bills,30,2837
15,4,2013,South West Trains,Transport,30,2807
15,4,2013,Starbucks Coffee,Eating Out,2,2805
15,4,2013,The West Cornwall Pasty Company,Eating Out,6,2799
15,4,2013,Tool Shop,,1,2798
16,4,2013,LBS Council Tax,Bills,35,2763
16,4,2013,Wild Bean Cafe,Eating Out,2,2761
17,4,2013,Costa Coffee,Eating Out,1,2760
18,4,2013,Caffe Nero,Eating Out,1,2759
18,4,2013,ATM Cash Withdrawal,General,10,2749
19,4,2013,Morrisons,Groceries,77,2672
19,4,2013,Wild Bean Cafe,Eating Out,2,2670
19,4,2013,McDonalds,Eating Out,5,2665
19,4,2013,ATM Cash Withdrawal,General,10,2655
19,4,2013,Paying back James,,5,2650
20,4,2013,VIRGIN MEDIA PYMTS,Bills,38,2612
20,4,2013,Scott's Restaurant,Eating Out,32,2580
21,4,2013,Pizza Express,Eating Out,54,2526
21,4,2013,ATM Cash Withdrawal,General,20,2506
22,4,2013,South West Trains,Transport,26,2480
22,4,2013,Caffe Nero,Eating Out,2,2478
23,4,2013,ATM Cash Withdrawal,General,10,2468
24,4,2013,O2,Bills,25,2443
24,4,2013,Wild Bean Cafe,Eating Out,2,2441
24,4,2013,The West Cornwall Pasty Company,Eating Out,8,2433
25,4,2013,Wild Bean Cafe,Eating Out,1,2432
25,4,2013,Subway,Eating Out,8,2424
25,4,2013,Cheam Service Station,,5,2419
26,4,2013,Morrisons,Groceries,67,2352
26,4,2013,Costa Coffee,Eating Out,1,2351
27,4,2013,ATM Cash Withdrawal,General,10,2341
28,4,2013,ATM Cash Withdrawal,General,10,2331
29,4,2013,South West Trains,Transport,31,2300
29,4,2013,McDonalds,Eating Out,4,2296
29,4,2013,ATM Cash Withdrawal,General,20,2276
30,4,2013,Caffe Nero,Eating Out,2,2274
1,5,2013,Rhino Sports salary,General,1600,3874
1,5,2013,Caffe Nero,Eating Out,2,3872
1,5,2013,Greggs,Eating Out,4,3868
2,5,2013,Wild Bean Cafe,Eating Out,2,3866
2,5,2013,McDonalds,Eating Out,6,3860
3,5,2013,ASDA,Groceries,46,3814
3,5,2013,Starbucks Coffee,Eating Out,1,3813
3,5,2013,The West Cornwall Pasty Company,Eating Out,6,3807
3,5,2013,Tool Shop,,7,3800
6,5,2013,South West Trains,Transport,32,3768
6,5,2013,Caffe Nero,Eating Out,2,3766
6,5,2013,McDonalds,Eating Out,7,3759
6,5,2013,ATM Cash Withdrawal,General,20,3739
7,5,2013,Cubit and West rent,Rent,440,3299
7,5,2013,Costa Coffee,Eating Out,1,3298
7,5,2013,Chicken Cottage,Eating Out,8,3290
8,5,2013,Starbucks Coffee,Eating Out,1,3289
9,5,2013,The West Cornwall Pasty Company,Eating Out,6,3283
9,5,2013,Red Shop,,6,3277
10,5,2013,ASDA,Groceries,38,3239
10,5,2013,Starbucks Coffee,Eating Out,2,3237
10,5,2013,Subway,Eating Out,8,3229
11,5,2013,ATM Cash Withdrawal,General,10,3219
12,5,2013,Dominos Pizza,Eating Out,35,3184
12,5,2013,Civic Shop,,9,3175
13,5,2013,South West Trains,Transport,32,3143
13,5,2013,Caffe Nero,Eating Out,2,3141
13,5,2013,Chicken Cottage,Eating Out,7,3134
14,5,2013,Wild Bean Cafe,Eating Out,2,3132
14,5,2013,McDonalds,Eating Out,5,3127
14,5,2013,ATM Cash Withdrawal,General,10,3117
15,5,2013,BRGAS-Electricity,Bills,20,3097
15,5,2013,BRGAS-Gas,Bills,31,3066
15,5,2013,Caffe Nero,Eating Out,1,3065
15,5,2013,Chicken Cottage,Eating Out,4,3061
16,5,2013,LBS Council Tax,Bills,35,3026
16,5,2013,ATM Cash Withdrawal,General,10,3016
17,5,2013,Tescos,Groceries,48,2968
17,5,2013,Starbucks Coffee,Eating Out,2,2966
17,5,2013,Greggs,Eating Out,8,2958
18,5,2013,The Grand Pub,Eating Out,14,2944
18,5,2013,The Grand Pub,Eating Out,12,2932
18,5,2013,Restaurant Gordon RamsayPortland Restaurant,Eating Out,50,2882
18,5,2013,ATM Cash Withdrawal,General,10,2872
20,5,2013,VIRGIN MEDIA PYMTS,Bills,29,2843
20,5,2013,South West Trains,Transport,34,2809
20,5,2013,Pret A Manger,Eating Out,4,2805
21,5,2013,Costa Coffee,Eating Out,2,2803
21,5,2013,The West Cornwall Pasty Company,Eating Out,4,2799
22,5,2013,Wild Bean Cafe,Eating Out,2,2797
22,5,2013,The West Cornwall Pasty Company,Eating Out,8,2789
22,5,2013,ATM Cash Withdrawal,General,20,2769
23,5,2013,Costa Coffee,Eating Out,2,2767
24,5,2013,O2,Bills,31,2736
24,5,2013,Morrisons,Groceries,74,2662
24,5,2013,Wild Bean Cafe,Eating Out,2,2660
24,5,2013,Pret A Manger,Eating Out,7,2653
26,5,2013,Scott's Restaurant,Eating Out,52,2601
26,5,2013,ATM Cash Withdrawal,General,20,2581
27,5,2013,South West Trains,Transport,32,2549
27,5,2013,Starbucks Coffee,Eating Out,2,2547
28,5,2013,Starbucks Coffee,Eating Out,2,2545
28,5,2013,McDonalds,Eating Out,6,2539
29,5,2013,Wild Bean Cafe,Eating Out,2,2537
29,5,2013,ATM Cash Withdrawal,General,10,2527
30,5,2013,Caffe Nero,Eating Out,2,2525
30,5,2013,Subway,Eating Out,6,2519
31,5,2013,Waitrose,Groceries,42,2477
31,5,2013,Caffe Nero,Eating Out,2,2475
31,5,2013,Fabric Club,Eating Out,8,2467
31,5,2013,Fabric Club,Eating Out,14,2453
1,6,2013,Rhino Sports salary,General,1600,4053
1,6,2013,Pizza Express,Eating Out,42,4011
1,6,2013,ATM Cash Withdrawal,General,10,4001
3,6,2013,South West Trains,Transport,24,3977
4,6,2013,Starbucks Coffee,Eating Out,2,3975
4,6,2013,Pret A Manger,Eating Out,7,3968
5,6,2013,Wild Bean Cafe,Eating Out,1,3967
5,6,2013,Chicken Cottage,Eating Out,6,3961
6,6,2013,Caffe Nero,Eating Out,1,3960
6,6,2013,Chicken Cottage,Eating Out,7,3953
6,6,2013,ATM Cash Withdrawal,General,20,3933
6,6,2013,Paying back Julie,,5,3928
7,6,2013,Cubit and West rent,Rent,440,3488
7,6,2013,Morrisons,Groceries,42,3446
7,6,2013,Caffe Nero,Eating Out,2,3444
7,6,2013,Restaurant Gordon RamsayPortland Restaurant,Eating Out,56,3388
7,6,2013,Civic Shop,,4,3384
8,6,2013,Heaven Club,Eating Out,12,3372
8,6,2013,Heaven Club,Eating Out,15,3357
8,6,2013,Heaven Club,Eating Out,16,3341
8,6,2013,Heaven Club,Eating Out,10,3331
8,6,2013,Heaven Club,Eating Out,6,3325
8,6,2013,Heaven Club,Eating Out,6,3319
10,6,2013,South West Trains,Transport,24,3295
10,6,2013,The West Cornwall Pasty Company,Eating Out,8,3287
11,6,2013,Starbucks Coffee,Eating Out,2,3285
12,6,2013,Caffe Nero,Eating Out,2,3283
13,6,2013,ATM Cash Withdrawal,General,20,3263
14,6,2013,Sainsburys,Groceries,64,3199
14,6,2013,Costa Coffee,Eating Out,2,3197
14,6,2013,Subway,Eating Out,8,3189
15,6,2013,BRGAS-Electricity,Bills,26,3163
15,6,2013,BRGAS-Gas,Bills,29,3134
15,6,2013,Pizza Express,Eating Out,24,3110
15,6,2013,ATM Cash Withdrawal,General,10,3100
15,6,2013,Tool Shop,,2,3098
16,6,2013,LBS Council Tax,Bills,35,3063
16,6,2013,Cheam Service Station,,7,3056
17,6,2013,South West Trains,Transport,34,3022
17,6,2013,Costa Coffee,Eating Out,1,3021
17,6,2013,Pret A Manger,Eating Out,6,3015
17,6,2013,Red Shop,,5,3010
18,6,2013,Wild Bean Cafe,Eating Out,1,3009
18,6,2013,Subway,Eating Out,5,3004
19,6,2013,Wild Bean Cafe,Eating Out,2,3002
19,6,2013,McDonalds,Eating Out,4,2998
19,6,2013,ATM Cash Withdrawal,General,10,2988
20,6,2013,VIRGIN MEDIA PYMTS,Bills,26,2962
20,6,2013,ATM Cash Withdrawal,General,10,2952
20,6,2013,Tool Tec,,9,2943
21,6,2013,Sainsburys,Groceries,59,2884
21,6,2013,Caffe Nero,Eating Out,2,2882
21,6,2013,McDonalds,Eating Out,6,2876
21,6,2013,Fabric Club,Eating Out,13,2863
21,6,2013,Fabric Club,Eating Out,8,2855
21,6,2013,Fabric Club,Eating Out,12,2843
21,6,2013,Fabric Club,Eating Out,11,2832
21,6,2013,Fabric Club,Eating Out,10,2822
21,6,2013,Tool Tec,,6,2816
24,6,2013,O2,Bills,32,2784
24,6,2013,South West Trains,Transport,36,2748
24,6,2013,Caffe Nero,Eating Out,2,2746
24,6,2013,Pret A Manger,Eating Out,5,2741
24,6,2013,Paying back Julie,,5,2736
25,6,2013,Wild Bean Cafe,Eating Out,2,2734
25,6,2013,McDonalds,Eating Out,8,2726
26,6,2013,Caffe Nero,Eating Out,2,2724
26,6,2013,Paying back Julie,,3,2721
28,6,2013,Sainsburys,Groceries,82,2639
28,6,2013,Costa Coffee,Eating Out,2,2637
28,6,2013,McDonalds,Eating Out,4,2633
28,6,2013,Ministry of Sound ClubXOYO Club,Eating Out,15,2618
28,6,2013,Ministry of Sound ClubXOYO Club,Eating Out,12,2606
29,6,2013,ATM Cash Withdrawal,General,20,2586
1,7,2013,Rhino Sports salary,General,1600,4186
1,7,2013,South West Trains,Transport,30,4156
1,7,2013,Caffe Nero,Eating Out,2,4154
1,7,2013,Subway,Eating Out,6,4148
2,7,2013,Starbucks Coffee,Eating Out,2,4146
2,7,2013,Pret A Manger,Eating Out,7,4139
3,7,2013,Caffe Nero,Eating Out,1,4138
3,7,2013,Chicken Cottage,Eating Out,8,4130
3,7,2013,ATM Cash Withdrawal,General,20,4110
4,7,2013,Wild Bean Cafe,Eating Out,2,4108
4,7,2013,Subway,Eating Out,4,4104
5,7,2013,ASDA,Groceries,75,4029
5,7,2013,Costa Coffee,Eating Out,2,4027
5,7,2013,Greggs,Eating Out,5,4022
6,7,2013,Heaven Club,Eating Out,15,4007
7,7,2013,Cubit and West rent,Rent,440,3567
7,7,2013,Anglo restaurant,Eating Out,57,3510
8,7,2013,South West Trains,Transport,37,3473
8,7,2013,Starbucks Coffee,Eating Out,2,3471
8,7,2013,McDonalds,Eating Out,6,3465
8,7,2013,ATM Cash Withdrawal,General,20,3445
9,7,2013,Wild Bean Cafe,Eating Out,1,3444
9,7,2013,ATM Cash Withdrawal,General,10,3434
10,7,2013,Chicken Cottage,Eating Out,6,3428
11,7,2013,Wild Bean Cafe,Eating Out,1,3427
12,7,2013,Tescos,Groceries,46,3381
12,7,2013,Chicken Cottage,Eating Out,4,3377
12,7,2013,Heaven Club,Eating Out,5,3372
12,7,2013,Heaven Club,Eating Out,9,3363
12,7,2013,Heaven Club,Eating Out,10,3353
12,7,2013,Heaven Club,Eating Out,12,3341
12,7,2013,Heaven Club,Eating Out,9,3332
12,7,2013,Heaven Club,Eating Out,15,3317
12,7,2013,Dominos Pizza,Eating Out,38,3279
13,7,2013,Tool Tec,,1,3278
14,7,2013,Anglo restaurant,Eating Out,34,3244
15,7,2013,BRGAS-Electricity,Bills,24,3220
15,7,2013,BRGAS-Gas,Bills,33,3187
15,7,2013,South West Trains,Transport,36,3151
15,7,2013,Chicken Cottage,Eating Out,7,3144
16,7,2013,LBS Council Tax,Bills,35,3109
16,7,2013,Starbucks Coffee,Eating Out,2,3107
16,7,2013,Tool Shop,,2,3105
17,7,2013,Costa Coffee,Eating Out,1,3104
17,7,2013,Pret A Manger,Eating Out,8,3096
18,7,2013,Chicken Cottage,Eating Out,8,3088
18,7,2013,Red Shop,,5,3083
19,7,2013,Morrisons,Groceries,62,3021
19,7,2013,Starbucks Coffee,Eating Out,1,3020
20,7,2013,VIRGIN MEDIA PYMTS,Bills,32,2988
20,7,2013,Red Shop,,3,2985
21,7,2013,Anglo restaurant,Eating Out,43,2942
21,7,2013,ATM Cash Withdrawal,General,20,2922
22,7,2013,South West Trains,Transport,35,2887
22,7,2013,Costa Coffee,Eating Out,2,2885
22,7,2013,Pret A Manger,Eating Out,5,2880
23,7,2013,Costa Coffee,Eating Out,2,2878
23,7,2013,Pret A Manger,Eating Out,5,2873
24,7,2013,O2,Bills,27,2846
24,7,2013,Caffe Nero,Eating Out,2,2844
25,7,2013,Wild Bean Cafe,Eating Out,2,2842
26,7,2013,Sainsburys,Groceries,69,2773
26,7,2013,Wild Bean Cafe,Eating Out,1,2772
27,7,2013,Red Shop,,7,2765
28,7,2013,Restaurant Gordon RamsayPortland Restaurant,Eating Out,51,2714
29,7,2013,South West Trains,Transport,32,2682
29,7,2013,Costa Coffee,Eating Out,2,2680
30,7,2013,Costa Coffee,Eating Out,2,2678
30,7,2013,Pret A Manger,Eating Out,5,2673
31,7,2013,Wild Bean Cafe,Eating Out,1,2672
31,7,2013,ATM Cash Withdrawal,General,20,2652
1,8,2013,Rhino Sports salary,General,1600,4252
1,8,2013,Costa Coffee,Eating Out,2,4250
1,8,2013,ATM Cash Withdrawal,General,10,4240
2,8,2013,Tescos,Groceries,43,4197
2,8,2013,Costa Coffee,Eating Out,2,4195
2,8,2013,Chicken Cottage,Eating Out,6,4189
4,8,2013,Dominos Pizza,Eating Out,57,4132
4,8,2013,ATM Cash Withdrawal,General,10,4122
5,8,2013,South West Trains,Transport,35,4087
5,8,2013,ATM Cash Withdrawal,General,10,4077
6,8,2013,Wild Bean Cafe,Eating Out,2,4075
6,8,2013,Greggs,Eating Out,7,4068
7,8,2013,Cubit and West rent,Rent,440,3628
7,8,2013,Starbucks Coffee,Eating Out,2,3626
7,8,2013,ATM Cash Withdrawal,General,10,3616
8,8,2013,Costa Coffee,Eating Out,2,3614
8,8,2013,Chicken Cottage,Eating Out,5,3609
9,8,2013,Waitrose,Groceries,73,3536
9,8,2013,The West Cornwall Pasty Company,Eating Out,4,3532
9,8,2013,Paying back Julie,,9,3523
10,8,2013,Scott's Restaurant,Eating Out,39,3484
11,8,2013,Restaurant Gordon RamsayPortland Restaurant,Eating Out,36,3448
12,8,2013,South West Trains,Transport,30,3418
12,8,2013,Wild Bean Cafe,Eating Out,2,3416
12,8,2013,Chicken Cottage,Eating Out,4,3412
13,8,2013,Costa Coffee,Eating Out,2,3410
13,8,2013,Pret A Manger,Eating Out,8,3402
14,8,2013,Starbucks Coffee,Eating Out,2,3400
14,8,2013,Pret A Manger,Eating Out,6,3394
15,8,2013,BRGAS-Electricity,Bills,28,3366
15,8,2013,BRGAS-Gas,Bills,29,3337
15,8,2013,Caffe Nero,Eating Out,2,3335
15,8,2013,Pret A Manger,Eating Out,8,3327
15,8,2013,Cheam Service Station,,4,3323
16,8,2013,LBS Council Tax,Bills,35,3288
16,8,2013,Morrisons,Groceries,40,3248
16,8,2013,Costa Coffee,Eating Out,1,3247
16,8,2013,The West Cornwall Pasty Company,Eating Out,7,3240
17,8,2013,Fabric Club,Eating Out,8,3232
17,8,2013,Fabric Club,Eating Out,9,3223
17,8,2013,Fabric Club,Eating Out,9,3214
17,8,2013,Fabric Club,Eating Out,8,3206
17,8,2013,Fabric Club,Eating Out,5,3201
17,8,2013,Fabric Club,Eating Out,6,3195
18,8,2013,Scott's Restaurant,Eating Out,26,3169
19,8,2013,South West Trains,Transport,29,3140
19,8,2013,Caffe Nero,Eating Out,1,3139
19,8,2013,Tool Shop,,5,3134
20,8,2013,VIRGIN MEDIA PYMTS,Bills,41,3093
20,8,2013,Costa Coffee,Eating Out,2,3091
20,8,2013,Greggs,Eating Out,5,3086
21,8,2013,Starbucks Coffee,Eating Out,2,3084
21,8,2013,Chicken Cottage,Eating Out,4,3080
22,8,2013,Costa Coffee,Eating Out,1,3079
22,8,2013,ATM Cash Withdrawal,General,10,3069
22,8,2013,Tool Tec,,3,3066
23,8,2013,ASDA,Groceries,69,2997
23,8,2013,Pret A Manger,Eating Out,6,2991
24,8,2013,O2,Bills,31,2960
24,8,2013,Scott's Restaurant,Eating Out,50,2910
25,8,2013,Restaurant Gordon RamsayPortland Restaurant,Eating Out,47,2863
25,8,2013,ATM Cash Withdrawal,General,20,2843
26,8,2013,South West Trains,Transport,33,2810
26,8,2013,Costa Coffee,Eating Out,2,2808
26,8,2013,ATM Cash Withdrawal,General,20,2788
27,8,2013,Caffe Nero,Eating Out,1,2787
27,8,2013,McDonalds,Eating Out,4,2783
27,8,2013,Civic Shop,,3,2780
28,8,2013,Wild Bean Cafe,Eating Out,1,2779
28,8,2013,Pret A Manger,Eating Out,4,2775
29,8,2013,Pret A Manger,Eating Out,4,2771
30,8,2013,Morrisons,Groceries,45,2726
30,8,2013,Greggs,Eating Out,6,2720
31,8,2013,Pizza Express,Eating Out,49,2671
1,9,2013,Rhino Sports salary,General,1600,4271
1,9,2013,Pizza Express,Eating Out,58,4213
2,9,2013,South West Trains,Transport,24,4189
2,9,2013,The West Cornwall Pasty Company,Eating Out,4,4185
3,9,2013,Wild Bean Cafe,Eating Out,2,4183
3,9,2013,Chicken Cottage,Eating Out,5,4178
3,9,2013,ATM Cash Withdrawal,General,20,4158
4,9,2013,ATM Cash Withdrawal,General,10,4148
5,9,2013,Caffe Nero,Eating Out,2,4146
5,9,2013,Pret A Manger,Eating Out,6,4140
6,9,2013,Sainsburys,Groceries,73,4067
6,9,2013,Caffe Nero,Eating Out,2,4065
6,9,2013,Greggs,Eating Out,4,4061
6,9,2013,Pizza Express,Eating Out,53,4008
6,9,2013,ATM Cash Withdrawal,General,10,3998
7,9,2013,Cubit and West rent,Rent,440,3558
8,9,2013,ATM Cash Withdrawal,General,20,3538
8,9,2013,Tool Shop,,6,3532
9,9,2013,South West Trains,Transport,25,3507
9,9,2013,Caffe Nero,Eating Out,2,3505
9,9,2013,McDonalds,Eating Out,5,3500
10,9,2013,Wild Bean Cafe,Eating Out,2,3498
10,9,2013,Subway,Eating Out,4,3494
10,9,2013,Civic Shop,,1,3493
11,9,2013,McDonalds,Eating Out,5,3488
12,9,2013,Caffe Nero,Eating Out,2,3486
12,9,2013,McDonalds,Eating Out,5,3481
13,9,2013,Sainsburys,Groceries,45,3436
13,9,2013,Anglo restaurant,Eating Out,32,3404
14,9,2013,Restaurant Gordon RamsayPortland Restaurant,Eating Out,45,3359
15,9,2013,BRGAS-Electricity,Bills,37,3322
15,9,2013,BRGAS-Gas,Bills,31,3291
15,9,2013,ATM Cash Withdrawal,General,10,3281
16,9,2013,LBS Council Tax,Bills,35,3246
16,9,2013,South West Trains,Transport,24,3222
16,9,2013,Caffe Nero,Eating Out,2,3220
16,9,2013,Greggs,Eating Out,6,3214
16,9,2013,ATM Cash Withdrawal,General,20,3194
16,9,2013,Red Shop,,6,3188
17,9,2013,Starbucks Coffee,Eating Out,2,3186
17,9,2013,Pret A Manger,Eating Out,5,3181
17,9,2013,ATM Cash Withdrawal,General,10,3171
18,9,2013,Wild Bean Cafe,Eating Out,2,3169
19,9,2013,Starbucks Coffee,Eating Out,2,3167
19,9,2013,Subway,Eating Out,6,3161
20,9,2013,VIRGIN MEDIA PYMTS,Bills,42,3119
20,9,2013,Tescos,Groceries,64,3055
20,9,2013,Caffe Nero,Eating Out,2,3053
20,9,2013,Chicken Cottage,Eating Out,7,3046
20,9,2013,Heaven Club,Eating Out,9,3037
20,9,2013,Heaven Club,Eating Out,12,3025
20,9,2013,Heaven Club,Eating Out,14,3011
20,9,2013,Heaven Club,Eating Out,5,3006
20,9,2013,Heaven Club,Eating Out,6,3000
20,9,2013,Heaven Club,Eating Out,6,2994
20,9,2013,Scott's Restaurant,Eating Out,55,2939
21,9,2013,Dominos Pizza,Eating Out,57,2882
22,9,2013,Anglo restaurant,Eating Out,45,2837
23,9,2013,South West Trains,Transport,36,2801
23,9,2013,Costa Coffee,Eating Out,2,2799
23,9,2013,The West Cornwall Pasty Company,Eating Out,7,2792
24,9,2013,O2,Bills,29,2763
24,9,2013,Wild Bean Cafe,Eating Out,1,2762
24,9,2013,The West Cornwall Pasty Company,Eating Out,4,2758
25,9,2013,Caffe Nero,Eating Out,2,2756
26,9,2013,Costa Coffee,Eating Out,1,2755
26,9,2013,Subway,Eating Out,4,2751
26,9,2013,Tool Shop,,3,2748
27,9,2013,Tescos,Groceries,76,2672
27,9,2013,McDonalds,Eating Out,8,2664
27,9,2013,Ministry of Sound ClubXOYO Club,Eating Out,7,2657
27,9,2013,Ministry of Sound ClubXOYO Club,Eating Out,15,2642
27,9,2013,Ministry of Sound ClubXOYO Club,Eating Out,6,2636
27,9,2013,Ministry of Sound ClubXOYO Club,Eating Out,12,2624
27,9,2013,Civic Shop,,3,2621
29,9,2013,Tool Shop,,4,2617
30,9,2013,South West Trains,Transport,34,2583
30,9,2013,Caffe Nero,Eating Out,2,2581
30,9,2013,ATM Cash Withdrawal,General,10,2571
1,10,2013,Rhino Sports salary,General,1600,4171
2,10,2013,Starbucks Coffee,Eating Out,2,4169
2,10,2013,Paying back Julie,,1,4168
3,10,2013,Starbucks Coffee,Eating Out,2,4166
4,10,2013,ASDA,Groceries,69,4097
4,10,2013,Caffe Nero,Eating Out,1,4096
4,10,2013,ATM Cash Withdrawal,General,20,4076
6,10,2013,Restaurant Gordon RamsayPortland Restaurant,Eating Out,53,4023
7,10,2013,Cubit and West rent,Rent,440,3583
7,10,2013,South West Trains,Transport,27,3556
8,10,2013,Starbucks Coffee,Eating Out,2,3554
8,10,2013,Subway,Eating Out,7,3547
9,10,2013,ATM Cash Withdrawal,General,20,3527
9,10,2013,Tool Tec,,3,3524
10,10,2013,Costa Coffee,Eating Out,2,3522
10,10,2013,ATM Cash Withdrawal,General,20,3502
10,10,2013,Paying back Julie,,9,3493
11,10,2013,Waitrose,Groceries,81,3412
11,10,2013,Caffe Nero,Eating Out,1,3411
11,10,2013,Restaurant Gordon RamsayPortland Restaurant,Eating Out,46,3365
13,10,2013,Anglo restaurant,Eating Out,48,3317
13,10,2013,ATM Cash Withdrawal,General,10,3307
14,10,2013,South West Trains,Transport,32,3275
14,10,2013,Costa Coffee,Eating Out,2,3273
14,10,2013,Greggs,Eating Out,5,3268
14,10,2013,ATM Cash Withdrawal,General,20,3248
15,10,2013,BRGAS-Electricity,Bills,33,3215
15,10,2013,BRGAS-Gas,Bills,23,3192
15,10,2013,Costa Coffee,Eating Out,1,3191
15,10,2013,Subway,Eating Out,6,3185
16,10,2013,LBS Council Tax,Bills,35,3150
16,10,2013,Subway,Eating Out,5,3145
17,10,2013,Caffe Nero,Eating Out,2,3143
17,10,2013,Chicken Cottage,Eating Out,8,3135
18,10,2013,Morrisons,Groceries,43,3092
18,10,2013,McDonalds,Eating Out,4,3088
18,10,2013,ATM Cash Withdrawal,General,10,3078
20,10,2013,VIRGIN MEDIA PYMTS,Bills,40,3038
20,10,2013,Pizza Express,Eating Out,57,2981
21,10,2013,South West Trains,Transport,31,2950
21,10,2013,Greggs,Eating Out,7,2943
22,10,2013,Caffe Nero,Eating Out,1,2942
22,10,2013,ATM Cash Withdrawal,General,10,2932
23,10,2013,Costa Coffee,Eating Out,2,2930
23,10,2013,McDonalds,Eating Out,7,2923
23,10,2013,ATM Cash Withdrawal,General,20,2903
24,10,2013,O2,Bills,30,2873
24,10,2013,Chicken Cottage,Eating Out,5,2868
25,10,2013,Morrisons,Groceries,53,2815
25,10,2013,Starbucks Coffee,Eating Out,2,2813
25,10,2013,McDonalds,Eating Out,6,2807
27,10,2013,Dominos Pizza,Eating Out,37,2770
28,10,2013,South West Trains,Transport,29,2741
28,10,2013,Caffe Nero,Eating Out,2,2739
30,10,2013,Costa Coffee,Eating Out,2,2737
31,10,2013,Wild Bean Cafe,Eating Out,2,2735
31,10,2013,The West Cornwall Pasty Company,Eating Out,7,2728
31,10,2013,ATM Cash Withdrawal,General,10,2718
31,10,2013,Paying back James,,6,2712
1,11,2013,Rhino Sports salary,General,1600,4312
1,11,2013,Morrisons,Groceries,71,4241
1,11,2013,Costa Coffee,Eating Out,2,4239
1,11,2013,McDonalds,Eating Out,7,4232
2,11,2013,Paying back James,,8,4224
4,11,2013,South West Trains,Transport,36,4188
4,11,2013,Greggs,Eating Out,5,4183
4,11,2013,Paying back James,,3,4180
5,11,2013,Wild Bean Cafe,Eating Out,2,4178
5,11,2013,McDonalds,Eating Out,6,4172
6,11,2013,The West Cornwall Pasty Company,Eating Out,4,4168
6,11,2013,ATM Cash Withdrawal,General,10,4158
7,11,2013,Cubit and West rent,Rent,440,3718
8,11,2013,Waitrose,Groceries,38,3680
8,11,2013,Starbucks Coffee,Eating Out,1,3679
8,11,2013,The West Cornwall Pasty Company,Eating Out,7,3672
8,11,2013,Fabric Club,Eating Out,7,3665
8,11,2013,Fabric Club,Eating Out,12,3653
8,11,2013,Fabric Club,Eating Out,16,3637
8,11,2013,Fabric Club,Eating Out,16,3621
8,11,2013,Fabric Club,Eating Out,5,3616
9,11,2013,ATM Cash Withdrawal,General,20,3596
11,11,2013,South West Trains,Transport,35,3561
11,11,2013,McDonalds,Eating Out,7,3554
12,11,2013,Subway,Eating Out,8,3546
13,11,2013,ATM Cash Withdrawal,General,10,3536
13,11,2013,Cheam Service Station,,2,3534
14,11,2013,Wild Bean Cafe,Eating Out,2,3532
14,11,2013,ATM Cash Withdrawal,General,10,3522
15,11,2013,BRGAS-Electricity,Bills,21,3501
15,11,2013,BRGAS-Gas,Bills,78,3423
15,11,2013,Tescos,Groceries,77,3346
15,11,2013,The West Cornwall Pasty Company,Eating Out,8,3338
15,11,2013,Heaven Club,Eating Out,12,3326
15,11,2013,Heaven Club,Eating Out,16,3310
15,11,2013,Heaven Club,Eating Out,15,3295
15,11,2013,Heaven Club,Eating Out,15,3280
15,11,2013,Heaven Club,Eating Out,9,3271
15,11,2013,Heaven Club,Eating Out,14,3257
15,11,2013,Scott's Restaurant,Eating Out,34,3223
16,11,2013,LBS Council Tax,Bills,35,3188
18,11,2013,South West Trains,Transport,35,3153
18,11,2013,Starbucks Coffee,Eating Out,2,3151
18,11,2013,ATM Cash Withdrawal,General,20,3131
19,11,2013,ATM Cash Withdrawal,General,10,3121
19,11,2013,Red Shop,,7,3114
20,11,2013,VIRGIN MEDIA PYMTS,Bills,31,3083
20,11,2013,Starbucks Coffee,Eating Out,2,3081
20,11,2013,Pret A Manger,Eating Out,6,3075
21,11,2013,Wild Bean Cafe,Eating Out,1,3074
21,11,2013,Greggs,Eating Out,4,3070
22,11,2013,Morrisons,Groceries,63,3007
22,11,2013,ATM Cash Withdrawal,General,10,2997
24,11,2013,O2,Bills,27,2970
24,11,2013,Paying back Julie,,1,2969
25,11,2013,South West Trains,Transport,30,2939
25,11,2013,Caffe Nero,Eating Out,1,2938
26,11,2013,ATM Cash Withdrawal,General,10,2928
27,11,2013,ATM Cash Withdrawal,General,20,2908
28,11,2013,Starbucks Coffee,Eating Out,1,2907
29,11,2013,ASDA,Groceries,71,2836
29,11,2013,Starbucks Coffee,Eating Out,2,2834
29,11,2013,The West Cornwall Pasty Company,Eating Out,5,2829
29,11,2013,Heaven Club,Eating Out,14,2815
29,11,2013,Heaven Club,Eating Out,5,2810
29,11,2013,Heaven Club,Eating Out,6,2804
29,11,2013,Restaurant Gordon RamsayPortland Restaurant,Eating Out,37,2767
1,12,2013,Rhino Sports salary,General,1600,4367
1,12,2013,Scott's Restaurant,Eating Out,48,4319
2,12,2013,South West Trains,Transport,35,4284
2,12,2013,Costa Coffee,Eating Out,2,4282
3,12,2013,Costa Coffee,Eating Out,2,4280
3,12,2013,The West Cornwall Pasty Company,Eating Out,5,4275
3,12,2013,ATM Cash Withdrawal,General,20,4255
4,12,2013,Wild Bean Cafe,Eating Out,1,4254
5,12,2013,Costa Coffee,Eating Out,1,4253
5,12,2013,McDonalds,Eating Out,6,4247
6,12,2013,Morrisons,Groceries,58,4189
6,12,2013,Starbucks Coffee,Eating Out,2,4187
6,12,2013,ATM Cash Withdrawal,General,10,4177
7,12,2013,Cubit and West rent,Rent,440,3737
8,12,2013,Pizza Express,Eating Out,57,3680
9,12,2013,South West Trains,Transport,36,3644
9,12,2013,Costa Coffee,Eating Out,1,3643
9,12,2013,ATM Cash Withdrawal,General,20,3623
9,12,2013,Tool Shop,,3,3620
10,12,2013,Costa Coffee,Eating Out,1,3619
10,12,2013,ATM Cash Withdrawal,General,10,3609
11,12,2013,Caffe Nero,Eating Out,1,3608
11,12,2013,The West Cornwall Pasty Company,Eating Out,7,3601
12,12,2013,Starbucks Coffee,Eating Out,1,3600
12,12,2013,ATM Cash Withdrawal,General,20,3580
13,12,2013,Morrisons,Groceries,55,3525
13,12,2013,Chicken Cottage,Eating Out,6,3519
14,12,2013,ATM Cash Withdrawal,General,10,3509
15,12,2013,BRGAS-Electricity,Bills,30,3479
15,12,2013,BRGAS-Gas,Bills,31,3448
16,12,2013,LBS Council Tax,Bills,35,3413
16,12,2013,South West Trains,Transport,34,3379
16,12,2013,Starbucks Coffee,Eating Out,1,3378
16,12,2013,ATM Cash Withdrawal,General,10,3368
17,12,2013,Starbucks Coffee,Eating Out,2,3366
17,12,2013,Pret A Manger,Eating Out,5,3361
18,12,2013,Starbucks Coffee,Eating Out,2,3359
19,12,2013,Caffe Nero,Eating Out,1,3358
19,12,2013,Pret A Manger,Eating Out,5,3353
20,12,2013,VIRGIN MEDIA PYMTS,Bills,35,3318
20,12,2013,Waitrose,Groceries,59,3259
20,12,2013,Wild Bean Cafe,Eating Out,1,3258
20,12,2013,McDonalds,Eating Out,7,3251
20,12,2013,ATM Cash Withdrawal,General,10,3241
22,12,2013,Restaurant Gordon RamsayPortland Restaurant,Eating Out,44,3197
22,12,2013,ATM Cash Withdrawal,General,20,3177
23,12,2013,South West Trains,Transport,26,3151
23,12,2013,Costa Coffee,Eating Out,2,3149
23,12,2013,Paying back Julie,,6,3143
24,12,2013,O2,Bills,25,3118
24,12,2013,Starbucks Coffee,Eating Out,1,3117
24,12,2013,McDonalds,Eating Out,7,3110
25,12,2013,Caffe Nero,Eating Out,1,3109
25,12,2013,The West Cornwall Pasty Company,Eating Out,8,3101
26,12,2013,Wild Bean Cafe,Eating Out,1,3100
27,12,2013,Morrisons,Groceries,44,3056
27,12,2013,Pret A Manger,Eating Out,7,3049
28,12,2013,Restaurant Gordon RamsayPortland Restaurant,Eating Out,30,3019
29,12,2013,ATM Cash Withdrawal,General,20,2999
30,12,2013,South West Trains,Transport,37,2962
30,12,2013,Caffe Nero,Eating Out,2,2960
30,12,2013,ATM Cash Withdrawal,General,10,2950
31,12,2013,ATM Cash Withdrawal,General,20,2930
1,1,2014,Rhino Sports salary,General,1600,4530
2,1,2014,Starbucks Coffee,Eating Out,2,4528
2,1,2014,Greggs,Eating Out,7,4521
3,1,2014,Tescos,Groceries,69,4452
3,1,2014,Subway,Eating Out,7,4445
4,1,2014,Dominos Pizza,Eating Out,46,4399
5,1,2014,Cheam Service Station,,1,4398
6,1,2014,South West Trains,Transport,29,4369
6,1,2014,Wild Bean Cafe,Eating Out,1,4368
6,1,2014,ATM Cash Withdrawal,General,10,4358
7,1,2014,Cubit and West rent,Rent,440,3918
7,1,2014,Caffe Nero,Eating Out,2,3916
7,1,2014,Chicken Cottage,Eating Out,7,3909
7,1,2014,Tool Shop,,1,3908
8,1,2014,Wild Bean Cafe,Eating Out,1,3907
8,1,2014,Chicken Cottage,Eating Out,7,3900
8,1,2014,ATM Cash Withdrawal,General,10,3890
9,1,2014,Greggs,Eating Out,4,3886
10,1,2014,Morrisons,Groceries,68,3818
10,1,2014,Costa Coffee,Eating Out,2,3816
10,1,2014,Restaurant Gordon RamsayPortland Restaurant,Eating Out,57,3759
11,1,2014,ATM Cash Withdrawal,General,20,3739
13,1,2014,South West Trains,Transport,32,3707
13,1,2014,Wild Bean Cafe,Eating Out,2,3705
14,1,2014,Caffe Nero,Eating Out,2,3703
14,1,2014,McDonalds,Eating Out,6,3697
15,1,2014,BRGAS-Electricity,Bills,46,3651
15,1,2014,BRGAS-Gas,Bills,41,3610
15,1,2014,Wild Bean Cafe,Eating Out,2,3608
15,1,2014,Greggs,Eating Out,4,3604
16,1,2014,LBS Council Tax,Bills,35,3569
16,1,2014,Caffe Nero,Eating Out,2,3567
16,1,2014,The West Cornwall Pasty Company,Eating Out,5,3562
16,1,2014,Tool Shop,,5,3557
17,1,2014,Sainsburys,Groceries,72,3485
17,1,2014,Wild Bean Cafe,Eating Out,2,3483
17,1,2014,Pret A Manger,Eating Out,5,3478
18,1,2014,Restaurant Gordon RamsayPortland Restaurant,Eating Out,34,3444
19,1,2014,Scott's Restaurant,Eating Out,34,3410
20,1,2014,VIRGIN MEDIA PYMTS,Bills,43,3367
20,1,2014,South West Trains,Transport,28,3339
20,1,2014,Starbucks Coffee,Eating Out,2,3337
20,1,2014,ATM Cash Withdrawal,General,10,3327
21,1,2014,Wild Bean Cafe,Eating Out,2,3325
21,1,2014,Pret A Manger,Eating Out,8,3317
22,1,2014,Starbucks Coffee,Eating Out,1,3316
22,1,2014,ATM Cash Withdrawal,General,20,3296
23,1,2014,Costa Coffee,Eating Out,2,3294
23,1,2014,Chicken Cottage,Eating Out,8,3286
23,1,2014,Paying back James,,4,3282
24,1,2014,O2,Bills,26,3256
24,1,2014,Sainsburys,Groceries,52,3204
24,1,2014,Caffe Nero,Eating Out,2,3202
27,1,2014,South West Trains,Transport,33,3169
27,1,2014,Starbucks Coffee,Eating Out,1,3168
27,1,2014,Subway,Eating Out,6,3162
28,1,2014,Starbucks Coffee,Eating Out,2,3160
29,1,2014,Costa Coffee,Eating Out,2,3158
29,1,2014,Greggs,Eating Out,4,3154
30,1,2014,Caffe Nero,Eating Out,1,3153
31,1,2014,Waitrose,Groceries,39,3114
31,1,2014,Wild Bean Cafe,Eating Out,2,3112
31,1,2014,The West Cornwall Pasty Company,Eating Out,7,3105
31,1,2014,Ministry of Sound ClubXOYO Club,Eating Out,14,3091
31,1,2014,Ministry of Sound ClubXOYO Club,Eating Out,12,3079
31,1,2014,Ministry of Sound ClubXOYO Club,Eating Out,13,3066
1,2,2014,Rhino Sports salary,General,1600,4666
1,2,2014,Pizza Express,Eating Out,37,4629
3,2,2014,South West Trains,Transport,34,4595
3,2,2014,Starbucks Coffee,Eating Out,2,4593
3,2,2014,The West Cornwall Pasty Company,Eating Out,8,4585
3,2,2014,Red Shop,,8,4577
4,2,2014,Starbucks Coffee,Eating Out,2,4575
4,2,2014,McDonalds,Eating Out,6,4569
5,2,2014,Greggs,Eating Out,7,4562
6,2,2014,Costa Coffee,Eating Out,1,4561
6,2,2014,McDonalds,Eating Out,5,4556
7,2,2014,Cubit and West rent,Rent,440,4116
7,2,2014,ASDA,Groceries,55,4061
7,2,2014,Subway,Eating Out,6,4055
7,2,2014,Dominos Pizza,Eating Out,59,3996
8,2,2014,Scott's Restaurant,Eating Out,51,3945
10,2,2014,South West Trains,Transport,38,3907
10,2,2014,Starbucks Coffee,Eating Out,2,3905
11,2,2014,McDonalds,Eating Out,7,3898
11,2,2014,ATM Cash Withdrawal,General,10,3888
12,2,2014,Starbucks Coffee,Eating Out,1,3887
12,2,2014,Greggs,Eating Out,5,3882
13,2,2014,Wild Bean Cafe,Eating Out,1,3881
13,2,2014,Chicken Cottage,Eating Out,6,3875
14,2,2014,Tescos,Groceries,58,3817
14,2,2014,Starbucks Coffee,Eating Out,1,3816
14,2,2014,Subway,Eating Out,5,3811
14,2,2014,Scott's Restaurant,Eating Out,44,3767
15,2,2014,BRGAS-Electricity,Bills,27,3740
15,2,2014,BRGAS-Gas,Bills,23,3717
16,2,2014,LBS Council Tax,Bills,35,3682
17,2,2014,South West Trains,Transport,24,3658
17,2,2014,Wild Bean Cafe,Eating Out,2,3656
17,2,2014,ATM Cash Withdrawal,General,20,3636
17,2,2014,Cheam Service Station,,5,3631
18,2,2014,Costa Coffee,Eating Out,1,3630
18,2,2014,Subway,Eating Out,6,3624
18,2,2014,Paying back Julie,,7,3617
19,2,2014,Starbucks Coffee,Eating Out,2,3615
20,2,2014,VIRGIN MEDIA PYMTS,Bills,23,3592
20,2,2014,Wild Bean Cafe,Eating Out,1,3591
20,2,2014,McDonalds,Eating Out,4,3587
21,2,2014,Tescos,Groceries,52,3535
21,2,2014,The West Cornwall Pasty Company,Eating Out,8,3527
21,2,2014,Ministry of Sound ClubXOYO Club,Eating Out,9,3518
21,2,2014,Ministry of Sound ClubXOYO Club,Eating Out,5,3513
21,2,2014,Ministry of Sound ClubXOYO Club,Eating Out,8,3505
21,2,2014,Ministry of Sound ClubXOYO Club,Eating Out,12,3493
21,2,2014,Ministry of Sound ClubXOYO Club,Eating Out,13,3480
21,2,2014,ATM Cash Withdrawal,General,20,3460
22,2,2014,Dominos Pizza,Eating Out,40,3420
24,2,2014,O2,Bills,30,3390
24,2,2014,South West Trains,Transport,31,3359
24,2,2014,Caffe Nero,Eating Out,2,3357
24,2,2014,The West Cornwall Pasty Company,Eating Out,8,3349
24,2,2014,ATM Cash Withdrawal,General,20,3329
25,2,2014,Paying back Julie,,1,3328
26,2,2014,Wild Bean Cafe,Eating Out,2,3326
26,2,2014,Greggs,Eating Out,8,3318
26,2,2014,ATM Cash Withdrawal,General,10,3308
26,2,2014,Cheam Service Station,,9,3299
27,2,2014,Starbucks Coffee,Eating Out,1,3298
28,2,2014,Tescos,Groceries,42,3256
28,2,2014,Subway,Eating Out,6,3250
1,3,2014,Rhino Sports salary,General,1600,4850
1,3,2014,ATM Cash Withdrawal,General,20,4830
1,3,2014,Paying back James,,2,4828
2,3,2014,Scott's Restaurant,Eating Out,54,4774
3,3,2014,South West Trains,Transport,38,4736
3,3,2014,Starbucks Coffee,Eating Out,2,4734
3,3,2014,McDonalds,Eating Out,7,4727
4,3,2014,Pret A Manger,Eating Out,5,4722
5,3,2014,Wild Bean Cafe,Eating Out,2,4720
5,3,2014,McDonalds,Eating Out,5,4715
5,3,2014,Paying back Julie,,1,4714
6,3,2014,Starbucks Coffee,Eating Out,2,4712
6,3,2014,Chicken Cottage,Eating Out,5,4707
7,3,2014,Cubit and West rent,Rent,440,4267
7,3,2014,Sainsburys,Groceries,60,4207
7,3,2014,Costa Coffee,Eating Out,2,4205
9,3,2014,Anglo restaurant,Eating Out,36,4169
10,3,2014,South West Trains,Transport,34,4135
10,3,2014,Costa Coffee,Eating Out,1,4134
10,3,2014,ATM Cash Withdrawal,General,20,4114
11,3,2014,Caffe Nero,Eating Out,2,4112
11,3,2014,Chicken Cottage,Eating Out,4,4108
12,3,2014,Caffe Nero,Eating Out,2,4106
13,3,2014,Wild Bean Cafe,Eating Out,1,4105
13,3,2014,Greggs,Eating Out,4,4101
13,3,2014,Tool Shop,,8,4093
14,3,2014,Morrisons,Groceries,47,4046
14,3,2014,Wild Bean Cafe,Eating Out,1,4045
14,3,2014,Greggs,Eating Out,7,4038
15,3,2014,BRGAS-Electricity,Bills,36,4002
15,3,2014,BRGAS-Gas,Bills,33,3969
15,3,2014,Pizza Express,Eating Out,51,3918
15,3,2014,ATM Cash Withdrawal,General,10,3908
16,3,2014,LBS Council Tax,Bills,35,3873
17,3,2014,South West Trains,Transport,34,3839
17,3,2014,Caffe Nero,Eating Out,1,3838
17,3,2014,The West Cornwall Pasty Company,Eating Out,6,3832
17,3,2014,Cheam Service Station,,5,3827
18,3,2014,Costa Coffee,Eating Out,2,3825
18,3,2014,McDonalds,Eating Out,4,3821
19,3,2014,Caffe Nero,Eating Out,1,3820
19,3,2014,Greggs,Eating Out,7,3813
19,3,2014,Red Shop,,3,3810
20,3,2014,VIRGIN MEDIA PYMTS,Bills,21,3789
20,3,2014,Caffe Nero,Eating Out,2,3787
20,3,2014,Chicken Cottage,Eating Out,7,3780
20,3,2014,ATM Cash Withdrawal,General,20,3760
21,3,2014,Sainsburys,Groceries,62,3698
21,3,2014,Starbucks Coffee,Eating Out,2,3696
21,3,2014,Chicken Cottage,Eating Out,4,3692
21,3,2014,Anglo restaurant,Eating Out,59,3633
23,3,2014,ATM Cash Withdrawal,General,20,3613
23,3,2014,Tool Shop,,3,3610
24,3,2014,O2,Bills,31,3579
24,3,2014,South West Trains,Transport,30,3549
25,3,2014,Caffe Nero,Eating Out,1,3548
26,3,2014,Starbucks Coffee,Eating Out,1,3547
26,3,2014,The West Cornwall Pasty Company,Eating Out,8,3539
26,3,2014,ATM Cash Withdrawal,General,10,3529
27,3,2014,Wild Bean Cafe,Eating Out,2,3527
27,3,2014,The West Cornwall Pasty Company,Eating Out,7,3520
28,3,2014,Morrisons,Groceries,50,3470
28,3,2014,Costa Coffee,Eating Out,1,3469
28,3,2014,The Grand Pub,Eating Out,12,3457
28,3,2014,The Grand Pub,Eating Out,7,3450
28,3,2014,The Grand Pub,Eating Out,9,3441
28,3,2014,The Grand Pub,Eating Out,14,3427
29,3,2014,Restaurant Gordon RamsayPortland Restaurant,Eating Out,53,3374
31,3,2014,South West Trains,Transport,30,3344
31,3,2014,Wild Bean Cafe,Eating Out,1,3343
31,3,2014,Subway,Eating Out,4,3339
1,4,2014,Rhino Sports salary,General,1600,4939
1,4,2014,Wild Bean Cafe,Eating Out,2,4937
1,4,2014,Subway,Eating Out,7,4930
2,4,2014,Wild Bean Cafe,Eating Out,2,4928
2,4,2014,Subway,Eating Out,6,4922
2,4,2014,ATM Cash Withdrawal,General,20,4902
4,4,2014,Tescos,Groceries,78,4824
4,4,2014,Caffe Nero,Eating Out,2,4822
4,4,2014,McDonalds,Eating Out,8,4814
4,4,2014,Pizza Express,Eating Out,38,4776
4,4,2014,ATM Cash Withdrawal,General,10,4766
5,4,2014,Cheam Service Station,,8,4758
6,4,2014,Paying back James,,3,4755
7,4,2014,Cubit and West rent,Rent,440,4315
7,4,2014,South West Trains,Transport,29,4286
7,4,2014,Costa Coffee,Eating Out,1,4285
7,4,2014,Subway,Eating Out,4,4281
7,4,2014,ATM Cash Withdrawal,General,10,4271
8,4,2014,Wild Bean Cafe,Eating Out,2,4269
8,4,2014,Subway,Eating Out,5,4264
9,4,2014,Caffe Nero,Eating Out,1,4263
9,4,2014,Subway,Eating Out,8,4255
10,4,2014,Costa Coffee,Eating Out,1,4254
10,4,2014,The West Cornwall Pasty Company,Eating Out,7,4247
11,4,2014,Sainsburys,Groceries,59,4188
11,4,2014,Subway,Eating Out,6,4182
12,4,2014,ATM Cash Withdrawal,General,10,4172
13,4,2014,Restaurant Gordon RamsayPortland Restaurant,Eating Out,43,4129
13,4,2014,ATM Cash Withdrawal,General,20,4109
13,4,2014,Paying back James,,4,4105
14,4,2014,South West Trains,Transport,37,4068
14,4,2014,Costa Coffee,Eating Out,1,4067
14,4,2014,Chicken Cottage,Eating Out,8,4059
14,4,2014,Paying back James,,8,4051
15,4,2014,BRGAS-Electricity,Bills,34,4017
15,4,2014,BRGAS-Gas,Bills,31,3986
15,4,2014,Costa Coffee,Eating Out,1,3985
16,4,2014,LBS Council Tax,Bills,35,3950
16,4,2014,Wild Bean Cafe,Eating Out,1,3949
17,4,2014,Wild Bean Cafe,Eating Out,1,3948
17,4,2014,Greggs,Eating Out,5,3943
17,4,2014,ATM Cash Withdrawal,General,20,3923
18,4,2014,Waitrose,Groceries,50,3873
18,4,2014,Caffe Nero,Eating Out,2,3871
18,4,2014,The West Cornwall Pasty Company,Eating Out,6,3865
18,4,2014,Heaven Club,Eating Out,5,3860
18,4,2014,Heaven Club,Eating Out,8,3852
18,4,2014,Heaven Club,Eating Out,13,3839
18,4,2014,Anglo restaurant,Eating Out,57,3782
19,4,2014,ATM Cash Withdrawal,General,20,3762
20,4,2014,VIRGIN MEDIA PYMTS,Bills,27,3735
20,4,2014,ATM Cash Withdrawal,General,20,3715
20,4,2014,Tool Tec,,7,3708
21,4,2014,South West Trains,Transport,24,3684
21,4,2014,Starbucks Coffee,Eating Out,1,3683
21,4,2014,ATM Cash Withdrawal,General,10,3673
22,4,2014,Caffe Nero,Eating Out,2,3671
23,4,2014,Caffe Nero,Eating Out,2,3669
24,4,2014,O2,Bills,30,3639
24,4,2014,ATM Cash Withdrawal,General,10,3629
25,4,2014,Sainsburys,Groceries,71,3558
25,4,2014,Starbucks Coffee,Eating Out,2,3556
25,4,2014,Greggs,Eating Out,4,3552
26,4,2014,Anglo restaurant,Eating Out,24,3528
26,4,2014,ATM Cash Withdrawal,General,10,3518
27,4,2014,Scott's Restaurant,Eating Out,26,3492
27,4,2014,Paying back Julie,,2,3490
28,4,2014,South West Trains,Transport,37,3453
28,4,2014,Costa Coffee,Eating Out,2,3451
28,4,2014,Subway,Eating Out,5,3446
28,4,2014,ATM Cash Withdrawal,General,20,3426
29,4,2014,Costa Coffee,Eating Out,2,3424
29,4,2014,Chicken Cottage,Eating Out,7,3417
1,5,2014,Rhino Sports salary,General,1600,5017
1,5,2014,Wild Bean Cafe,Eating Out,2,5015
2,5,2014,Morrisons,Groceries,44,4971
2,5,2014,Costa Coffee,Eating Out,2,4969
2,5,2014,McDonalds,Eating Out,7,4962
4,5,2014,Restaurant Gordon RamsayPortland Restaurant,Eating Out,24,4938
5,5,2014,South West Trains,Transport,27,4911
5,5,2014,Caffe Nero,Eating Out,2,4909
6,5,2014,Caffe Nero,Eating Out,1,4908
7,5,2014,Cubit and West rent,Rent,440,4468
7,5,2014,Starbucks Coffee,Eating Out,2,4466
8,5,2014,McDonalds,Eating Out,8,4458
9,5,2014,Waitrose,Groceries,67,4391
9,5,2014,Wild Bean Cafe,Eating Out,2,4389
10,5,2014,Dominos Pizza,Eating Out,42,4347
11,5,2014,Dominos Pizza,Eating Out,56,4291
12,5,2014,South West Trains,Transport,32,4259
12,5,2014,Caffe Nero,Eating Out,2,4257
12,5,2014,ATM Cash Withdrawal,General,20,4237
13,5,2014,Starbucks Coffee,Eating Out,1,4236
14,5,2014,Costa Coffee,Eating Out,2,4234
15,5,2014,BRGAS-Electricity,Bills,30,4204
15,5,2014,BRGAS-Gas,Bills,24,4180
15,5,2014,Costa Coffee,Eating Out,1,4179
15,5,2014,Pret A Manger,Eating Out,8,4171
15,5,2014,ATM Cash Withdrawal,General,20,4151
16,5,2014,LBS Council Tax,Bills,35,4116
16,5,2014,Waitrose,Groceries,77,4039
16,5,2014,Caffe Nero,Eating Out,2,4037
16,5,2014,Greggs,Eating Out,7,4030
16,5,2014,Fabric Club,Eating Out,15,4015
16,5,2014,Fabric Club,Eating Out,15,4000
18,5,2014,Pizza Express,Eating Out,37,3963
19,5,2014,South West Trains,Transport,37,3926
20,5,2014,VIRGIN MEDIA PYMTS,Bills,39,3887
20,5,2014,Wild Bean Cafe,Eating Out,2,3885
20,5,2014,McDonalds,Eating Out,7,3878
21,5,2014,Starbucks Coffee,Eating Out,1,3877
21,5,2014,McDonalds,Eating Out,8,3869
22,5,2014,Wild Bean Cafe,Eating Out,1,3868
22,5,2014,Chicken Cottage,Eating Out,4,3864
23,5,2014,Tescos,Groceries,69,3795
23,5,2014,Starbucks Coffee,Eating Out,1,3794
23,5,2014,The West Cornwall Pasty Company,Eating Out,4,3790
23,5,2014,Heaven Club,Eating Out,7,3783
24,5,2014,O2,Bills,31,3752
26,5,2014,South West Trains,Transport,25,3727
26,5,2014,Paying back James,,4,3723
27,5,2014,Caffe Nero,Eating Out,2,3721
27,5,2014,McDonalds,Eating Out,7,3714
27,5,2014,Red Shop,,2,3712
28,5,2014,Starbucks Coffee,Eating Out,1,3711
28,5,2014,The West Cornwall Pasty Company,Eating Out,7,3704
29,5,2014,Caffe Nero,Eating Out,2,3702
29,5,2014,Pret A Manger,Eating Out,6,3696
30,5,2014,Morrisons,Groceries,70,3626
30,5,2014,The West Cornwall Pasty Company,Eating Out,5,3621
31,5,2014,Restaurant Gordon RamsayPortland Restaurant,Eating Out,49,3572
1,6,2014,Rhino Sports salary,General,1600,5172
2,6,2014,South West Trains,Transport,33,5139
2,6,2014,Wild Bean Cafe,Eating Out,2,5137
2,6,2014,Civic Shop,,8,5129
3,6,2014,Wild Bean Cafe,Eating Out,2,5127
3,6,2014,ATM Cash Withdrawal,General,20,5107
4,6,2014,Costa Coffee,Eating Out,2,5105
5,6,2014,Costa Coffee,Eating Out,2,5103
5,6,2014,ATM Cash Withdrawal,General,20,5083
6,6,2014,Morrisons,Groceries,60,5023
6,6,2014,Starbucks Coffee,Eating Out,1,5022
6,6,2014,The West Cornwall Pasty Company,Eating Out,5,5017
7,6,2014,Cubit and West rent,Rent,440,4577
7,6,2014,Dominos Pizza,Eating Out,47,4530
9,6,2014,South West Trains,Transport,36,4494
9,6,2014,McDonalds,Eating Out,5,4489
9,6,2014,ATM Cash Withdrawal,General,20,4469
10,6,2014,Costa Coffee,Eating Out,2,4467
10,6,2014,Greggs,Eating Out,6,4461
11,6,2014,Caffe Nero,Eating Out,1,4460
11,6,2014,Chicken Cottage,Eating Out,5,4455
12,6,2014,Subway,Eating Out,6,4449
12,6,2014,ATM Cash Withdrawal,General,10,4439
12,6,2014,Cheam Service Station,,4,4435
13,6,2014,ASDA,Groceries,46,4389
13,6,2014,Scott's Restaurant,Eating Out,51,4338
15,6,2014,BRGAS-Electricity,Bills,20,4318
15,6,2014,BRGAS-Gas,Bills,35,4283
16,6,2014,LBS Council Tax,Bills,35,4248
16,6,2014,South West Trains,Transport,31,4217
16,6,2014,Caffe Nero,Eating Out,2,4215
17,6,2014,The West Cornwall Pasty Company,Eating Out,4,4211
18,6,2014,Starbucks Coffee,Eating Out,1,4210
18,6,2014,Pret A Manger,Eating Out,4,4206
18,6,2014,ATM Cash Withdrawal,General,10,4196
19,6,2014,Costa Coffee,Eating Out,1,4195
19,6,2014,The West Cornwall Pasty Company,Eating Out,8,4187
19,6,2014,ATM Cash Withdrawal,General,20,4167
20,6,2014,VIRGIN MEDIA PYMTS,Bills,28,4139
20,6,2014,Tescos,Groceries,40,4099
20,6,2014,Costa Coffee,Eating Out,2,4097
20,6,2014,Greggs,Eating Out,4,4093
21,6,2014,Scott's Restaurant,Eating Out,40,4053
22,6,2014,Dominos Pizza,Eating Out,28,4025
23,6,2014,South West Trains,Transport,29,3996
23,6,2014,Starbucks Coffee,Eating Out,2,3994
24,6,2014,O2,Bills,30,3964
24,6,2014,The West Cornwall Pasty Company,Eating Out,4,3960
25,6,2014,Starbucks Coffee,Eating Out,2,3958
25,6,2014,The West Cornwall Pasty Company,Eating Out,7,3951
26,6,2014,Costa Coffee,Eating Out,2,3949
26,6,2014,Chicken Cottage,Eating Out,6,3943
26,6,2014,ATM Cash Withdrawal,General,10,3933
27,6,2014,Tescos,Groceries,60,3873
27,6,2014,The West Cornwall Pasty Company,Eating Out,5,3868
28,6,2014,Scott's Restaurant,Eating Out,52,3816
28,6,2014,ATM Cash Withdrawal,General,20,3796
29,6,2014,Scott's Restaurant,Eating Out,57,3739
30,6,2014,South West Trains,Transport,35,3704
30,6,2014,McDonalds,Eating Out,7,3697
30,6,2014,ATM Cash Withdrawal,General,20,3677
1,7,2014,Rhino Sports salary,General,1600,5277
1,7,2014,Costa Coffee,Eating Out,2,5275
2,7,2014,Costa Coffee,Eating Out,1,5274
2,7,2014,McDonalds,Eating Out,5,5269
3,7,2014,Caffe Nero,Eating Out,2,5267
4,7,2014,Tescos,Groceries,55,5212
4,7,2014,Scott's Restaurant,Eating Out,27,5185
4,7,2014,ATM Cash Withdrawal,General,20,5165
5,7,2014,Scott's Restaurant,Eating Out,42,5123
5,7,2014,ATM Cash Withdrawal,General,10,5113
6,7,2014,Red Shop,,3,5110
7,7,2014,Cubit and West rent,Rent,440,4670
7,7,2014,South West Trains,Transport,30,4640
7,7,2014,Costa Coffee,Eating Out,1,4639
7,7,2014,Pret A Manger,Eating Out,7,4632
7,7,2014,ATM Cash Withdrawal,General,10,4622
8,7,2014,McDonalds,Eating Out,6,4616
9,7,2014,Starbucks Coffee,Eating Out,2,4614
10,7,2014,Caffe Nero,Eating Out,2,4612
10,7,2014,The West Cornwall Pasty Company,Eating Out,8,4604
11,7,2014,Waitrose,Groceries,45,4559
11,7,2014,Starbucks Coffee,Eating Out,2,4557
11,7,2014,McDonalds,Eating Out,6,4551
11,7,2014,ATM Cash Withdrawal,General,10,4541
12,7,2014,Scott's Restaurant,Eating Out,41,4500
13,7,2014,Pizza Express,Eating Out,36,4464
13,7,2014,ATM Cash Withdrawal,General,10,4454
14,7,2014,South West Trains,Transport,36,4418
14,7,2014,Subway,Eating Out,6,4412
15,7,2014,BRGAS-Electricity,Bills,24,4388
15,7,2014,BRGAS-Gas,Bills,22,4366
15,7,2014,Caffe Nero,Eating Out,2,4364
15,7,2014,Pret A Manger,Eating Out,4,4360
16,7,2014,LBS Council Tax,Bills,35,4325
16,7,2014,McDonalds,Eating Out,6,4319
16,7,2014,ATM Cash Withdrawal,General,10,4309
17,7,2014,Starbucks Coffee,Eating Out,1,4308
17,7,2014,McDonalds,Eating Out,6,4302
18,7,2014,Morrisons,Groceries,62,4240
18,7,2014,Wild Bean Cafe,Eating Out,2,4238
18,7,2014,ATM Cash Withdrawal,General,10,4228
20,7,2014,VIRGIN MEDIA PYMTS,Bills,41,4187
20,7,2014,Pizza Express,Eating Out,45,4142
20,7,2014,ATM Cash Withdrawal,General,20,4122
21,7,2014,South West Trains,Transport,31,4091
21,7,2014,Wild Bean Cafe,Eating Out,2,4089
21,7,2014,Pret A Manger,Eating Out,8,4081
21,7,2014,ATM Cash Withdrawal,General,20,4061
22,7,2014,ATM Cash Withdrawal,General,10,4051
23,7,2014,Starbucks Coffee,Eating Out,1,4050
23,7,2014,Chicken Cottage,Eating Out,8,4042
24,7,2014,O2,Bills,30,4012
24,7,2014,Starbucks Coffee,Eating Out,2,4010
24,7,2014,Greggs,Eating Out,8,4002
25,7,2014,ASDA,Groceries,47,3955
25,7,2014,Costa Coffee,Eating Out,2,3953
25,7,2014,Scott's Restaurant,Eating Out,36,3917
26,7,2014,ATM Cash Withdrawal,General,20,3897
28,7,2014,South West Trains,Transport,26,3871
28,7,2014,Caffe Nero,Eating Out,2,3869
29,7,2014,Starbucks Coffee,Eating Out,2,3867
29,7,2014,The West Cornwall Pasty Company,Eating Out,7,3860
30,7,2014,Wild Bean Cafe,Eating Out,1,3859
30,7,2014,McDonalds,Eating Out,6,3853
30,7,2014,ATM Cash Withdrawal,General,20,3833
31,7,2014,Wild Bean Cafe,Eating Out,2,3831
31,7,2014,Subway,Eating Out,8,3823
1,8,2014,Rhino Sports salary,General,1600,5423
1,8,2014,Tescos,Groceries,41,5382
1,8,2014,Wild Bean Cafe,Eating Out,1,5381
1,8,2014,Fabric Club,Eating Out,11,5370
1,8,2014,Fabric Club,Eating Out,7,5363
1,8,2014,Fabric Club,Eating Out,5,5358
1,8,2014,Fabric Club,Eating Out,6,5352
1,8,2014,Fabric Club,Eating Out,9,5343
1,8,2014,Fabric Club,Eating Out,13,5330
1,8,2014,ATM Cash Withdrawal,General,10,5320
3,8,2014,Dominos Pizza,Eating Out,48,5272
3,8,2014,Red Shop,,3,5269
4,8,2014,South West Trains,Transport,38,5231
4,8,2014,Costa Coffee,Eating Out,2,5229
4,8,2014,Pret A Manger,Eating Out,4,5225
4,8,2014,ATM Cash Withdrawal,General,20,5205
5,8,2014,ATM Cash Withdrawal,General,20,5185
6,8,2014,Wild Bean Cafe,Eating Out,2,5183
6,8,2014,ATM Cash Withdrawal,General,20,5163
6,8,2014,Civic Shop,,9,5154
7,8,2014,Cubit and West rent,Rent,440,4714
7,8,2014,Costa Coffee,Eating Out,2,4712
7,8,2014,McDonalds,Eating Out,6,4706
8,8,2014,ASDA,Groceries,54,4652
8,8,2014,Starbucks Coffee,Eating Out,1,4651
8,8,2014,Subway,Eating Out,8,4643
9,8,2014,Restaurant Gordon RamsayPortland Restaurant,Eating Out,28,4615
10,8,2014,ATM Cash Withdrawal,General,10,4605
11,8,2014,South West Trains,Transport,26,4579
11,8,2014,Caffe Nero,Eating Out,1,4578
11,8,2014,McDonalds,Eating Out,8,4570
11,8,2014,Cheam Service Station,,1,4569
12,8,2014,ATM Cash Withdrawal,General,20,4549
13,8,2014,Costa Coffee,Eating Out,2,4547
13,8,2014,Greggs,Eating Out,4,4543
13,8,2014,ATM Cash Withdrawal,General,10,4533
14,8,2014,The West Cornwall Pasty Company,Eating Out,8,4525
15,8,2014,BRGAS-Electricity,Bills,22,4503
15,8,2014,BRGAS-Gas,Bills,28,4475
15,8,2014,Morrisons,Groceries,75,4400
15,8,2014,Caffe Nero,Eating Out,1,4399
15,8,2014,Greggs,Eating Out,7,4392
15,8,2014,Anglo restaurant,Eating Out,33,4359
15,8,2014,ATM Cash Withdrawal,General,20,4339
16,8,2014,LBS Council Tax,Bills,35,4304
16,8,2014,Heaven Club,Eating Out,15,4289
16,8,2014,Heaven Club,Eating Out,13,4276
16,8,2014,Heaven Club,Eating Out,9,4267
16,8,2014,Heaven Club,Eating Out,12,4255
16,8,2014,Heaven Club,Eating Out,13,4242
16,8,2014,Heaven Club,Eating Out,5,4237
16,8,2014,Paying back James,,5,4232
18,8,2014,South West Trains,Transport,38,4194
18,8,2014,McDonalds,Eating Out,4,4190
19,8,2014,Starbucks Coffee,Eating Out,2,4188
19,8,2014,ATM Cash Withdrawal,General,10,4178
20,8,2014,VIRGIN MEDIA PYMTS,Bills,41,4137
20,8,2014,ATM Cash Withdrawal,General,10,4127
21,8,2014,Caffe Nero,Eating Out,1,4126
21,8,2014,Pret A Manger,Eating Out,6,4120
22,8,2014,Morrisons,Groceries,43,4077
22,8,2014,Costa Coffee,Eating Out,2,4075
22,8,2014,Chicken Cottage,Eating Out,7,4068
22,8,2014,Pizza Express,Eating Out,54,4014
23,8,2014,Dominos Pizza,Eating Out,48,3966
24,8,2014,O2,Bills,32,3934
24,8,2014,Anglo restaurant,Eating Out,39,3895
25,8,2014,South West Trains,Transport,26,3869
25,8,2014,Wild Bean Cafe,Eating Out,2,3867
25,8,2014,Subway,Eating Out,7,3860
26,8,2014,Caffe Nero,Eating Out,1,3859
26,8,2014,Subway,Eating Out,8,3851
26,8,2014,Tool Tec,,7,3844
27,8,2014,Costa Coffee,Eating Out,1,3843
27,8,2014,Pret A Manger,Eating Out,6,3837
27,8,2014,ATM Cash Withdrawal,General,20,3817
28,8,2014,Pret A Manger,Eating Out,6,3811
29,8,2014,Waitrose,Groceries,61,3750
29,8,2014,Starbucks Coffee,Eating Out,1,3749
29,8,2014,Greggs,Eating Out,4,3745
29,8,2014,Fabric Club,Eating Out,8,3737
29,8,2014,Fabric Club,Eating Out,5,3732
29,8,2014,Fabric Club,Eating Out,9,3723
29,8,2014,Fabric Club,Eating Out,12,3711
29,8,2014,Fabric Club,Eating Out,12,3699
29,8,2014,Fabric Club,Eating Out,12,3687
29,8,2014,Restaurant Gordon RamsayPortland Restaurant,Eating Out,43,3644
29,8,2014,ATM Cash Withdrawal,General,10,3634
30,8,2014,ATM Cash Withdrawal,General,10,3624
31,8,2014,ATM Cash Withdrawal,General,20,3604
1,9,2014,Rhino Sports salary,General,1600,5204
1,9,2014,South West Trains,Transport,32,5172
2,9,2014,Starbucks Coffee,Eating Out,2,5170
2,9,2014,Chicken Cottage,Eating Out,6,5164
3,9,2014,Costa Coffee,Eating Out,2,5162
5,9,2014,Sainsburys,Groceries,76,5086
5,9,2014,Costa Coffee,Eating Out,2,5084
5,9,2014,The West Cornwall Pasty Company,Eating Out,7,5077
5,9,2014,Restaurant Gordon RamsayPortland Restaurant,Eating Out,39,5038
5,9,2014,ATM Cash Withdrawal,General,20,5018
6,9,2014,Scott's Restaurant,Eating Out,38,4980
6,9,2014,ATM Cash Withdrawal,General,10,4970
7,9,2014,Cubit and West rent,Rent,440,4530
8,9,2014,South West Trains,Transport,30,4500
8,9,2014,Starbucks Coffee,Eating Out,1,4499
9,9,2014,Costa Coffee,Eating Out,1,4498
10,9,2014,Greggs,Eating Out,6,4492
11,9,2014,Wild Bean Cafe,Eating Out,2,4490
11,9,2014,Chicken Cottage,Eating Out,5,4485
11,9,2014,ATM Cash Withdrawal,General,10,4475
12,9,2014,Tescos,Groceries,70,4405
12,9,2014,Caffe Nero,Eating Out,2,4403
12,9,2014,Subway,Eating Out,8,4395
12,9,2014,ATM Cash Withdrawal,General,10,4385
13,9,2014,Anglo restaurant,Eating Out,34,4351
14,9,2014,Restaurant Gordon RamsayPortland Restaurant,Eating Out,24,4327
15,9,2014,BRGAS-Electricity,Bills,29,4298
15,9,2014,BRGAS-Gas,Bills,36,4262
15,9,2014,South West Trains,Transport,27,4235
15,9,2014,Costa Coffee,Eating Out,2,4233
15,9,2014,The West Cornwall Pasty Company,Eating Out,7,4226
15,9,2014,ATM Cash Withdrawal,General,10,4216
16,9,2014,LBS Council Tax,Bills,35,4181
16,9,2014,Costa Coffee,Eating Out,1,4180
17,9,2014,Caffe Nero,Eating Out,2,4178
17,9,2014,The West Cornwall Pasty Company,Eating Out,8,4170
17,9,2014,ATM Cash Withdrawal,General,20,4150
18,9,2014,Wild Bean Cafe,Eating Out,2,4148
18,9,2014,Pret A Manger,Eating Out,7,4141
18,9,2014,Paying back James,,1,4140
19,9,2014,Waitrose,Groceries,58,4082
19,9,2014,Costa Coffee,Eating Out,1,4081
20,9,2014,VIRGIN MEDIA PYMTS,Bills,40,4041
21,9,2014,Anglo restaurant,Eating Out,32,4009
22,9,2014,South West Trains,Transport,38,3971
22,9,2014,Greggs,Eating Out,4,3967
22,9,2014,ATM Cash Withdrawal,General,20,3947
22,9,2014,Civic Shop,,5,3942
23,9,2014,The West Cornwall Pasty Company,Eating Out,8,3934
24,9,2014,O2,Bills,31,3903
24,9,2014,Starbucks Coffee,Eating Out,2,3901
25,9,2014,Starbucks Coffee,Eating Out,2,3899
25,9,2014,McDonalds,Eating Out,7,3892
26,9,2014,Waitrose,Groceries,54,3838
26,9,2014,Starbucks Coffee,Eating Out,1,3837
26,9,2014,Scott's Restaurant,Eating Out,42,3795
26,9,2014,ATM Cash Withdrawal,General,10,3785
28,9,2014,Scott's Restaurant,Eating Out,31,3754
28,9,2014,ATM Cash Withdrawal,General,10,3744
29,9,2014,South West Trains,Transport,27,3717
29,9,2014,Costa Coffee,Eating Out,1,3716
29,9,2014,Subway,Eating Out,8,3708
30,9,2014,Caffe Nero,Eating Out,1,3707
1,10,2014,Rhino Sports salary,General,1600,5307
1,10,2014,Caffe Nero,Eating Out,1,5306
1,10,2014,McDonalds,Eating Out,8,5298
2,10,2014,Costa Coffee,Eating Out,2,5296
2,10,2014,Pret A Manger,Eating Out,4,5292
3,10,2014,Tescos,Groceries,53,5239
3,10,2014,Starbucks Coffee,Eating Out,2,5237
3,10,2014,Pret A Manger,Eating Out,6,5231
5,10,2014,Scott's Restaurant,Eating Out,39,5192
5,10,2014,Red Shop,,5,5187
6,10,2014,South West Trains,Transport,25,5162
6,10,2014,Greggs,Eating Out,6,5156
7,10,2014,Cubit and West rent,Rent,440,4716
7,10,2014,Pret A Manger,Eating Out,6,4710
8,10,2014,Greggs,Eating Out,7,4703
8,10,2014,ATM Cash Withdrawal,General,20,4683
9,10,2014,Starbucks Coffee,Eating Out,2,4681
9,10,2014,Subway,Eating Out,6,4675
9,10,2014,ATM Cash Withdrawal,General,10,4665
10,10,2014,Morrisons,Groceries,52,4613
10,10,2014,Caffe Nero,Eating Out,2,4611
10,10,2014,The West Cornwall Pasty Company,Eating Out,7,4604
10,10,2014,Restaurant Gordon RamsayPortland Restaurant,Eating Out,24,4580
10,10,2014,ATM Cash Withdrawal,General,10,4570
11,10,2014,Restaurant Gordon RamsayPortland Restaurant,Eating Out,38,4532
11,10,2014,ATM Cash Withdrawal,General,20,4512
12,10,2014,Dominos Pizza,Eating Out,34,4478
13,10,2014,South West Trains,Transport,26,4452
13,10,2014,Wild Bean Cafe,Eating Out,2,4450
13,10,2014,Greggs,Eating Out,8,4442
14,10,2014,Costa Coffee,Eating Out,2,4440
14,10,2014,The West Cornwall Pasty Company,Eating Out,8,4432
14,10,2014,ATM Cash Withdrawal,General,10,4422
15,10,2014,BRGAS-Electricity,Bills,33,4389
15,10,2014,BRGAS-Gas,Bills,18,4371
15,10,2014,Wild Bean Cafe,Eating Out,2,4369
15,10,2014,Chicken Cottage,Eating Out,8,4361
15,10,2014,ATM Cash Withdrawal,General,20,4341
16,10,2014,LBS Council Tax,Bills,35,4306
16,10,2014,Caffe Nero,Eating Out,2,4304
16,10,2014,Greggs,Eating Out,8,4296
16,10,2014,ATM Cash Withdrawal,General,10,4286
17,10,2014,Tescos,Groceries,63,4223
17,10,2014,Costa Coffee,Eating Out,2,4221
17,10,2014,Subway,Eating Out,8,4213
17,10,2014,ATM Cash Withdrawal,General,10,4203
18,10,2014,Pizza Express,Eating Out,53,4150
19,10,2014,Dominos Pizza,Eating Out,34,4116
19,10,2014,ATM Cash Withdrawal,General,10,4106
20,10,2014,VIRGIN MEDIA PYMTS,Bills,37,4069
20,10,2014,South West Trains,Transport,36,4033
20,10,2014,Starbucks Coffee,Eating Out,2,4031
20,10,2014,McDonalds,Eating Out,5,4026
21,10,2014,Starbucks Coffee,Eating Out,2,4024
21,10,2014,Subway,Eating Out,5,4019
21,10,2014,ATM Cash Withdrawal,General,20,3999
22,10,2014,Wild Bean Cafe,Eating Out,2,3997
22,10,2014,Greggs,Eating Out,7,3990
23,10,2014,Costa Coffee,Eating Out,2,3988
23,10,2014,Greggs,Eating Out,8,3980
23,10,2014,Red Shop,,3,3977
24,10,2014,O2,Bills,27,3950
24,10,2014,Waitrose,Groceries,42,3908
24,10,2014,The West Cornwall Pasty Company,Eating Out,5,3903
24,10,2014,ATM Cash Withdrawal,General,10,3893
25,10,2014,Anglo restaurant,Eating Out,59,3834
25,10,2014,Cheam Service Station,,1,3833
26,10,2014,Pizza Express,Eating Out,57,3776
27,10,2014,South West Trains,Transport,26,3750
27,10,2014,Wild Bean Cafe,Eating Out,1,3749
27,10,2014,Pret A Manger,Eating Out,6,3743
28,10,2014,Caffe Nero,Eating Out,2,3741
28,10,2014,Subway,Eating Out,8,3733
28,10,2014,Civic Shop,,1,3732
29,10,2014,Wild Bean Cafe,Eating Out,2,3730
29,10,2014,Subway,Eating Out,4,3726
30,10,2014,Starbucks Coffee,Eating Out,1,3725
30,10,2014,ATM Cash Withdrawal,General,20,3705
30,10,2014,Tool Tec,,2,3703
31,10,2014,Sainsburys,Groceries,69,3634
31,10,2014,Costa Coffee,Eating Out,2,3632
31,10,2014,ATM Cash Withdrawal,General,10,3622
1,11,2014,Rhino Sports salary,General,1600,5222
1,11,2014,Scott's Restaurant,Eating Out,55,5167
3,11,2014,South West Trains,Transport,27,5140
3,11,2014,Wild Bean Cafe,Eating Out,2,5138
3,11,2014,Greggs,Eating Out,8,5130
3,11,2014,ATM Cash Withdrawal,General,20,5110
4,11,2014,Starbucks Coffee,Eating Out,2,5108
4,11,2014,Subway,Eating Out,5,5103
5,11,2014,Wild Bean Cafe,Eating Out,2,5101
5,11,2014,Greggs,Eating Out,6,5095
5,11,2014,Tool Tec,,5,5090
6,11,2014,Costa Coffee,Eating Out,2,5088
7,11,2014,Cubit and West rent,Rent,440,4648
7,11,2014,Morrisons,Groceries,75,4573
7,11,2014,The West Cornwall Pasty Company,Eating Out,7,4566
7,11,2014,Dominos Pizza,Eating Out,51,4515
8,11,2014,ATM Cash Withdrawal,General,10,4505
9,11,2014,ATM Cash Withdrawal,General,10,4495
9,11,2014,Civic Shop,,7,4488
10,11,2014,South West Trains,Transport,34,4454
10,11,2014,Starbucks Coffee,Eating Out,1,4453
10,11,2014,Subway,Eating Out,6,4447
11,11,2014,Costa Coffee,Eating Out,2,4445
11,11,2014,Tool Shop,,4,4441
12,11,2014,Wild Bean Cafe,Eating Out,2,4439
12,11,2014,Chicken Cottage,Eating Out,6,4433
13,11,2014,Caffe Nero,Eating Out,2,4431
14,11,2014,Sainsburys,Groceries,79,4352
14,11,2014,Subway,Eating Out,4,4348
14,11,2014,ATM Cash Withdrawal,General,10,4338
15,11,2014,BRGAS-Electricity,Bills,48,4290
15,11,2014,BRGAS-Gas,Bills,40,4250
15,11,2014,Anglo restaurant,Eating Out,33,4217
16,11,2014,LBS Council Tax,Bills,35,4182
17,11,2014,South West Trains,Transport,29,4153
17,11,2014,Pret A Manger,Eating Out,7,4146
18,11,2014,Costa Coffee,Eating Out,2,4144
18,11,2014,The West Cornwall Pasty Company,Eating Out,6,4138
19,11,2014,Costa Coffee,Eating Out,1,4137
19,11,2014,Subway,Eating Out,7,4130
20,11,2014,VIRGIN MEDIA PYMTS,Bills,31,4099
20,11,2014,Wild Bean Cafe,Eating Out,1,4098
20,11,2014,Pret A Manger,Eating Out,6,4092
20,11,2014,ATM Cash Withdrawal,General,10,4082
21,11,2014,Waitrose,Groceries,78,4004
21,11,2014,Wild Bean Cafe,Eating Out,1,4003
21,11,2014,Subway,Eating Out,7,3996
22,11,2014,ATM Cash Withdrawal,General,20,3976
23,11,2014,ATM Cash Withdrawal,General,10,3966
24,11,2014,O2,Bills,30,3936
24,11,2014,South West Trains,Transport,28,3908
24,11,2014,Caffe Nero,Eating Out,2,3906
24,11,2014,The West Cornwall Pasty Company,Eating Out,5,3901
25,11,2014,Costa Coffee,Eating Out,2,3899
25,11,2014,Greggs,Eating Out,6,3893
26,11,2014,Costa Coffee,Eating Out,2,3891
26,11,2014,Subway,Eating Out,7,3884
26,11,2014,ATM Cash Withdrawal,General,10,3874
27,11,2014,Costa Coffee,Eating Out,1,3873
28,11,2014,Tescos,Groceries,73,3800
28,11,2014,Chicken Cottage,Eating Out,7,3793
28,11,2014,Restaurant Gordon RamsayPortland Restaurant,Eating Out,48,3745
28,11,2014,ATM Cash Withdrawal,General,10,3735
29,11,2014,Anglo restaurant,Eating Out,36,3699
29,11,2014,ATM Cash Withdrawal,General,20,3679
30,11,2014,Dominos Pizza,Eating Out,42,3637
1,12,2014,Rhino Sports salary,General,1600,5237
1,12,2014,South West Trains,Transport,37,5200
2,12,2014,Caffe Nero,Eating Out,1,5199
2,12,2014,Paying back Julie,,7,5192
3,12,2014,Costa Coffee,Eating Out,2,5190
3,12,2014,Subway,Eating Out,5,5185
3,12,2014,ATM Cash Withdrawal,General,10,5175
4,12,2014,Caffe Nero,Eating Out,2,5173
5,12,2014,ASDA,Groceries,39,5134
5,12,2014,Caffe Nero,Eating Out,2,5132
5,12,2014,McDonalds,Eating Out,6,5126
5,12,2014,ATM Cash Withdrawal,General,20,5106
7,12,2014,Cubit and West rent,Rent,440,4666
7,12,2014,Pizza Express,Eating Out,43,4623
8,12,2014,South West Trains,Transport,36,4587
8,12,2014,Starbucks Coffee,Eating Out,1,4586
8,12,2014,McDonalds,Eating Out,6,4580
8,12,2014,ATM Cash Withdrawal,General,20,4560
9,12,2014,Starbucks Coffee,Eating Out,1,4559
9,12,2014,The West Cornwall Pasty Company,Eating Out,5,4554
9,12,2014,Red Shop,,5,4549
10,12,2014,Caffe Nero,Eating Out,2,4547
10,12,2014,ATM Cash Withdrawal,General,20,4527
11,12,2014,Costa Coffee,Eating Out,2,4525
12,12,2014,Waitrose,Groceries,59,4466
12,12,2014,Caffe Nero,Eating Out,2,4464
12,12,2014,The West Cornwall Pasty Company,Eating Out,8,4456
12,12,2014,The Grand Pub,Eating Out,8,4448
12,12,2014,ATM Cash Withdrawal,General,20,4428
14,12,2014,Scott's Restaurant,Eating Out,45,4383
15,12,2014,BRGAS-Electricity,Bills,35,4348
15,12,2014,BRGAS-Gas,Bills,26,4322
15,12,2014,South West Trains,Transport,29,4293
15,12,2014,Greggs,Eating Out,7,4286
16,12,2014,LBS Council Tax,Bills,35,4251
16,12,2014,Subway,Eating Out,7,4244
17,12,2014,Starbucks Coffee,Eating Out,1,4243
17,12,2014,Greggs,Eating Out,4,4239
17,12,2014,Cheam Service Station,,6,4233
18,12,2014,Wild Bean Cafe,Eating Out,1,4232
18,12,2014,Chicken Cottage,Eating Out,4,4228
18,12,2014,ATM Cash Withdrawal,General,20,4208
18,12,2014,Paying back James,,6,4202
19,12,2014,ASDA,Groceries,79,4123
19,12,2014,Starbucks Coffee,Eating Out,1,4122
19,12,2014,Pret A Manger,Eating Out,4,4118
20,12,2014,VIRGIN MEDIA PYMTS,Bills,44,4074
20,12,2014,Anglo restaurant,Eating Out,45,4029
20,12,2014,ATM Cash Withdrawal,General,20,4009
21,12,2014,Scott's Restaurant,Eating Out,56,3953
21,12,2014,ATM Cash Withdrawal,General,10,3943
21,12,2014,Paying back Julie,,5,3938
22,12,2014,South West Trains,Transport,34,3904
22,12,2014,Costa Coffee,Eating Out,1,3903
22,12,2014,Subway,Eating Out,7,3896
23,12,2014,Starbucks Coffee,Eating Out,2,3894
24,12,2014,O2,Bills,29,3865
25,12,2014,Wild Bean Cafe,Eating Out,1,3864
25,12,2014,Pret A Manger,Eating Out,5,3859
26,12,2014,Morrisons,Groceries,39,3820
26,12,2014,Scott's Restaurant,Eating Out,25,3795
26,12,2014,ATM Cash Withdrawal,General,10,3785
27,12,2014,Pizza Express,Eating Out,39,3746
29,12,2014,South West Trains,Transport,30,3716
29,12,2014,ATM Cash Withdrawal,General,10,3706
31,12,2014,Starbucks Coffee,Eating Out,2,3704
31,12,2014,Pret A Manger,Eating Out,4,3700
1,1,2015,Rhino Sports salary,General,1600,5300
1,1,2015,Costa Coffee,Eating Out,2,5298
1,1,2015,Greggs,Eating Out,6,5292
2,1,2015,Sainsburys,Groceries,60,5232
2,1,2015,Wild Bean Cafe,Eating Out,2,5230
5,1,2015,South West Trains,Transport,31,5199
5,1,2015,Costa Coffee,Eating Out,2,5197
5,1,2015,McDonalds,Eating Out,5,5192
5,1,2015,ATM Cash Withdrawal,General,10,5182
6,1,2015,Costa Coffee,Eating Out,2,5180
6,1,2015,Subway,Eating Out,4,5176
7,1,2015,Cubit and West rent,Rent,440,4736
7,1,2015,Wild Bean Cafe,Eating Out,1,4735
7,1,2015,Tool Shop,,3,4732
8,1,2015,Caffe Nero,Eating Out,1,4731
8,1,2015,Subway,Eating Out,7,4724
9,1,2015,ASDA,Groceries,65,4659
9,1,2015,Starbucks Coffee,Eating Out,2,4657
9,1,2015,Scott's Restaurant,Eating Out,39,4618
10,1,2015,ATM Cash Withdrawal,General,20,4598
12,1,2015,South West Trains,Transport,24,4574
12,1,2015,Starbucks Coffee,Eating Out,2,4572
12,1,2015,Chicken Cottage,Eating Out,7,4565
13,1,2015,Wild Bean Cafe,Eating Out,1,4564
13,1,2015,Greggs,Eating Out,7,4557
14,1,2015,Caffe Nero,Eating Out,1,4556
14,1,2015,The West Cornwall Pasty Company,Eating Out,6,4550
15,1,2015,BRGAS-Electricity,Bills,54,4496
15,1,2015,BRGAS-Gas,Bills,78,4418
15,1,2015,Costa Coffee,Eating Out,2,4416
16,1,2015,LBS Council Tax,Bills,35,4381
16,1,2015,Morrisons,Groceries,53,4328
16,1,2015,Wild Bean Cafe,Eating Out,2,4326
16,1,2015,Cheam Service Station,,8,4318
18,1,2015,Scott's Restaurant,Eating Out,24,4294
19,1,2015,South West Trains,Transport,25,4269
19,1,2015,Costa Coffee,Eating Out,1,4268
19,1,2015,Subway,Eating Out,6,4262
20,1,2015,VIRGIN MEDIA PYMTS,Bills,25,4237
20,1,2015,Starbucks Coffee,Eating Out,2,4235
21,1,2015,The West Cornwall Pasty Company,Eating Out,8,4227
21,1,2015,ATM Cash Withdrawal,General,10,4217
22,1,2015,Costa Coffee,Eating Out,1,4216
23,1,2015,ASDA,Groceries,61,4155
23,1,2015,Caffe Nero,Eating Out,2,4153
23,1,2015,Restaurant Gordon RamsayPortland Restaurant,Eating Out,28,4125
24,1,2015,O2,Bills,28,4097
26,1,2015,South West Trains,Transport,27,4070
26,1,2015,Costa Coffee,Eating Out,1,4069
26,1,2015,Subway,Eating Out,8,4061
27,1,2015,Pret A Manger,Eating Out,6,4055
27,1,2015,ATM Cash Withdrawal,General,10,4045
28,1,2015,Caffe Nero,Eating Out,1,4044
28,1,2015,McDonalds,Eating Out,7,4037
28,1,2015,Red Shop,,7,4030
30,1,2015,ASDA,Groceries,48,3982
30,1,2015,Wild Bean Cafe,Eating Out,2,3980
30,1,2015,Subway,Eating Out,5,3975
30,1,2015,Dominos Pizza,Eating Out,48,3927
31,1,2015,ATM Cash Withdrawal,General,10,3917
1,2,2015,Rhino Sports salary,General,1600,5517
1,2,2015,Scott's Restaurant,Eating Out,58,5459
1,2,2015,ATM Cash Withdrawal,General,20,5439
2,2,2015,South West Trains,Transport,33,5406
2,2,2015,Caffe Nero,Eating Out,2,5404
2,2,2015,The West Cornwall Pasty Company,Eating Out,8,5396
2,2,2015,ATM Cash Withdrawal,General,10,5386
3,2,2015,Pret A Manger,Eating Out,4,5382
5,2,2015,Wild Bean Cafe,Eating Out,2,5380
6,2,2015,Morrisons,Groceries,47,5333
6,2,2015,Caffe Nero,Eating Out,2,5331
6,2,2015,Pret A Manger,Eating Out,5,5326
7,2,2015,Cubit and West rent,Rent,440,4886
7,2,2015,Pizza Express,Eating Out,52,4834
9,2,2015,South West Trains,Transport,27,4807
9,2,2015,Costa Coffee,Eating Out,2,4805
10,2,2015,Starbucks Coffee,Eating Out,1,4804
10,2,2015,Greggs,Eating Out,4,4800
11,2,2015,Wild Bean Cafe,Eating Out,2,4798
11,2,2015,Red Shop,,3,4795
12,2,2015,Caffe Nero,Eating Out,2,4793
12,2,2015,Pret A Manger,Eating Out,5,4788
13,2,2015,Waitrose,Groceries,51,4737
13,2,2015,Caffe Nero,Eating Out,1,4736
13,2,2015,McDonalds,Eating Out,7,4729
14,2,2015,Pizza Express,Eating Out,32,4697
15,2,2015,BRGAS-Electricity,Bills,29,4668
15,2,2015,BRGAS-Gas,Bills,30,4638
15,2,2015,Scott's Restaurant,Eating Out,24,4614
16,2,2015,LBS Council Tax,Bills,35,4579
16,2,2015,South West Trains,Transport,30,4549
16,2,2015,Chicken Cottage,Eating Out,8,4541
16,2,2015,Cheam Service Station,,8,4533
17,2,2015,Starbucks Coffee,Eating Out,1,4532
17,2,2015,ATM Cash Withdrawal,General,20,4512
18,2,2015,Costa Coffee,Eating Out,2,4510
18,2,2015,Pret A Manger,Eating Out,7,4503
19,2,2015,Wild Bean Cafe,Eating Out,2,4501
19,2,2015,McDonalds,Eating Out,7,4494
20,2,2015,VIRGIN MEDIA PYMTS,Bills,33,4461
20,2,2015,Waitrose,Groceries,46,4415
20,2,2015,Heaven Club,Eating Out,15,4400
20,2,2015,Heaven Club,Eating Out,14,4386
20,2,2015,ATM Cash Withdrawal,General,10,4376
21,2,2015,Fabric Club,Eating Out,15,4361
21,2,2015,Fabric Club,Eating Out,12,4349
21,2,2015,Fabric Club,Eating Out,15,4334
21,2,2015,Dominos Pizza,Eating Out,25,4309
23,2,2015,South West Trains,Transport,27,4282
23,2,2015,Costa Coffee,Eating Out,2,4280
24,2,2015,O2,Bills,28,4252
24,2,2015,Starbucks Coffee,Eating Out,2,4250
24,2,2015,McDonalds,Eating Out,7,4243
25,2,2015,Caffe Nero,Eating Out,1,4242
25,2,2015,Pret A Manger,Eating Out,6,4236
26,2,2015,Greggs,Eating Out,6,4230
27,2,2015,Sainsburys,Groceries,61,4169
27,2,2015,Caffe Nero,Eating Out,2,4167
27,2,2015,Anglo restaurant,Eating Out,25,4142
28,2,2015,Restaurant Gordon RamsayPortland Restaurant,Eating Out,56,4086
1,3,2015,Rhino Sports salary,General,1600,5686
1,3,2015,Dominos Pizza,Eating Out,30,5656
1,3,2015,ATM Cash Withdrawal,General,10,5646
2,3,2015,South West Trains,Transport,27,5619
2,3,2015,Starbucks Coffee,Eating Out,2,5617
2,3,2015,Chicken Cottage,Eating Out,7,5610
2,3,2015,ATM Cash Withdrawal,General,20,5590
4,3,2015,Pret A Manger,Eating Out,6,5584
4,3,2015,ATM Cash Withdrawal,General,20,5564
6,3,2015,Sainsburys,Groceries,61,5503
6,3,2015,Costa Coffee,Eating Out,2,5501
6,3,2015,Restaurant Gordon RamsayPortland Restaurant,Eating Out,49,5452
6,3,2015,ATM Cash Withdrawal,General,10,5442
7,3,2015,Cubit and West rent,Rent,440,5002
8,3,2015,Anglo restaurant,Eating Out,50,4952
9,3,2015,South West Trains,Transport,27,4925
9,3,2015,Caffe Nero,Eating Out,1,4924
9,3,2015,ATM Cash Withdrawal,General,20,4904
10,3,2015,Wild Bean Cafe,Eating Out,1,4903
10,3,2015,Subway,Eating Out,4,4899
10,3,2015,ATM Cash Withdrawal,General,20,4879
11,3,2015,Wild Bean Cafe,Eating Out,1,4878
11,3,2015,Chicken Cottage,Eating Out,5,4873
11,3,2015,ATM Cash Withdrawal,General,10,4863
12,3,2015,Wild Bean Cafe,Eating Out,1,4862
12,3,2015,Greggs,Eating Out,4,4858
12,3,2015,ATM Cash Withdrawal,General,10,4848
13,3,2015,Tescos,Groceries,77,4771
13,3,2015,Wild Bean Cafe,Eating Out,1,4770
13,3,2015,Greggs,Eating Out,4,4766
13,3,2015,Pizza Express,Eating Out,44,4722
15,3,2015,BRGAS-Electricity,Bills,33,4689
15,3,2015,BRGAS-Gas,Bills,23,4666
16,3,2015,LBS Council Tax,Bills,35,4631
16,3,2015,South West Trains,Transport,35,4596
16,3,2015,Caffe Nero,Eating Out,2,4594
16,3,2015,The West Cornwall Pasty Company,Eating Out,4,4590
17,3,2015,Costa Coffee,Eating Out,1,4589
17,3,2015,McDonalds,Eating Out,5,4584
17,3,2015,ATM Cash Withdrawal,General,10,4574
18,3,2015,Costa Coffee,Eating Out,2,4572
18,3,2015,Subway,Eating Out,7,4565
19,3,2015,Costa Coffee,Eating Out,2,4563
19,3,2015,Pret A Manger,Eating Out,4,4559
20,3,2015,VIRGIN MEDIA PYMTS,Bills,43,4516
20,3,2015,Morrisons,Groceries,49,4467
20,3,2015,Caffe Nero,Eating Out,2,4465
20,3,2015,Pret A Manger,Eating Out,6,4459
20,3,2015,Heaven Club,Eating Out,8,4451
20,3,2015,Heaven Club,Eating Out,12,4439
20,3,2015,Restaurant Gordon RamsayPortland Restaurant,Eating Out,32,4407
20,3,2015,Paying back James,,1,4406
23,3,2015,South West Trains,Transport,29,4377
23,3,2015,Wild Bean Cafe,Eating Out,2,4375
23,3,2015,Chicken Cottage,Eating Out,5,4370
24,3,2015,O2,Bills,25,4345
24,3,2015,Chicken Cottage,Eating Out,7,4338
25,3,2015,Caffe Nero,Eating Out,2,4336
25,3,2015,Chicken Cottage,Eating Out,6,4330
25,3,2015,ATM Cash Withdrawal,General,20,4310
26,3,2015,Costa Coffee,Eating Out,2,4308
26,3,2015,The West Cornwall Pasty Company,Eating Out,5,4303
26,3,2015,ATM Cash Withdrawal,General,10,4293
27,3,2015,ASDA,Groceries,81,4212
27,3,2015,Wild Bean Cafe,Eating Out,1,4211
30,3,2015,South West Trains,Transport,32,4179
30,3,2015,Starbucks Coffee,Eating Out,1,4178
30,3,2015,Subway,Eating Out,6,4172
31,3,2015,Caffe Nero,Eating Out,2,4170
31,3,2015,The West Cornwall Pasty Company,Eating Out,7,4163
1,4,2015,Rhino Sports salary,General,1600,5763
1,4,2015,Costa Coffee,Eating Out,2,5761
1,4,2015,Subway,Eating Out,8,5753
1,4,2015,Tool Tec,,3,5750
2,4,2015,Costa Coffee,Eating Out,2,5748
2,4,2015,McDonalds,Eating Out,4,5744
3,4,2015,Waitrose,Groceries,43,5701
3,4,2015,Costa Coffee,Eating Out,2,5699
3,4,2015,ATM Cash Withdrawal,General,10,5689
3,4,2015,Paying back James,,6,5683
4,4,2015,Dominos Pizza,Eating Out,46,5637
4,4,2015,ATM Cash Withdrawal,General,20,5617
5,4,2015,Anglo restaurant,Eating Out,43,5574
6,4,2015,South West Trains,Transport,33,5541
6,4,2015,Wild Bean Cafe,Eating Out,2,5539
6,4,2015,Civic Shop,,5,5534
7,4,2015,Cubit and West rent,Rent,440,5094
7,4,2015,Costa Coffee,Eating Out,2,5092
7,4,2015,ATM Cash Withdrawal,General,10,5082
8,4,2015,Caffe Nero,Eating Out,1,5081
8,4,2015,Pret A Manger,Eating Out,8,5073
10,4,2015,Sainsburys,Groceries,64,5009
10,4,2015,Costa Coffee,Eating Out,1,5008
10,4,2015,Chicken Cottage,Eating Out,7,5001
10,4,2015,Scott's Restaurant,Eating Out,25,4976
11,4,2015,The Grand Pub,Eating Out,10,4966
11,4,2015,The Grand Pub,Eating Out,15,4951
11,4,2015,The Grand Pub,Eating Out,13,4938
11,4,2015,The Grand Pub,Eating Out,7,4931
11,4,2015,ATM Cash Withdrawal,General,20,4911
13,4,2015,South West Trains,Transport,30,4881
13,4,2015,Caffe Nero,Eating Out,2,4879
13,4,2015,Subway,Eating Out,5,4874
13,4,2015,ATM Cash Withdrawal,General,20,4854
14,4,2015,Starbucks Coffee,Eating Out,1,4853
14,4,2015,Greggs,Eating Out,7,4846
15,4,2015,BRGAS-Electricity,Bills,29,4817
15,4,2015,BRGAS-Gas,Bills,21,4796
15,4,2015,Costa Coffee,Eating Out,1,4795
15,4,2015,Greggs,Eating Out,4,4791
15,4,2015,ATM Cash Withdrawal,General,10,4781
16,4,2015,LBS Council Tax,Bills,35,4746
16,4,2015,Costa Coffee,Eating Out,1,4745
16,4,2015,ATM Cash Withdrawal,General,10,4735
16,4,2015,Tool Shop,,7,4728
17,4,2015,ASDA,Groceries,77,4651
17,4,2015,Greggs,Eating Out,5,4646
17,4,2015,Fabric Club,Eating Out,15,4631
17,4,2015,Fabric Club,Eating Out,16,4615
17,4,2015,Anglo restaurant,Eating Out,45,4570
17,4,2015,Cheam Service Station,,6,4564
18,4,2015,Restaurant Gordon RamsayPortland Restaurant,Eating Out,50,4514
18,4,2015,ATM Cash Withdrawal,General,10,4504
18,4,2015,Tool Shop,,4,4500
20,4,2015,VIRGIN MEDIA PYMTS,Bills,30,4470
20,4,2015,South West Trains,Transport,25,4445
20,4,2015,Costa Coffee,Eating Out,2,4443
20,4,2015,ATM Cash Withdrawal,General,20,4423
21,4,2015,Caffe Nero,Eating Out,1,4422
21,4,2015,Greggs,Eating Out,5,4417
22,4,2015,Wild Bean Cafe,Eating Out,2,4415
22,4,2015,Pret A Manger,Eating Out,7,4408
23,4,2015,Wild Bean Cafe,Eating Out,2,4406
23,4,2015,Civic Shop,,6,4400
24,4,2015,O2,Bills,27,4373
24,4,2015,Waitrose,Groceries,67,4306
24,4,2015,Wild Bean Cafe,Eating Out,1,4305
24,4,2015,Subway,Eating Out,4,4301
24,4,2015,ATM Cash Withdrawal,General,10,4291
25,4,2015,Heaven Club,Eating Out,5,4286
25,4,2015,Heaven Club,Eating Out,9,4277
25,4,2015,Heaven Club,Eating Out,14,4263
25,4,2015,Heaven Club,Eating Out,5,4258
25,4,2015,Heaven Club,Eating Out,5,4253
25,4,2015,Anglo restaurant,Eating Out,49,4204
25,4,2015,ATM Cash Withdrawal,General,20,4184
25,4,2015,Cheam Service Station,,3,4181
27,4,2015,South West Trains,Transport,32,4149
27,4,2015,Costa Coffee,Eating Out,2,4147
27,4,2015,The West Cornwall Pasty Company,Eating Out,7,4140
27,4,2015,ATM Cash Withdrawal,General,10,4130
28,4,2015,Starbucks Coffee,Eating Out,2,4128
28,4,2015,Greggs,Eating Out,7,4121
29,4,2015,Caffe Nero,Eating Out,2,4119
29,4,2015,Chicken Cottage,Eating Out,8,4111
30,4,2015,McDonalds,Eating Out,5,4106
1,5,2015,Rhino Sports salary,General,1600,5706
1,5,2015,Tescos,Groceries,41,5665
1,5,2015,Costa Coffee,Eating Out,2,5663
1,5,2015,Scott's Restaurant,Eating Out,26,5637
1,5,2015,ATM Cash Withdrawal,General,20,5617
2,5,2015,Scott's Restaurant,Eating Out,53,5564
4,5,2015,South West Trains,Transport,33,5531
4,5,2015,Starbucks Coffee,Eating Out,1,5530
4,5,2015,Pret A Manger,Eating Out,4,5526
5,5,2015,Costa Coffee,Eating Out,2,5524
5,5,2015,ATM Cash Withdrawal,General,10,5514
5,5,2015,Tool Shop,,5,5509
6,5,2015,Starbucks Coffee,Eating Out,2,5507
6,5,2015,Pret A Manger,Eating Out,6,5501
7,5,2015,Cubit and West rent,Rent,440,5061
7,5,2015,Costa Coffee,Eating Out,2,5059
8,5,2015,Tescos,Groceries,75,4984
8,5,2015,Starbucks Coffee,Eating Out,2,4982
8,5,2015,Restaurant Gordon RamsayPortland Restaurant,Eating Out,42,4940
8,5,2015,Paying back Julie,,5,4935
9,5,2015,Restaurant Gordon RamsayPortland Restaurant,Eating Out,52,4883
10,5,2015,ATM Cash Withdrawal,General,20,4863
11,5,2015,South West Trains,Transport,37,4826
11,5,2015,Wild Bean Cafe,Eating Out,2,4824
12,5,2015,Subway,Eating Out,8,4816
13,5,2015,Starbucks Coffee,Eating Out,2,4814
13,5,2015,McDonalds,Eating Out,8,4806
13,5,2015,ATM Cash Withdrawal,General,10,4796
14,5,2015,The West Cornwall Pasty Company,Eating Out,5,4791
15,5,2015,BRGAS-Electricity,Bills,34,4757
15,5,2015,BRGAS-Gas,Bills,37,4720
15,5,2015,Waitrose,Groceries,78,4642
15,5,2015,Caffe Nero,Eating Out,2,4640
15,5,2015,The West Cornwall Pasty Company,Eating Out,6,4634
15,5,2015,Scott's Restaurant,Eating Out,39,4595
15,5,2015,ATM Cash Withdrawal,General,20,4575
16,5,2015,LBS Council Tax,Bills,35,4540
16,5,2015,Dominos Pizza,Eating Out,35,4505
17,5,2015,ATM Cash Withdrawal,General,10,4495
18,5,2015,South West Trains,Transport,29,4466
18,5,2015,Costa Coffee,Eating Out,2,4464
19,5,2015,Wild Bean Cafe,Eating Out,1,4463
19,5,2015,Chicken Cottage,Eating Out,5,4458
19,5,2015,ATM Cash Withdrawal,General,20,4438
20,5,2015,VIRGIN MEDIA PYMTS,Bills,22,4416
20,5,2015,ATM Cash Withdrawal,General,10,4406
21,5,2015,Caffe Nero,Eating Out,2,4404
21,5,2015,Pret A Manger,Eating Out,8,4396
22,5,2015,Tescos,Groceries,78,4318
22,5,2015,Caffe Nero,Eating Out,1,4317
22,5,2015,Restaurant Gordon RamsayPortland Restaurant,Eating Out,30,4287
22,5,2015,ATM Cash Withdrawal,General,20,4267
23,5,2015,Restaurant Gordon RamsayPortland Restaurant,Eating Out,27,4240
23,5,2015,ATM Cash Withdrawal,General,10,4230
24,5,2015,O2,Bills,25,4205
24,5,2015,Anglo restaurant,Eating Out,29,4176
25,5,2015,South West Trains,Transport,25,4151
25,5,2015,Greggs,Eating Out,6,4145
26,5,2015,Costa Coffee,Eating Out,2,4143
27,5,2015,Wild Bean Cafe,Eating Out,2,4141
27,5,2015,Subway,Eating Out,4,4137
28,5,2015,Starbucks Coffee,Eating Out,2,4135
28,5,2015,Tool Tec,,1,4134
29,5,2015,Waitrose,Groceries,61,4073
29,5,2015,Starbucks Coffee,Eating Out,1,4072
29,5,2015,Greggs,Eating Out,6,4066
31,5,2015,Anglo restaurant,Eating Out,44,4022
31,5,2015,ATM Cash Withdrawal,General,10,4012
1,6,2015,Rhino Sports salary,General,1600,5612
1,6,2015,South West Trains,Transport,29,5583
1,6,2015,The West Cornwall Pasty Company,Eating Out,5,5578
2,6,2015,Caffe Nero,Eating Out,2,5576
2,6,2015,McDonalds,Eating Out,4,5572
3,6,2015,Caffe Nero,Eating Out,2,5570
3,6,2015,The West Cornwall Pasty Company,Eating Out,4,5566
3,6,2015,ATM Cash Withdrawal,General,10,5556
4,6,2015,Starbucks Coffee,Eating Out,1,5555
5,6,2015,Sainsburys,Groceries,51,5504
5,6,2015,Pret A Manger,Eating Out,8,5496
7,6,2015,Cubit and West rent,Rent,440,5056
7,6,2015,Dominos Pizza,Eating Out,40,5016
7,6,2015,Civic Shop,,6,5010
8,6,2015,South West Trains,Transport,29,4981
8,6,2015,Caffe Nero,Eating Out,2,4979
8,6,2015,McDonalds,Eating Out,8,4971
9,6,2015,Caffe Nero,Eating Out,2,4969
9,6,2015,The West Cornwall Pasty Company,Eating Out,4,4965
11,6,2015,Caffe Nero,Eating Out,1,4964
11,6,2015,The West Cornwall Pasty Company,Eating Out,5,4959
12,6,2015,ASDA,Groceries,58,4901
12,6,2015,Costa Coffee,Eating Out,2,4899
12,6,2015,ATM Cash Withdrawal,General,20,4879
14,6,2015,Pizza Express,Eating Out,37,4842
15,6,2015,BRGAS-Electricity,Bills,27,4815
15,6,2015,BRGAS-Gas,Bills,23,4792
15,6,2015,South West Trains,Transport,36,4756
15,6,2015,Starbucks Coffee,Eating Out,2,4754
15,6,2015,Pret A Manger,Eating Out,5,4749
16,6,2015,LBS Council Tax,Bills,35,4714
16,6,2015,Wild Bean Cafe,Eating Out,2,4712
17,6,2015,Costa Coffee,Eating Out,2,4710
18,6,2015,ATM Cash Withdrawal,General,10,4700
18,6,2015,Paying back Julie,,7,4693
19,6,2015,ASDA,Groceries,66,4627
19,6,2015,Starbucks Coffee,Eating Out,1,4626
19,6,2015,Pret A Manger,Eating Out,6,4620
20,6,2015,VIRGIN MEDIA PYMTS,Bills,43,4577
22,6,2015,South West Trains,Transport,28,4549
22,6,2015,Costa Coffee,Eating Out,2,4547
22,6,2015,Pret A Manger,Eating Out,5,4542
22,6,2015,ATM Cash Withdrawal,General,10,4532
23,6,2015,Caffe Nero,Eating Out,2,4530
23,6,2015,Subway,Eating Out,5,4525
23,6,2015,ATM Cash Withdrawal,General,10,4515
24,6,2015,O2,Bills,32,4483
24,6,2015,Costa Coffee,Eating Out,2,4481
25,6,2015,Starbucks Coffee,Eating Out,1,4480
25,6,2015,The West Cornwall Pasty Company,Eating Out,5,4475
25,6,2015,ATM Cash Withdrawal,General,10,4465
26,6,2015,Morrisons,Groceries,76,4389
26,6,2015,Caffe Nero,Eating Out,2,4387
26,6,2015,The West Cornwall Pasty Company,Eating Out,5,4382
26,6,2015,The Grand Pub,Eating Out,16,4366
28,6,2015,Paying back James,,1,4365
29,6,2015,South West Trains,Transport,26,4339
29,6,2015,Costa Coffee,Eating Out,2,4337
30,6,2015,Starbucks Coffee,Eating Out,1,4336
1,7,2015,Rhino Sports salary,General,1600,5936
1,7,2015,Caffe Nero,Eating Out,1,5935
1,7,2015,Chicken Cottage,Eating Out,6,5929
2,7,2015,Wild Bean Cafe,Eating Out,2,5927
2,7,2015,Chicken Cottage,Eating Out,6,5921
3,7,2015,Tescos,Groceries,42,5879
3,7,2015,Caffe Nero,Eating Out,2,5877
3,7,2015,Greggs,Eating Out,5,5872
3,7,2015,Restaurant Gordon RamsayPortland Restaurant,Eating Out,29,5843
4,7,2015,ATM Cash Withdrawal,General,20,5823
5,7,2015,Civic Shop,,7,5816
6,7,2015,South West Trains,Transport,31,5785
6,7,2015,Starbucks Coffee,Eating Out,2,5783
6,7,2015,Tool Shop,,9,5774
7,7,2015,Cubit and West rent,Rent,440,5334
7,7,2015,Costa Coffee,Eating Out,2,5332
8,7,2015,Red Shop,,6,5326
9,7,2015,Caffe Nero,Eating Out,1,5325
9,7,2015,Greggs,Eating Out,6,5319
10,7,2015,Waitrose,Groceries,69,5250
10,7,2015,Wild Bean Cafe,Eating Out,1,5249
10,7,2015,Tool Shop,,1,5248
12,7,2015,Anglo restaurant,Eating Out,38,5210
13,7,2015,South West Trains,Transport,26,5184
13,7,2015,Starbucks Coffee,Eating Out,2,5182
13,7,2015,Pret A Manger,Eating Out,8,5174
13,7,2015,ATM Cash Withdrawal,General,20,5154
14,7,2015,Costa Coffee,Eating Out,1,5153
15,7,2015,BRGAS-Electricity,Bills,25,5128
15,7,2015,BRGAS-Gas,Bills,34,5094
15,7,2015,Costa Coffee,Eating Out,2,5092
16,7,2015,LBS Council Tax,Bills,35,5057
16,7,2015,Starbucks Coffee,Eating Out,1,5056
16,7,2015,Subway,Eating Out,5,5051
16,7,2015,ATM Cash Withdrawal,General,20,5031
17,7,2015,Waitrose,Groceries,42,4989
17,7,2015,Costa Coffee,Eating Out,2,4987
17,7,2015,ATM Cash Withdrawal,General,20,4967
18,7,2015,Red Shop,,8,4959
20,7,2015,VIRGIN MEDIA PYMTS,Bills,23,4936
20,7,2015,South West Trains,Transport,34,4902
20,7,2015,Caffe Nero,Eating Out,1,4901
20,7,2015,The West Cornwall Pasty Company,Eating Out,5,4896
21,7,2015,Wild Bean Cafe,Eating Out,1,4895
21,7,2015,Chicken Cottage,Eating Out,4,4891
21,7,2015,ATM Cash Withdrawal,General,20,4871
22,7,2015,Caffe Nero,Eating Out,2,4869
22,7,2015,McDonalds,Eating Out,5,4864
22,7,2015,ATM Cash Withdrawal,General,10,4854
23,7,2015,Starbucks Coffee,Eating Out,1,4853
23,7,2015,Pret A Manger,Eating Out,5,4848
24,7,2015,O2,Bills,28,4820
24,7,2015,Waitrose,Groceries,59,4761
24,7,2015,Costa Coffee,Eating Out,2,4759
24,7,2015,The West Cornwall Pasty Company,Eating Out,5,4754
24,7,2015,Restaurant Gordon RamsayPortland Restaurant,Eating Out,27,4727
24,7,2015,Tool Shop,,3,4724
25,7,2015,Anglo restaurant,Eating Out,40,4684
25,7,2015,ATM Cash Withdrawal,General,20,4664
27,7,2015,South West Trains,Transport,30,4634
27,7,2015,Starbucks Coffee,Eating Out,2,4632
27,7,2015,Pret A Manger,Eating Out,8,4624
28,7,2015,Costa Coffee,Eating Out,2,4622
28,7,2015,Greggs,Eating Out,7,4615
29,7,2015,Wild Bean Cafe,Eating Out,2,4613
29,7,2015,McDonalds,Eating Out,8,4605
30,7,2015,Starbucks Coffee,Eating Out,2,4603
31,7,2015,Tescos,Groceries,64,4539
31,7,2015,Greggs,Eating Out,8,4531
31,7,2015,Fabric Club,Eating Out,14,4517
31,7,2015,Fabric Club,Eating Out,16,4501
31,7,2015,Fabric Club,Eating Out,14,4487
31,7,2015,Fabric Club,Eating Out,10,4477
31,7,2015,Fabric Club,Eating Out,7,4470
31,7,2015,Fabric Club,Eating Out,9,4461
31,7,2015,Anglo restaurant,Eating Out,36,4425
1,8,2015,Rhino Sports salary,General,1600,6025
2,8,2015,Scott's Restaurant,Eating Out,46,5979
3,8,2015,South West Trains,Transport,28,5951
3,8,2015,Costa Coffee,Eating Out,2,5949
3,8,2015,Pret A Manger,Eating Out,6,5943
4,8,2015,Costa Coffee,Eating Out,2,5941
4,8,2015,McDonalds,Eating Out,4,5937
4,8,2015,ATM Cash Withdrawal,General,10,5927
5,8,2015,Costa Coffee,Eating Out,1,5926
6,8,2015,Starbucks Coffee,Eating Out,2,5924
6,8,2015,ATM Cash Withdrawal,General,10,5914
6,8,2015,Tool Tec,,6,5908
7,8,2015,Cubit and West rent,Rent,440,5468
7,8,2015,Sainsburys,Groceries,81,5387
7,8,2015,Starbucks Coffee,Eating Out,2,5385
7,8,2015,McDonalds,Eating Out,4,5381
7,8,2015,Restaurant Gordon RamsayPortland Restaurant,Eating Out,53,5328
7,8,2015,ATM Cash Withdrawal,General,20,5308
8,8,2015,Dominos Pizza,Eating Out,28,5280
9,8,2015,Pizza Express,Eating Out,58,5222
10,8,2015,South West Trains,Transport,26,5196
10,8,2015,Starbucks Coffee,Eating Out,1,5195
10,8,2015,Greggs,Eating Out,7,5188
11,8,2015,Caffe Nero,Eating Out,1,5187
11,8,2015,Tool Tec,,4,5183
12,8,2015,Costa Coffee,Eating Out,2,5181
12,8,2015,ATM Cash Withdrawal,General,10,5171
13,8,2015,Costa Coffee,Eating Out,2,5169
14,8,2015,ASDA,Groceries,81,5088
14,8,2015,Wild Bean Cafe,Eating Out,1,5087
14,8,2015,Subway,Eating Out,8,5079
15,8,2015,BRGAS-Electricity,Bills,35,5044
15,8,2015,BRGAS-Gas,Bills,22,5022
16,8,2015,LBS Council Tax,Bills,35,4987
17,8,2015,South West Trains,Transport,33,4954
17,8,2015,Starbucks Coffee,Eating Out,1,4953
17,8,2015,ATM Cash Withdrawal,General,10,4943
18,8,2015,Pret A Manger,Eating Out,7,4936
20,8,2015,VIRGIN MEDIA PYMTS,Bills,43,4893
20,8,2015,Starbucks Coffee,Eating Out,1,4892
20,8,2015,Greggs,Eating Out,6,4886
21,8,2015,Sainsburys,Groceries,47,4839
21,8,2015,The West Cornwall Pasty Company,Eating Out,6,4833
21,8,2015,ATM Cash Withdrawal,General,20,4813
21,8,2015,Tool Tec,,4,4809
22,8,2015,Pizza Express,Eating Out,50,4759
22,8,2015,ATM Cash Withdrawal,General,20,4739
23,8,2015,ATM Cash Withdrawal,General,10,4729
24,8,2015,O2,Bills,28,4701
24,8,2015,South West Trains,Transport,35,4666
24,8,2015,Caffe Nero,Eating Out,1,4665
24,8,2015,McDonalds,Eating Out,4,4661
25,8,2015,Wild Bean Cafe,Eating Out,1,4660
25,8,2015,Subway,Eating Out,6,4654
26,8,2015,Starbucks Coffee,Eating Out,2,4652
26,8,2015,Greggs,Eating Out,5,4647
28,8,2015,Morrisons,Groceries,65,4582
31,8,2015,South West Trains,Transport,30,4552
31,8,2015,Caffe Nero,Eating Out,2,4550
31,8,2015,McDonalds,Eating Out,7,4543
1,9,2015,Rhino Sports salary,General,1600,6143
1,9,2015,Chicken Cottage,Eating Out,8,6135
2,9,2015,Subway,Eating Out,6,6129
2,9,2015,ATM Cash Withdrawal,General,10,6119
3,9,2015,Costa Coffee,Eating Out,2,6117
3,9,2015,Pret A Manger,Eating Out,6,6111
4,9,2015,Waitrose,Groceries,69,6042
4,9,2015,Caffe Nero,Eating Out,1,6041
5,9,2015,Anglo restaurant,Eating Out,27,6014
7,9,2015,Cubit and West rent,Rent,440,5574
7,9,2015,South West Trains,Transport,25,5549
7,9,2015,Wild Bean Cafe,Eating Out,2,5547
8,9,2015,Costa Coffee,Eating Out,2,5545
8,9,2015,Chicken Cottage,Eating Out,7,5538
8,9,2015,Civic Shop,,9,5529
9,9,2015,Wild Bean Cafe,Eating Out,1,5528
9,9,2015,The West Cornwall Pasty Company,Eating Out,8,5520
9,9,2015,ATM Cash Withdrawal,General,20,5500
10,9,2015,Costa Coffee,Eating Out,1,5499
10,9,2015,Greggs,Eating Out,5,5494
11,9,2015,Morrisons,Groceries,55,5439
11,9,2015,Starbucks Coffee,Eating Out,2,5437
11,9,2015,The Grand Pub,Eating Out,5,5432
11,9,2015,The Grand Pub,Eating Out,15,5417
11,9,2015,The Grand Pub,Eating Out,14,5403
11,9,2015,ATM Cash Withdrawal,General,20,5383
12,9,2015,Fabric Club,Eating Out,6,5377
12,9,2015,Fabric Club,Eating Out,8,5369
12,9,2015,Fabric Club,Eating Out,11,5358
12,9,2015,Fabric Club,Eating Out,10,5348
12,9,2015,Anglo restaurant,Eating Out,46,5302
12,9,2015,ATM Cash Withdrawal,General,20,5282
14,9,2015,South West Trains,Transport,32,5250
14,9,2015,Greggs,Eating Out,5,5245
15,9,2015,BRGAS-Electricity,Bills,30,5215
15,9,2015,BRGAS-Gas,Bills,31,5184
15,9,2015,Pret A Manger,Eating Out,4,5180
16,9,2015,LBS Council Tax,Bills,35,5145
16,9,2015,Starbucks Coffee,Eating Out,2,5143
16,9,2015,The West Cornwall Pasty Company,Eating Out,4,5139
16,9,2015,ATM Cash Withdrawal,General,20,5119
17,9,2015,Caffe Nero,Eating Out,1,5118
17,9,2015,The West Cornwall Pasty Company,Eating Out,6,5112
18,9,2015,ASDA,Groceries,66,5046
18,9,2015,Starbucks Coffee,Eating Out,2,5044
18,9,2015,Pret A Manger,Eating Out,6,5038
18,9,2015,ATM Cash Withdrawal,General,10,5028
19,9,2015,Scott's Restaurant,Eating Out,27,5001
19,9,2015,ATM Cash Withdrawal,General,10,4991
20,9,2015,VIRGIN MEDIA PYMTS,Bills,28,4963
21,9,2015,South West Trains,Transport,34,4929
21,9,2015,Starbucks Coffee,Eating Out,1,4928
21,9,2015,Greggs,Eating Out,7,4921
22,9,2015,Wild Bean Cafe,Eating Out,2,4919
22,9,2015,Subway,Eating Out,7,4912
23,9,2015,Costa Coffee,Eating Out,1,4911
23,9,2015,Subway,Eating Out,5,4906
24,9,2015,O2,Bills,27,4879
24,9,2015,Costa Coffee,Eating Out,2,4877
24,9,2015,Chicken Cottage,Eating Out,7,4870
24,9,2015,Red Shop,,1,4869
25,9,2015,Waitrose,Groceries,66,4803
25,9,2015,Caffe Nero,Eating Out,1,4802
25,9,2015,ATM Cash Withdrawal,General,20,4782
26,9,2015,Restaurant Gordon RamsayPortland Restaurant,Eating Out,56,4726
26,9,2015,ATM Cash Withdrawal,General,20,4706
27,9,2015,Anglo restaurant,Eating Out,46,4660
27,9,2015,ATM Cash Withdrawal,General,20,4640
28,9,2015,South West Trains,Transport,36,4604
28,9,2015,The West Cornwall Pasty Company,Eating Out,7,4597
29,9,2015,McDonalds,Eating Out,6,4591
30,9,2015,Starbucks Coffee,Eating Out,1,4590
30,9,2015,McDonalds,Eating Out,4,4586
30,9,2015,ATM Cash Withdrawal,General,10,4576
1,10,2015,Rhino Sports salary,General,1600,6176
1,10,2015,Subway,Eating Out,5,6171
2,10,2015,Tescos,Groceries,80,6091
2,10,2015,Wild Bean Cafe,Eating Out,2,6089
2,10,2015,Pret A Manger,Eating Out,4,6085
2,10,2015,Pizza Express,Eating Out,37,6048
2,10,2015,ATM Cash Withdrawal,General,10,6038
3,10,2015,ATM Cash Withdrawal,General,10,6028
5,10,2015,South West Trains,Transport,35,5993
5,10,2015,Starbucks Coffee,Eating Out,1,5992
5,10,2015,Pret A Manger,Eating Out,6,5986
6,10,2015,Starbucks Coffee,Eating Out,2,5984
6,10,2015,Chicken Cottage,Eating Out,6,5978
6,10,2015,ATM Cash Withdrawal,General,20,5958
7,10,2015,Cubit and West rent,Rent,440,5518
7,10,2015,Starbucks Coffee,Eating Out,2,5516
7,10,2015,The West Cornwall Pasty Company,Eating Out,5,5511
7,10,2015,ATM Cash Withdrawal,General,10,5501
8,10,2015,Caffe Nero,Eating Out,2,5499
8,10,2015,Subway,Eating Out,4,5495
9,10,2015,Waitrose,Groceries,64,5431
9,10,2015,Costa Coffee,Eating Out,1,5430
9,10,2015,ATM Cash Withdrawal,General,10,5420
10,10,2015,Ministry of Sound ClubXOYO Club,Eating Out,8,5412
10,10,2015,Ministry of Sound ClubXOYO Club,Eating Out,11,5401
10,10,2015,Ministry of Sound ClubXOYO Club,Eating Out,11,5390
11,10,2015,ATM Cash Withdrawal,General,20,5370
12,10,2015,South West Trains,Transport,26,5344
12,10,2015,Caffe Nero,Eating Out,2,5342
13,10,2015,Starbucks Coffee,Eating Out,1,5341
13,10,2015,McDonalds,Eating Out,7,5334
14,10,2015,Costa Coffee,Eating Out,2,5332
14,10,2015,Chicken Cottage,Eating Out,7,5325
15,10,2015,BRGAS-Electricity,Bills,30,5295
15,10,2015,BRGAS-Gas,Bills,30,5265
15,10,2015,Starbucks Coffee,Eating Out,1,5264
15,10,2015,McDonalds,Eating Out,6,5258
15,10,2015,ATM Cash Withdrawal,General,20,5238
16,10,2015,LBS Council Tax,Bills,35,5203
16,10,2015,Morrisons,Groceries,50,5153
16,10,2015,Caffe Nero,Eating Out,2,5151
16,10,2015,Chicken Cottage,Eating Out,8,5143
16,10,2015,ATM Cash Withdrawal,General,10,5133
17,10,2015,ATM Cash Withdrawal,General,10,5123
19,10,2015,South West Trains,Transport,37,5086
19,10,2015,Wild Bean Cafe,Eating Out,2,5084
20,10,2015,VIRGIN MEDIA PYMTS,Bills,36,5048
20,10,2015,Wild Bean Cafe,Eating Out,2,5046
20,10,2015,McDonalds,Eating Out,5,5041
20,10,2015,Tool Tec,,9,5032
21,10,2015,Wild Bean Cafe,Eating Out,2,5030
21,10,2015,McDonalds,Eating Out,5,5025
22,10,2015,Starbucks Coffee,Eating Out,1,5024
22,10,2015,ATM Cash Withdrawal,General,10,5014
23,10,2015,Sainsburys,Groceries,74,4940
23,10,2015,Caffe Nero,Eating Out,1,4939
23,10,2015,The West Cornwall Pasty Company,Eating Out,4,4935
23,10,2015,Dominos Pizza,Eating Out,36,4899
24,10,2015,O2,Bills,31,4868
24,10,2015,Tool Tec,,4,4864
25,10,2015,Tool Shop,,7,4857
26,10,2015,South West Trains,Transport,28,4829
26,10,2015,Costa Coffee,Eating Out,1,4828
27,10,2015,Caffe Nero,Eating Out,2,4826
27,10,2015,McDonalds,Eating Out,4,4822
27,10,2015,Tool Tec,,6,4816
28,10,2015,Wild Bean Cafe,Eating Out,1,4815
28,10,2015,Chicken Cottage,Eating Out,8,4807
29,10,2015,Chicken Cottage,Eating Out,5,4802
29,10,2015,Tool Tec,,8,4794
30,10,2015,Tescos,Groceries,47,4747
30,10,2015,Costa Coffee,Eating Out,2,4745
30,10,2015,Greggs,Eating Out,4,4741
30,10,2015,ATM Cash Withdrawal,General,20,4721
31,10,2015,Pizza Express,Eating Out,36,4685
1,11,2015,Rhino Sports salary,General,1600,6285
1,11,2015,ATM Cash Withdrawal,General,20,6265
2,11,2015,South West Trains,Transport,31,6234
2,11,2015,Starbucks Coffee,Eating Out,1,6233
3,11,2015,Caffe Nero,Eating Out,1,6232
3,11,2015,McDonalds,Eating Out,7,6225
4,11,2015,Starbucks Coffee,Eating Out,1,6224
4,11,2015,Subway,Eating Out,6,6218
4,11,2015,ATM Cash Withdrawal,General,10,6208
5,11,2015,Caffe Nero,Eating Out,2,6206
5,11,2015,Pret A Manger,Eating Out,8,6198
6,11,2015,ASDA,Groceries,45,6153
6,11,2015,Costa Coffee,Eating Out,2,6151
6,11,2015,Chicken Cottage,Eating Out,6,6145
6,11,2015,ATM Cash Withdrawal,General,10,6135
6,11,2015,Tool Tec,,5,6130
7,11,2015,Cubit and West rent,Rent,440,5690
9,11,2015,South West Trains,Transport,32,5658
9,11,2015,Costa Coffee,Eating Out,1,5657
9,11,2015,Pret A Manger,Eating Out,8,5649
9,11,2015,Tool Shop,,8,5641
10,11,2015,Costa Coffee,Eating Out,2,5639
10,11,2015,Chicken Cottage,Eating Out,7,5632
11,11,2015,Caffe Nero,Eating Out,1,5631
11,11,2015,The West Cornwall Pasty Company,Eating Out,7,5624
12,11,2015,Wild Bean Cafe,Eating Out,1,5623
12,11,2015,Greggs,Eating Out,7,5616
13,11,2015,Waitrose,Groceries,78,5538
13,11,2015,Costa Coffee,Eating Out,2,5536
13,11,2015,Subway,Eating Out,5,5531
13,11,2015,Anglo restaurant,Eating Out,46,5485
15,11,2015,BRGAS-Electricity,Bills,63,5422
15,11,2015,BRGAS-Gas,Bills,59,5363
15,11,2015,ATM Cash Withdrawal,General,10,5353
16,11,2015,LBS Council Tax,Bills,35,5318
16,11,2015,South West Trains,Transport,32,5286
16,11,2015,Wild Bean Cafe,Eating Out,1,5285
16,11,2015,Subway,Eating Out,7,5278
17,11,2015,Starbucks Coffee,Eating Out,1,5277
18,11,2015,Wild Bean Cafe,Eating Out,2,5275
18,11,2015,Tool Tec,,6,5269
19,11,2015,Wild Bean Cafe,Eating Out,2,5267
20,11,2015,VIRGIN MEDIA PYMTS,Bills,30,5237
20,11,2015,Tescos,Groceries,49,5188
20,11,2015,Costa Coffee,Eating Out,2,5186
20,11,2015,McDonalds,Eating Out,8,5178
21,11,2015,Anglo restaurant,Eating Out,30,5148
21,11,2015,ATM Cash Withdrawal,General,20,5128
22,11,2015,ATM Cash Withdrawal,General,20,5108
23,11,2015,South West Trains,Transport,25,5083
23,11,2015,McDonalds,Eating Out,8,5075
24,11,2015,O2,Bills,29,5046
24,11,2015,Wild Bean Cafe,Eating Out,2,5044
24,11,2015,Pret A Manger,Eating Out,5,5039
25,11,2015,Wild Bean Cafe,Eating Out,2,5037
26,11,2015,The West Cornwall Pasty Company,Eating Out,4,5033
27,11,2015,Waitrose,Groceries,80,4953
27,11,2015,Costa Coffee,Eating Out,2,4951
27,11,2015,Pret A Manger,Eating Out,6,4945
27,11,2015,Cheam Service Station,,7,4938
28,11,2015,ATM Cash Withdrawal,General,20,4918
30,11,2015,South West Trains,Transport,32,4886
30,11,2015,Costa Coffee,Eating Out,2,4884
30,11,2015,The West Cornwall Pasty Company,Eating Out,4,4880
1,12,2015,Rhino Sports salary,General,1600,6480
1,12,2015,McDonalds,Eating Out,5,6475
1,12,2015,ATM Cash Withdrawal,General,10,6465
3,12,2015,Chicken Cottage,Eating Out,4,6461
3,12,2015,ATM Cash Withdrawal,General,10,6451
4,12,2015,Sainsburys,Groceries,60,6391
4,12,2015,Costa Coffee,Eating Out,2,6389
4,12,2015,The West Cornwall Pasty Company,Eating Out,8,6381
4,12,2015,ATM Cash Withdrawal,General,10,6371
7,12,2015,Cubit and West rent,Rent,440,5931
7,12,2015,South West Trains,Transport,30,5901
7,12,2015,Starbucks Coffee,Eating Out,2,5899
7,12,2015,Subway,Eating Out,5,5894
7,12,2015,ATM Cash Withdrawal,General,10,5884
7,12,2015,Civic Shop,,5,5879
8,12,2015,Caffe Nero,Eating Out,2,5877
8,12,2015,Chicken Cottage,Eating Out,5,5872
9,12,2015,Costa Coffee,Eating Out,1,5871
10,12,2015,Starbucks Coffee,Eating Out,1,5870
10,12,2015,Pret A Manger,Eating Out,8,5862
10,12,2015,Civic Shop,,1,5861
11,12,2015,Tescos,Groceries,40,5821
11,12,2015,Starbucks Coffee,Eating Out,2,5819
11,12,2015,The West Cornwall Pasty Company,Eating Out,6,5813
11,12,2015,Scott's Restaurant,Eating Out,26,5787
12,12,2015,ATM Cash Withdrawal,General,20,5767
14,12,2015,South West Trains,Transport,30,5737
14,12,2015,Caffe Nero,Eating Out,2,5735
14,12,2015,Pret A Manger,Eating Out,4,5731
15,12,2015,BRGAS-Electricity,Bills,27,5704
15,12,2015,BRGAS-Gas,Bills,26,5678
15,12,2015,Wild Bean Cafe,Eating Out,2,5676
15,12,2015,Chicken Cottage,Eating Out,7,5669
16,12,2015,LBS Council Tax,Bills,35,5634
16,12,2015,Starbucks Coffee,Eating Out,2,5632
17,12,2015,Starbucks Coffee,Eating Out,1,5631
17,12,2015,Greggs,Eating Out,7,5624
18,12,2015,Tescos,Groceries,48,5576
18,12,2015,Wild Bean Cafe,Eating Out,2,5574
18,12,2015,McDonalds,Eating Out,7,5567
18,12,2015,Anglo restaurant,Eating Out,58,5509
19,12,2015,Anglo restaurant,Eating Out,58,5451
19,12,2015,ATM Cash Withdrawal,General,20,5431
20,12,2015,VIRGIN MEDIA PYMTS,Bills,26,5405
20,12,2015,ATM Cash Withdrawal,General,10,5395
21,12,2015,South West Trains,Transport,26,5369
21,12,2015,Costa Coffee,Eating Out,2,5367
21,12,2015,Chicken Cottage,Eating Out,4,5363
21,12,2015,ATM Cash Withdrawal,General,10,5353
22,12,2015,Wild Bean Cafe,Eating Out,1,5352
22,12,2015,The West Cornwall Pasty Company,Eating Out,5,5347
22,12,2015,ATM Cash Withdrawal,General,10,5337
23,12,2015,Caffe Nero,Eating Out,2,5335
24,12,2015,O2,Bills,28,5307
25,12,2015,ASDA,Groceries,72,5235
25,12,2015,Caffe Nero,Eating Out,1,5234
25,12,2015,Pret A Manger,Eating Out,6,5228
25,12,2015,The Grand Pub,Eating Out,5,5223
25,12,2015,The Grand Pub,Eating Out,6,5217
25,12,2015,ATM Cash Withdrawal,General,10,5207
26,12,2015,ATM Cash Withdrawal,General,20,5187
28,12,2015,South West Trains,Transport,28,5159
28,12,2015,Chicken Cottage,Eating Out,7,5152
29,12,2015,Wild Bean Cafe,Eating Out,1,5151
29,12,2015,McDonalds,Eating Out,7,5144
30,12,2015,Starbucks Coffee,Eating Out,2,5142
30,12,2015,Pret A Manger,Eating Out,4,5138
30,12,2015,ATM Cash Withdrawal,General,10,5128
31,12,2015,Starbucks Coffee,Eating Out,2,5126
31,12,2015,The West Cornwall Pasty Company,Eating Out,4,5122
1,1,2016,Rhino Sports salary,General,1600,6722
1,1,2016,Sainsburys,Groceries,46,6676
1,1,2016,Starbucks Coffee,Eating Out,1,6675
1,1,2016,Chicken Cottage,Eating Out,8,6667
4,1,2016,South West Trains,Transport,33,6634
4,1,2016,Wild Bean Cafe,Eating Out,2,6632
4,1,2016,Pret A Manger,Eating Out,5,6627
5,1,2016,Greggs,Eating Out,5,6622
5,1,2016,ATM Cash Withdrawal,General,20,6602
6,1,2016,ATM Cash Withdrawal,General,20,6582
6,1,2016,Civic Shop,,3,6579
7,1,2016,Cubit and West rent,Rent,440,6139
7,1,2016,Wild Bean Cafe,Eating Out,1,6138
7,1,2016,The West Cornwall Pasty Company,Eating Out,4,6134
7,1,2016,ATM Cash Withdrawal,General,10,6124
8,1,2016,Sainsburys,Groceries,72,6052
8,1,2016,Costa Coffee,Eating Out,2,6050
8,1,2016,Civic Shop,,1,6049
9,1,2016,Restaurant Gordon RamsayPortland Restaurant,Eating Out,47,6002
9,1,2016,ATM Cash Withdrawal,General,20,5982
9,1,2016,Tool Shop,,5,5977
10,1,2016,Dominos Pizza,Eating Out,27,5950
10,1,2016,ATM Cash Withdrawal,General,20,5930
10,1,2016,Red Shop,,3,5927
11,1,2016,South West Trains,Transport,34,5893
11,1,2016,Costa Coffee,Eating Out,2,5891
11,1,2016,Civic Shop,,9,5882
12,1,2016,Costa Coffee,Eating Out,2,5880
12,1,2016,Pret A Manger,Eating Out,6,5874
13,1,2016,Subway,Eating Out,8,5866
13,1,2016,Tool Tec,,5,5861
15,1,2016,BRGAS-Electricity,Bills,36,5825
15,1,2016,BRGAS-Gas,Bills,27,5798
15,1,2016,Morrisons,Groceries,54,5744
15,1,2016,Wild Bean Cafe,Eating Out,2,5742
15,1,2016,The West Cornwall Pasty Company,Eating Out,8,5734
15,1,2016,Anglo restaurant,Eating Out,52,5682
16,1,2016,LBS Council Tax,Bills,35,5647
17,1,2016,Pizza Express,Eating Out,48,5599
18,1,2016,South West Trains,Transport,36,5563
18,1,2016,Starbucks Coffee,Eating Out,1,5562
18,1,2016,Chicken Cottage,Eating Out,5,5557
19,1,2016,Starbucks Coffee,Eating Out,1,5556
19,1,2016,Chicken Cottage,Eating Out,4,5552
20,1,2016,VIRGIN MEDIA PYMTS,Bills,39,5513
20,1,2016,Starbucks Coffee,Eating Out,2,5511
20,1,2016,Chicken Cottage,Eating Out,6,5505
21,1,2016,Caffe Nero,Eating Out,2,5503
21,1,2016,ATM Cash Withdrawal,General,10,5493
22,1,2016,Sainsburys,Groceries,73,5420
22,1,2016,Starbucks Coffee,Eating Out,1,5419
22,1,2016,Subway,Eating Out,4,5415
22,1,2016,Restaurant Gordon RamsayPortland Restaurant,Eating Out,56,5359
23,1,2016,Fabric Club,Eating Out,8,5351
23,1,2016,Fabric Club,Eating Out,13,5338
23,1,2016,Fabric Club,Eating Out,7,5331
23,1,2016,Fabric Club,Eating Out,16,5315
23,1,2016,Fabric Club,Eating Out,5,5310
24,1,2016,O2,Bills,29,5281
25,1,2016,South West Trains,Transport,28,5253
25,1,2016,Caffe Nero,Eating Out,2,5251
25,1,2016,Greggs,Eating Out,4,5247
25,1,2016,ATM Cash Withdrawal,General,10,5237
26,1,2016,Costa Coffee,Eating Out,2,5235
26,1,2016,Chicken Cottage,Eating Out,4,5231
27,1,2016,Wild Bean Cafe,Eating Out,2,5229
27,1,2016,Greggs,Eating Out,6,5223
28,1,2016,Costa Coffee,Eating Out,2,5221
28,1,2016,Greggs,Eating Out,5,5216
29,1,2016,Waitrose,Groceries,59,5157
29,1,2016,Costa Coffee,Eating Out,2,5155
29,1,2016,Ministry of Sound ClubXOYO Club,Eating Out,6,5149
29,1,2016,Ministry of Sound ClubXOYO Club,Eating Out,8,5141
29,1,2016,Ministry of Sound ClubXOYO Club,Eating Out,13,5128
29,1,2016,Ministry of Sound ClubXOYO Club,Eating Out,8,5120
29,1,2016,Ministry of Sound ClubXOYO Club,Eating Out,7,5113
29,1,2016,ATM Cash Withdrawal,General,10,5103
30,1,2016,ATM Cash Withdrawal,General,20,5083
31,1,2016,Restaurant Gordon RamsayPortland Restaurant,Eating Out,25,5058
31,1,2016,Red Shop,,7,5051
1,2,2016,Rhino Sports salary,General,1600,6651
1,2,2016,South West Trains,Transport,34,6617
1,2,2016,Costa Coffee,Eating Out,2,6615
2,2,2016,Caffe Nero,Eating Out,2,6613
2,2,2016,The West Cornwall Pasty Company,Eating Out,7,6606
3,2,2016,Chicken Cottage,Eating Out,6,6600
3,2,2016,Tool Shop,,1,6599
4,2,2016,Starbucks Coffee,Eating Out,2,6597
4,2,2016,Greggs,Eating Out,6,6591
4,2,2016,ATM Cash Withdrawal,General,10,6581
5,2,2016,Waitrose,Groceries,76,6505
5,2,2016,Costa Coffee,Eating Out,1,6504
5,2,2016,Pret A Manger,Eating Out,8,6496
6,2,2016,Ministry of Sound ClubXOYO Club,Eating Out,10,6486
6,2,2016,Ministry of Sound ClubXOYO Club,Eating Out,9,6477
6,2,2016,Ministry of Sound ClubXOYO Club,Eating Out,14,6463
6,2,2016,Ministry of Sound ClubXOYO Club,Eating Out,6,6457
6,2,2016,Ministry of Sound ClubXOYO Club,Eating Out,9,6448
7,2,2016,Cubit and West rent,Rent,440,6008
7,2,2016,Paying back James,,1,6007
8,2,2016,South West Trains,Transport,26,5981
8,2,2016,Wild Bean Cafe,Eating Out,1,5980
9,2,2016,Greggs,Eating Out,6,5974
10,2,2016,Wild Bean Cafe,Eating Out,2,5972
10,2,2016,Chicken Cottage,Eating Out,6,5966
11,2,2016,Caffe Nero,Eating Out,2,5964
11,2,2016,The West Cornwall Pasty Company,Eating Out,4,5960
12,2,2016,Tescos,Groceries,66,5894
12,2,2016,Wild Bean Cafe,Eating Out,1,5893
12,2,2016,Greggs,Eating Out,7,5886
12,2,2016,Scott's Restaurant,Eating Out,48,5838
14,2,2016,Scott's Restaurant,Eating Out,38,5800
15,2,2016,BRGAS-Electricity,Bills,25,5775
15,2,2016,BRGAS-Gas,Bills,29,5746
15,2,2016,South West Trains,Transport,37,5709
15,2,2016,Costa Coffee,Eating Out,2,5707
16,2,2016,LBS Council Tax,Bills,35,5672
16,2,2016,Caffe Nero,Eating Out,1,5671
17,2,2016,Caffe Nero,Eating Out,2,5669
18,2,2016,The West Cornwall Pasty Company,Eating Out,5,5664
19,2,2016,Morrisons,Groceries,39,5625
19,2,2016,Wild Bean Cafe,Eating Out,2,5623
19,2,2016,Pizza Express,Eating Out,36,5587
20,2,2016,VIRGIN MEDIA PYMTS,Bills,44,5543
22,2,2016,South West Trains,Transport,36,5507
22,2,2016,Starbucks Coffee,Eating Out,2,5505
22,2,2016,Subway,Eating Out,5,5500
23,2,2016,Cheam Service Station,,4,5496
24,2,2016,O2,Bills,26,5470
24,2,2016,Greggs,Eating Out,6,5464
25,2,2016,Caffe Nero,Eating Out,2,5462
25,2,2016,Greggs,Eating Out,5,5457
25,2,2016,ATM Cash Withdrawal,General,20,5437
25,2,2016,Civic Shop,,9,5428
26,2,2016,Morrisons,Groceries,50,5378
26,2,2016,Wild Bean Cafe,Eating Out,2,5376
26,2,2016,Chicken Cottage,Eating Out,7,5369
26,2,2016,ATM Cash Withdrawal,General,10,5359
27,2,2016,Tool Shop,,8,5351
28,2,2016,Restaurant Gordon RamsayPortland Restaurant,Eating Out,58,5293
28,2,2016,Red Shop,,2,5291
29,2,2016,South West Trains,Transport,26,5265
29,2,2016,Starbucks Coffee,Eating Out,2,5263
1,3,2016,Rhino Sports salary,General,1600,6863
1,3,2016,McDonalds,Eating Out,6,6857
1,3,2016,ATM Cash Withdrawal,General,20,6837
2,3,2016,Caffe Nero,Eating Out,2,6835
3,3,2016,Starbucks Coffee,Eating Out,2,6833
3,3,2016,ATM Cash Withdrawal,General,20,6813
4,3,2016,Tescos,Groceries,71,6742
4,3,2016,Costa Coffee,Eating Out,2,6740
4,3,2016,Scott's Restaurant,Eating Out,40,6700
4,3,2016,Tool Shop,,9,6691
5,3,2016,Restaurant Gordon RamsayPortland Restaurant,Eating Out,30,6661
5,3,2016,ATM Cash Withdrawal,General,20,6641
6,3,2016,ATM Cash Withdrawal,General,10,6631
7,3,2016,Cubit and West rent,Rent,440,6191
7,3,2016,South West Trains,Transport,24,6167
7,3,2016,Wild Bean Cafe,Eating Out,2,6165
7,3,2016,Subway,Eating Out,8,6157
7,3,2016,Civic Shop,,1,6156
8,3,2016,Costa Coffee,Eating Out,2,6154
8,3,2016,The West Cornwall Pasty Company,Eating Out,5,6149
9,3,2016,Wild Bean Cafe,Eating Out,1,6148
10,3,2016,Costa Coffee,Eating Out,2,6146
10,3,2016,The West Cornwall Pasty Company,Eating Out,4,6142
11,3,2016,Sainsburys,Groceries,48,6094
11,3,2016,Starbucks Coffee,Eating Out,1,6093
11,3,2016,Subway,Eating Out,8,6085
11,3,2016,The Grand Pub,Eating Out,8,6077
11,3,2016,The Grand Pub,Eating Out,9,6068
11,3,2016,The Grand Pub,Eating Out,16,6052
12,3,2016,Pizza Express,Eating Out,42,6010
13,3,2016,Pizza Express,Eating Out,24,5986
13,3,2016,ATM Cash Withdrawal,General,20,5966
14,3,2016,South West Trains,Transport,28,5938
14,3,2016,Starbucks Coffee,Eating Out,2,5936
14,3,2016,Chicken Cottage,Eating Out,6,5930
14,3,2016,ATM Cash Withdrawal,General,20,5910
14,3,2016,Tool Shop,,9,5901
15,3,2016,BRGAS-Electricity,Bills,24,5877
15,3,2016,BRGAS-Gas,Bills,35,5842
15,3,2016,Pret A Manger,Eating Out,4,5838
16,3,2016,LBS Council Tax,Bills,35,5803
16,3,2016,Caffe Nero,Eating Out,1,5802
17,3,2016,Wild Bean Cafe,Eating Out,1,5801
17,3,2016,Pret A Manger,Eating Out,6,5795
17,3,2016,ATM Cash Withdrawal,General,10,5785
18,3,2016,Morrisons,Groceries,54,5731
18,3,2016,Starbucks Coffee,Eating Out,2,5729
18,3,2016,Restaurant Gordon RamsayPortland Restaurant,Eating Out,35,5694
20,3,2016,VIRGIN MEDIA PYMTS,Bills,42,5652
20,3,2016,Restaurant Gordon RamsayPortland Restaurant,Eating Out,45,5607
20,3,2016,ATM Cash Withdrawal,General,20,5587
20,3,2016,Tool Shop,,5,5582
21,3,2016,South West Trains,Transport,37,5545
21,3,2016,McDonalds,Eating Out,7,5538
22,3,2016,Caffe Nero,Eating Out,2,5536
22,3,2016,Greggs,Eating Out,7,5529
22,3,2016,Cheam Service Station,,7,5522
23,3,2016,Wild Bean Cafe,Eating Out,1,5521
23,3,2016,Greggs,Eating Out,8,5513
23,3,2016,Tool Tec,,9,5504
24,3,2016,O2,Bills,29,5475
24,3,2016,Costa Coffee,Eating Out,2,5473
24,3,2016,Greggs,Eating Out,8,5465
24,3,2016,ATM Cash Withdrawal,General,20,5445
25,3,2016,ASDA,Groceries,46,5399
25,3,2016,Subway,Eating Out,4,5395
25,3,2016,Anglo restaurant,Eating Out,58,5337
25,3,2016,ATM Cash Withdrawal,General,10,5327
26,3,2016,The Grand Pub,Eating Out,11,5316
26,3,2016,The Grand Pub,Eating Out,7,5309
26,3,2016,Dominos Pizza,Eating Out,37,5272
26,3,2016,ATM Cash Withdrawal,General,20,5252
27,3,2016,Anglo restaurant,Eating Out,29,5223
27,3,2016,Paying back James,,7,5216
28,3,2016,South West Trains,Transport,28,5188
28,3,2016,Starbucks Coffee,Eating Out,2,5186
28,3,2016,McDonalds,Eating Out,5,5181
29,3,2016,Pret A Manger,Eating Out,4,5177
30,3,2016,Starbucks Coffee,Eating Out,2,5175
31,3,2016,Caffe Nero,Eating Out,2,5173
31,3,2016,Greggs,Eating Out,5,5168
31,3,2016,ATM Cash Withdrawal,General,10,5158
1,4,2016,Rhino Sports salary,General,1600,6758
1,4,2016,Tescos,Groceries,42,6716
1,4,2016,Starbucks Coffee,Eating Out,2,6714
1,4,2016,Greggs,Eating Out,5,6709
2,4,2016,The Grand Pub,Eating Out,5,6704
2,4,2016,The Grand Pub,Eating Out,7,6697
3,4,2016,Anglo restaurant,Eating Out,48,6649
4,4,2016,South West Trains,Transport,35,6614
4,4,2016,Wild Bean Cafe,Eating Out,1,6613
4,4,2016,Red Shop,,6,6607
5,4,2016,Costa Coffee,Eating Out,2,6605
5,4,2016,The West Cornwall Pasty Company,Eating Out,8,6597
5,4,2016,ATM Cash Withdrawal,General,20,6577
6,4,2016,McDonalds,Eating Out,6,6571
6,4,2016,ATM Cash Withdrawal,General,20,6551
7,4,2016,Cubit and West rent,Rent,440,6111
7,4,2016,Starbucks Coffee,Eating Out,2,6109
7,4,2016,Chicken Cottage,Eating Out,5,6104
7,4,2016,ATM Cash Withdrawal,General,10,6094
8,4,2016,Waitrose,Groceries,62,6032
8,4,2016,Caffe Nero,Eating Out,1,6031
8,4,2016,Greggs,Eating Out,8,6023
8,4,2016,Anglo restaurant,Eating Out,51,5972
9,4,2016,ATM Cash Withdrawal,General,10,5962
9,4,2016,Cheam Service Station,,1,5961
11,4,2016,South West Trains,Transport,29,5932
11,4,2016,Starbucks Coffee,Eating Out,1,5931
11,4,2016,McDonalds,Eating Out,6,5925
12,4,2016,Wild Bean Cafe,Eating Out,2,5923
12,4,2016,Civic Shop,,5,5918
13,4,2016,Costa Coffee,Eating Out,2,5916
13,4,2016,Greggs,Eating Out,6,5910
13,4,2016,Cheam Service Station,,4,5906
14,4,2016,Wild Bean Cafe,Eating Out,2,5904
14,4,2016,Pret A Manger,Eating Out,8,5896
15,4,2016,BRGAS-Electricity,Bills,27,5869
15,4,2016,BRGAS-Gas,Bills,21,5848
15,4,2016,Morrisons,Groceries,64,5784
15,4,2016,Starbucks Coffee,Eating Out,2,5782
15,4,2016,Heaven Club,Eating Out,5,5777
15,4,2016,Scott's Restaurant,Eating Out,41,5736
16,4,2016,LBS Council Tax,Bills,35,5701
16,4,2016,Pizza Express,Eating Out,47,5654
16,4,2016,ATM Cash Withdrawal,General,20,5634
17,4,2016,ATM Cash Withdrawal,General,20,5614
18,4,2016,South West Trains,Transport,26,5588
18,4,2016,Starbucks Coffee,Eating Out,2,5586
18,4,2016,Pret A Manger,Eating Out,4,5582
19,4,2016,Wild Bean Cafe,Eating Out,2,5580
20,4,2016,VIRGIN MEDIA PYMTS,Bills,34,5546
20,4,2016,Caffe Nero,Eating Out,2,5544
20,4,2016,McDonalds,Eating Out,8,5536
21,4,2016,Starbucks Coffee,Eating Out,2,5534
21,4,2016,Subway,Eating Out,6,5528
21,4,2016,Tool Tec,,2,5526
22,4,2016,ASDA,Groceries,44,5482
22,4,2016,Caffe Nero,Eating Out,2,5480
22,4,2016,ATM Cash Withdrawal,General,20,5460
22,4,2016,Red Shop,,9,5451
23,4,2016,Scott's Restaurant,Eating Out,24,5427
24,4,2016,O2,Bills,29,5398
24,4,2016,Pizza Express,Eating Out,45,5353
25,4,2016,South West Trains,Transport,31,5322
25,4,2016,Wild Bean Cafe,Eating Out,1,5321
25,4,2016,The West Cornwall Pasty Company,Eating Out,6,5315
25,4,2016,Tool Shop,,7,5308
26,4,2016,Caffe Nero,Eating Out,1,5307
26,4,2016,Pret A Manger,Eating Out,7,5300
27,4,2016,ATM Cash Withdrawal,General,20,5280
28,4,2016,Starbucks Coffee,Eating Out,1,5279
28,4,2016,The West Cornwall Pasty Company,Eating Out,8,5271
28,4,2016,ATM Cash Withdrawal,General,20,5251
29,4,2016,Waitrose,Groceries,78,5173
29,4,2016,Caffe Nero,Eating Out,1,5172
29,4,2016,McDonalds,Eating Out,5,5167
1,5,2016,Rhino Sports salary,General,1600,6767
1,5,2016,Pizza Express,Eating Out,40,6727
1,5,2016,Paying back Julie,,6,6721
2,5,2016,South West Trains,Transport,24,6697
2,5,2016,Costa Coffee,Eating Out,1,6696
2,5,2016,Pret A Manger,Eating Out,7,6689
2,5,2016,Tool Tec,,3,6686
3,5,2016,Costa Coffee,Eating Out,1,6685
4,5,2016,Caffe Nero,Eating Out,2,6683
4,5,2016,McDonalds,Eating Out,8,6675
5,5,2016,Wild Bean Cafe,Eating Out,1,6674
5,5,2016,Chicken Cottage,Eating Out,5,6669
5,5,2016,ATM Cash Withdrawal,General,10,6659
6,5,2016,Waitrose,Groceries,44,6615
6,5,2016,Subway,Eating Out,6,6609
6,5,2016,ATM Cash Withdrawal,General,20,6589
7,5,2016,Cubit and West rent,Rent,440,6149
7,5,2016,ATM Cash Withdrawal,General,10,6139
8,5,2016,Red Shop,,2,6137
9,5,2016,South West Trains,Transport,24,6113
9,5,2016,Starbucks Coffee,Eating Out,2,6111
9,5,2016,Subway,Eating Out,6,6105
10,5,2016,Wild Bean Cafe,Eating Out,2,6103
10,5,2016,ATM Cash Withdrawal,General,20,6083
10,5,2016,Tool Tec,,4,6079
11,5,2016,Costa Coffee,Eating Out,1,6078
11,5,2016,The West Cornwall Pasty Company,Eating Out,4,6074
12,5,2016,Subway,Eating Out,5,6069
13,5,2016,Waitrose,Groceries,47,6022
13,5,2016,Wild Bean Cafe,Eating Out,2,6020
13,5,2016,McDonalds,Eating Out,8,6012
15,5,2016,BRGAS-Electricity,Bills,33,5979
15,5,2016,BRGAS-Gas,Bills,22,5957
16,5,2016,LBS Council Tax,Bills,35,5922
16,5,2016,South West Trains,Transport,25,5897
16,5,2016,Wild Bean Cafe,Eating Out,2,5895
16,5,2016,Subway,Eating Out,8,5887
17,5,2016,Caffe Nero,Eating Out,1,5886
17,5,2016,Subway,Eating Out,8,5878
17,5,2016,ATM Cash Withdrawal,General,20,5858
18,5,2016,Wild Bean Cafe,Eating Out,2,5856
18,5,2016,ATM Cash Withdrawal,General,10,5846
19,5,2016,Costa Coffee,Eating Out,2,5844
19,5,2016,Greggs,Eating Out,8,5836
20,5,2016,VIRGIN MEDIA PYMTS,Bills,42,5794
20,5,2016,Morrisons,Groceries,49,5745
20,5,2016,Starbucks Coffee,Eating Out,2,5743
20,5,2016,McDonalds,Eating Out,6,5737
20,5,2016,Scott's Restaurant,Eating Out,33,5704
20,5,2016,Civic Shop,,1,5703
21,5,2016,Heaven Club,Eating Out,12,5691
21,5,2016,Heaven Club,Eating Out,12,5679
21,5,2016,Heaven Club,Eating Out,16,5663
21,5,2016,Restaurant Gordon RamsayPortland Restaurant,Eating Out,34,5629
21,5,2016,Paying back Julie,,7,5622
22,5,2016,ATM Cash Withdrawal,General,10,5612
23,5,2016,South West Trains,Transport,33,5579
23,5,2016,Starbucks Coffee,Eating Out,1,5578
23,5,2016,Subway,Eating Out,6,5572
24,5,2016,O2,Bills,32,5540
24,5,2016,Starbucks Coffee,Eating Out,1,5539
24,5,2016,Subway,Eating Out,7,5532
25,5,2016,Costa Coffee,Eating Out,2,5530
25,5,2016,Greggs,Eating Out,4,5526
26,5,2016,Caffe Nero,Eating Out,1,5525
26,5,2016,Pret A Manger,Eating Out,4,5521
27,5,2016,Waitrose,Groceries,51,5470
27,5,2016,Wild Bean Cafe,Eating Out,2,5468
28,5,2016,ATM Cash Withdrawal,General,10,5458
29,5,2016,ATM Cash Withdrawal,General,10,5448
30,5,2016,South West Trains,Transport,26,5422
30,5,2016,Costa Coffee,Eating Out,1,5421
30,5,2016,ATM Cash Withdrawal,General,10,5411
31,5,2016,Starbucks Coffee,Eating Out,1,5410
1,6,2016,Rhino Sports salary,General,1600,7010
1,6,2016,Starbucks Coffee,Eating Out,1,7009
2,6,2016,Greggs,Eating Out,5,7004
2,6,2016,ATM Cash Withdrawal,General,10,6994
3,6,2016,Tescos,Groceries,69,6925
3,6,2016,Starbucks Coffee,Eating Out,1,6924
3,6,2016,Pret A Manger,Eating Out,7,6917
3,6,2016,Heaven Club,Eating Out,14,6903
3,6,2016,Heaven Club,Eating Out,14,6889
3,6,2016,Heaven Club,Eating Out,9,6880
3,6,2016,Heaven Club,Eating Out,14,6866
4,6,2016,Tool Shop,,5,6861
6,6,2016,South West Trains,Transport,25,6836
7,6,2016,Cubit and West rent,Rent,440,6396
7,6,2016,Caffe Nero,Eating Out,2,6394
7,6,2016,Civic Shop,,8,6386
8,6,2016,Greggs,Eating Out,8,6378
10,6,2016,Morrisons,Groceries,65,6313
10,6,2016,Costa Coffee,Eating Out,1,6312
10,6,2016,Scott's Restaurant,Eating Out,46,6266
10,6,2016,Paying back Julie,,5,6261
11,6,2016,Fabric Club,Eating Out,10,6251
12,6,2016,Pizza Express,Eating Out,59,6192
13,6,2016,South West Trains,Transport,28,6164
13,6,2016,Starbucks Coffee,Eating Out,1,6163
13,6,2016,Greggs,Eating Out,6,6157
14,6,2016,Caffe Nero,Eating Out,2,6155
14,6,2016,The West Cornwall Pasty Company,Eating Out,6,6149
15,6,2016,BRGAS-Electricity,Bills,29,6120
15,6,2016,BRGAS-Gas,Bills,36,6084
15,6,2016,Starbucks Coffee,Eating Out,2,6082
16,6,2016,LBS Council Tax,Bills,35,6047
16,6,2016,Wild Bean Cafe,Eating Out,2,6045
16,6,2016,ATM Cash Withdrawal,General,20,6025
17,6,2016,Sainsburys,Groceries,47,5978
17,6,2016,Wild Bean Cafe,Eating Out,2,5976
17,6,2016,Dominos Pizza,Eating Out,30,5946
18,6,2016,Scott's Restaurant,Eating Out,58,5888
18,6,2016,ATM Cash Withdrawal,General,10,5878
19,6,2016,Pizza Express,Eating Out,57,5821
20,6,2016,VIRGIN MEDIA PYMTS,Bills,33,5788
20,6,2016,South West Trains,Transport,25,5763
20,6,2016,Starbucks Coffee,Eating Out,2,5761
20,6,2016,Pret A Manger,Eating Out,4,5757
21,6,2016,Caffe Nero,Eating Out,1,5756
21,6,2016,Chicken Cottage,Eating Out,6,5750
22,6,2016,Costa Coffee,Eating Out,1,5749
22,6,2016,Chicken Cottage,Eating Out,6,5743
22,6,2016,ATM Cash Withdrawal,General,10,5733
23,6,2016,Starbucks Coffee,Eating Out,1,5732
23,6,2016,Greggs,Eating Out,4,5728
24,6,2016,O2,Bills,27,5701
24,6,2016,ASDA,Groceries,52,5649
24,6,2016,Starbucks Coffee,Eating Out,2,5647
26,6,2016,ATM Cash Withdrawal,General,20,5627
27,6,2016,South West Trains,Transport,31,5596
27,6,2016,Caffe Nero,Eating Out,2,5594
27,6,2016,McDonalds,Eating Out,7,5587
28,6,2016,Costa Coffee,Eating Out,2,5585
28,6,2016,Chicken Cottage,Eating Out,7,5578
28,6,2016,ATM Cash Withdrawal,General,10,5568
30,6,2016,McDonalds,Eating Out,5,5563
30,6,2016,ATM Cash Withdrawal,General,20,5543
1,7,2016,Rhino Sports salary,General,1600,7143
1,7,2016,ASDA,Groceries,39,7104
1,7,2016,Costa Coffee,Eating Out,2,7102
2,7,2016,The Grand Pub,Eating Out,7,7095
2,7,2016,The Grand Pub,Eating Out,13,7082
2,7,2016,The Grand Pub,Eating Out,16,7066
3,7,2016,Anglo restaurant,Eating Out,34,7032
3,7,2016,ATM Cash Withdrawal,General,20,7012
4,7,2016,South West Trains,Transport,32,6980
4,7,2016,Wild Bean Cafe,Eating Out,1,6979
4,7,2016,ATM Cash Withdrawal,General,10,6969
5,7,2016,Starbucks Coffee,Eating Out,2,6967
5,7,2016,The West Cornwall Pasty Company,Eating Out,4,6963
6,7,2016,Caffe Nero,Eating Out,1,6962
6,7,2016,McDonalds,Eating Out,8,6954
7,7,2016,Cubit and West rent,Rent,440,6514
7,7,2016,Starbucks Coffee,Eating Out,1,6513
7,7,2016,McDonalds,Eating Out,8,6505
8,7,2016,Waitrose,Groceries,60,6445
8,7,2016,Starbucks Coffee,Eating Out,1,6444
8,7,2016,Greggs,Eating Out,6,6438
8,7,2016,ATM Cash Withdrawal,General,10,6428
10,7,2016,ATM Cash Withdrawal,General,10,6418
11,7,2016,South West Trains,Transport,38,6380
11,7,2016,Costa Coffee,Eating Out,2,6378
11,7,2016,McDonalds,Eating Out,5,6373
12,7,2016,Costa Coffee,Eating Out,2,6371
12,7,2016,ATM Cash Withdrawal,General,10,6361
13,7,2016,Chicken Cottage,Eating Out,7,6354
13,7,2016,Tool Shop,,2,6352
14,7,2016,Costa Coffee,Eating Out,2,6350
14,7,2016,ATM Cash Withdrawal,General,10,6340
15,7,2016,BRGAS-Electricity,Bills,22,6318
15,7,2016,BRGAS-Gas,Bills,22,6296
15,7,2016,ASDA,Groceries,52,6244
15,7,2016,Caffe Nero,Eating Out,2,6242
15,7,2016,McDonalds,Eating Out,8,6234
16,7,2016,LBS Council Tax,Bills,35,6199
18,7,2016,South West Trains,Transport,32,6167
18,7,2016,Wild Bean Cafe,Eating Out,2,6165
19,7,2016,Starbucks Coffee,Eating Out,1,6164
19,7,2016,The West Cornwall Pasty Company,Eating Out,6,6158
20,7,2016,VIRGIN MEDIA PYMTS,Bills,43,6115
20,7,2016,Starbucks Coffee,Eating Out,1,6114
20,7,2016,McDonalds,Eating Out,7,6107
21,7,2016,Wild Bean Cafe,Eating Out,2,6105
21,7,2016,McDonalds,Eating Out,7,6098
22,7,2016,ASDA,Groceries,40,6058
22,7,2016,The Grand Pub,Eating Out,12,6046
22,7,2016,The Grand Pub,Eating Out,5,6041
22,7,2016,The Grand Pub,Eating Out,7,6034
22,7,2016,Anglo restaurant,Eating Out,46,5988
24,7,2016,O2,Bills,27,5961
25,7,2016,South West Trains,Transport,28,5933
25,7,2016,McDonalds,Eating Out,7,5926
25,7,2016,Red Shop,,5,5921
26,7,2016,Greggs,Eating Out,8,5913
27,7,2016,The West Cornwall Pasty Company,Eating Out,7,5906
28,7,2016,Costa Coffee,Eating Out,2,5904
28,7,2016,Chicken Cottage,Eating Out,5,5899
29,7,2016,ASDA,Groceries,41,5858
29,7,2016,Costa Coffee,Eating Out,1,5857
29,7,2016,Pizza Express,Eating Out,59,5798
29,7,2016,ATM Cash Withdrawal,General,20,5778
29,7,2016,Tool Tec,,3,5775
31,7,2016,Cheam Service Station,,7,5768
1,8,2016,Rhino Sports salary,General,1600,7368
1,8,2016,South West Trains,Transport,25,7343
2,8,2016,Wild Bean Cafe,Eating Out,2,7341
2,8,2016,Chicken Cottage,Eating Out,5,7336
3,8,2016,The West Cornwall Pasty Company,Eating Out,8,7328
4,8,2016,Caffe Nero,Eating Out,2,7326
4,8,2016,Greggs,Eating Out,5,7321
5,8,2016,Tescos,Groceries,56,7265
5,8,2016,Wild Bean Cafe,Eating Out,2,7263
5,8,2016,Chicken Cottage,Eating Out,8,7255
7,8,2016,Cubit and West rent,Rent,440,6815
7,8,2016,Scott's Restaurant,Eating Out,41,6774
8,8,2016,South West Trains,Transport,35,6739
8,8,2016,Wild Bean Cafe,Eating Out,2,6737
8,8,2016,Greggs,Eating Out,7,6730
9,8,2016,Caffe Nero,Eating Out,2,6728
9,8,2016,Pret A Manger,Eating Out,5,6723
9,8,2016,ATM Cash Withdrawal,General,20,6703
10,8,2016,Caffe Nero,Eating Out,2,6701
10,8,2016,The West Cornwall Pasty Company,Eating Out,7,6694
10,8,2016,ATM Cash Withdrawal,General,20,6674
11,8,2016,Wild Bean Cafe,Eating Out,2,6672
11,8,2016,Chicken Cottage,Eating Out,4,6668
12,8,2016,ASDA,Groceries,68,6600
12,8,2016,Chicken Cottage,Eating Out,5,6595
12,8,2016,ATM Cash Withdrawal,General,10,6585
13,8,2016,Fabric Club,Eating Out,5,6580
13,8,2016,Fabric Club,Eating Out,13,6567
13,8,2016,Fabric Club,Eating Out,8,6559
13,8,2016,Fabric Club,Eating Out,8,6551
14,8,2016,Pizza Express,Eating Out,29,6522
15,8,2016,BRGAS-Electricity,Bills,17,6505
15,8,2016,BRGAS-Gas,Bills,21,6484
15,8,2016,South West Trains,Transport,33,6451
15,8,2016,Caffe Nero,Eating Out,2,6449
16,8,2016,LBS Council Tax,Bills,35,6414
16,8,2016,Caffe Nero,Eating Out,2,6412
16,8,2016,The West Cornwall Pasty Company,Eating Out,8,6404
17,8,2016,Starbucks Coffee,Eating Out,2,6402
17,8,2016,Greggs,Eating Out,4,6398
17,8,2016,ATM Cash Withdrawal,General,20,6378
18,8,2016,Caffe Nero,Eating Out,2,6376
18,8,2016,Chicken Cottage,Eating Out,5,6371
18,8,2016,ATM Cash Withdrawal,General,20,6351
19,8,2016,Morrisons,Groceries,39,6312
19,8,2016,Caffe Nero,Eating Out,1,6311
19,8,2016,McDonalds,Eating Out,7,6304
20,8,2016,VIRGIN MEDIA PYMTS,Bills,38,6266
20,8,2016,Pizza Express,Eating Out,54,6212
22,8,2016,South West Trains,Transport,25,6187
23,8,2016,Starbucks Coffee,Eating Out,2,6185
23,8,2016,Subway,Eating Out,7,6178
24,8,2016,O2,Bills,26,6152
24,8,2016,Caffe Nero,Eating Out,2,6150
25,8,2016,McDonalds,Eating Out,4,6146
25,8,2016,ATM Cash Withdrawal,General,20,6126
26,8,2016,Sainsburys,Groceries,75,6051
26,8,2016,Subway,Eating Out,5,6046
26,8,2016,Heaven Club,Eating Out,15,6031
26,8,2016,Heaven Club,Eating Out,6,6025
26,8,2016,Heaven Club,Eating Out,14,6011
26,8,2016,Heaven Club,Eating Out,11,6000
26,8,2016,Paying back James,,9,5991
28,8,2016,Anglo restaurant,Eating Out,41,5950
28,8,2016,ATM Cash Withdrawal,General,20,5930
29,8,2016,South West Trains,Transport,27,5903
29,8,2016,Starbucks Coffee,Eating Out,2,5901
30,8,2016,Costa Coffee,Eating Out,2,5899
30,8,2016,Paying back James,,2,5897
31,8,2016,Costa Coffee,Eating Out,2,5895
1,9,2016,Rhino Sports salary,General,1600,7495
2,9,2016,Sainsburys,Groceries,52,7443
2,9,2016,Starbucks Coffee,Eating Out,1,7442
2,9,2016,Pizza Express,Eating Out,27,7415
5,9,2016,South West Trains,Transport,32,7383
5,9,2016,Chicken Cottage,Eating Out,8,7375
5,9,2016,Tool Tec,,1,7374
6,9,2016,Costa Coffee,Eating Out,1,7373
6,9,2016,The West Cornwall Pasty Company,Eating Out,4,7369
6,9,2016,ATM Cash Withdrawal,General,10,7359
7,9,2016,Cubit and West rent,Rent,440,6919
7,9,2016,Starbucks Coffee,Eating Out,2,6917
7,9,2016,Chicken Cottage,Eating Out,8,6909
8,9,2016,Costa Coffee,Eating Out,1,6908
9,9,2016,Waitrose,Groceries,46,6862
9,9,2016,Starbucks Coffee,Eating Out,2,6860
11,9,2016,Dominos Pizza,Eating Out,44,6816
12,9,2016,South West Trains,Transport,29,6787
12,9,2016,Caffe Nero,Eating Out,1,6786
12,9,2016,Chicken Cottage,Eating Out,5,6781
12,9,2016,Tool Tec,,8,6773
13,9,2016,Starbucks Coffee,Eating Out,1,6772
13,9,2016,Pret A Manger,Eating Out,5,6767
13,9,2016,ATM Cash Withdrawal,General,10,6757
14,9,2016,Costa Coffee,Eating Out,2,6755
14,9,2016,Subway,Eating Out,4,6751
15,9,2016,BRGAS-Electricity,Bills,19,6732
15,9,2016,BRGAS-Gas,Bills,18,6714
15,9,2016,Costa Coffee,Eating Out,2,6712
16,9,2016,LBS Council Tax,Bills,35,6677
16,9,2016,Sainsburys,Groceries,48,6629
16,9,2016,McDonalds,Eating Out,7,6622
17,9,2016,Heaven Club,Eating Out,10,6612
17,9,2016,Heaven Club,Eating Out,6,6606
17,9,2016,Heaven Club,Eating Out,10,6596
17,9,2016,Heaven Club,Eating Out,9,6587
17,9,2016,ATM Cash Withdrawal,General,20,6567
17,9,2016,Paying back Julie,,8,6559
19,9,2016,South West Trains,Transport,31,6528
19,9,2016,Wild Bean Cafe,Eating Out,1,6527
19,9,2016,ATM Cash Withdrawal,General,20,6507
20,9,2016,VIRGIN MEDIA PYMTS,Bills,43,6464
20,9,2016,McDonalds,Eating Out,7,6457
20,9,2016,Cheam Service Station,,4,6453
21,9,2016,Wild Bean Cafe,Eating Out,1,6452
21,9,2016,Chicken Cottage,Eating Out,8,6444
21,9,2016,ATM Cash Withdrawal,General,10,6434
21,9,2016,Civic Shop,,1,6433
22,9,2016,Wild Bean Cafe,Eating Out,2,6431
23,9,2016,Morrisons,Groceries,74,6357
23,9,2016,Costa Coffee,Eating Out,2,6355
23,9,2016,Chicken Cottage,Eating Out,7,6348
24,9,2016,O2,Bills,25,6323
24,9,2016,ATM Cash Withdrawal,General,10,6313
26,9,2016,South West Trains,Transport,35,6278
26,9,2016,Costa Coffee,Eating Out,2,6276
26,9,2016,The West Cornwall Pasty Company,Eating Out,8,6268
27,9,2016,Pret A Manger,Eating Out,5,6263
28,9,2016,Costa Coffee,Eating Out,1,6262
28,9,2016,Greggs,Eating Out,5,6257
28,9,2016,ATM Cash Withdrawal,General,10,6247
29,9,2016,Wild Bean Cafe,Eating Out,2,6245
29,9,2016,Pret A Manger,Eating Out,7,6238
29,9,2016,ATM Cash Withdrawal,General,20,6218
29,9,2016,Cheam Service Station,,3,6215
30,9,2016,Waitrose,Groceries,70,6145
30,9,2016,Costa Coffee,Eating Out,2,6143
30,9,2016,Chicken Cottage,Eating Out,7,6136
30,9,2016,Pizza Express,Eating Out,33,6103
1,10,2016,Rhino Sports salary,General,1600,7703
1,10,2016,Tool Shop,,9,7694
2,10,2016,Pizza Express,Eating Out,51,7643
2,10,2016,ATM Cash Withdrawal,General,10,7633
2,10,2016,Cheam Service Station,,2,7631
3,10,2016,South West Trains,Transport,38,7593
3,10,2016,Wild Bean Cafe,Eating Out,2,7591
3,10,2016,Subway,Eating Out,5,7586
3,10,2016,ATM Cash Withdrawal,General,10,7576
3,10,2016,Red Shop,,8,7568
4,10,2016,Wild Bean Cafe,Eating Out,2,7566
4,10,2016,Greggs,Eating Out,8,7558
5,10,2016,The West Cornwall Pasty Company,Eating Out,5,7553
5,10,2016,ATM Cash Withdrawal,General,10,7543
6,10,2016,Costa Coffee,Eating Out,1,7542
6,10,2016,The West Cornwall Pasty Company,Eating Out,5,7537
7,10,2016,Cubit and West rent,Rent,440,7097
7,10,2016,Waitrose,Groceries,44,7053
7,10,2016,Wild Bean Cafe,Eating Out,2,7051
7,10,2016,Red Shop,,4,7047
9,10,2016,ATM Cash Withdrawal,General,10,7037
10,10,2016,South West Trains,Transport,33,7004
10,10,2016,Wild Bean Cafe,Eating Out,1,7003
10,10,2016,Chicken Cottage,Eating Out,5,6998
11,10,2016,Caffe Nero,Eating Out,2,6996
12,10,2016,Wild Bean Cafe,Eating Out,1,6995
12,10,2016,ATM Cash Withdrawal,General,20,6975
13,10,2016,Starbucks Coffee,Eating Out,2,6973
13,10,2016,Pret A Manger,Eating Out,6,6967
14,10,2016,ASDA,Groceries,48,6919
14,10,2016,Wild Bean Cafe,Eating Out,1,6918
14,10,2016,The West Cornwall Pasty Company,Eating Out,8,6910
14,10,2016,Paying back James,,3,6907
15,10,2016,BRGAS-Electricity,Bills,27,6880
15,10,2016,BRGAS-Gas,Bills,32,6848
16,10,2016,LBS Council Tax,Bills,35,6813
16,10,2016,Paying back James,,5,6808
17,10,2016,South West Trains,Transport,34,6774
17,10,2016,Starbucks Coffee,Eating Out,1,6773
17,10,2016,Chicken Cottage,Eating Out,5,6768
18,10,2016,Wild Bean Cafe,Eating Out,1,6767
18,10,2016,Chicken Cottage,Eating Out,5,6762
19,10,2016,Wild Bean Cafe,Eating Out,2,6760
19,10,2016,Chicken Cottage,Eating Out,8,6752
20,10,2016,VIRGIN MEDIA PYMTS,Bills,39,6713
20,10,2016,McDonalds,Eating Out,6,6707
20,10,2016,ATM Cash Withdrawal,General,10,6697
21,10,2016,Tescos,Groceries,49,6648
21,10,2016,Subway,Eating Out,6,6642
21,10,2016,Pizza Express,Eating Out,29,6613
22,10,2016,Pizza Express,Eating Out,38,6575
24,10,2016,O2,Bills,32,6543
24,10,2016,South West Trains,Transport,25,6518
24,10,2016,ATM Cash Withdrawal,General,20,6498
25,10,2016,Costa Coffee,Eating Out,2,6496
25,10,2016,ATM Cash Withdrawal,General,10,6486
26,10,2016,McDonalds,Eating Out,5,6481
27,10,2016,Wild Bean Cafe,Eating Out,2,6479
27,10,2016,Subway,Eating Out,4,6475
27,10,2016,ATM Cash Withdrawal,General,10,6465
28,10,2016,Tescos,Groceries,82,6383
28,10,2016,Caffe Nero,Eating Out,2,6381
28,10,2016,Subway,Eating Out,8,6373
29,10,2016,ATM Cash Withdrawal,General,10,6363
30,10,2016,ATM Cash Withdrawal,General,20,6343
31,10,2016,South West Trains,Transport,36,6307
31,10,2016,ATM Cash Withdrawal,General,10,6297
1,11,2016,Rhino Sports salary,General,1600,7897
1,11,2016,Wild Bean Cafe,Eating Out,2,7895
1,11,2016,ATM Cash Withdrawal,General,20,7875
1,11,2016,Paying back Julie,,4,7871
2,11,2016,Costa Coffee,Eating Out,1,7870
2,11,2016,McDonalds,Eating Out,6,7864
2,11,2016,ATM Cash Withdrawal,General,20,7844
3,11,2016,Costa Coffee,Eating Out,1,7843
3,11,2016,Subway,Eating Out,8,7835
4,11,2016,ASDA,Groceries,70,7765
4,11,2016,Wild Bean Cafe,Eating Out,1,7764
4,11,2016,Greggs,Eating Out,7,7757
4,11,2016,Anglo restaurant,Eating Out,43,7714
4,11,2016,ATM Cash Withdrawal,General,10,7704
5,11,2016,Scott's Restaurant,Eating Out,29,7675
5,11,2016,ATM Cash Withdrawal,General,10,7665
7,11,2016,Cubit and West rent,Rent,440,7225
7,11,2016,South West Trains,Transport,38,7187
8,11,2016,Costa Coffee,Eating Out,2,7185
8,11,2016,Greggs,Eating Out,5,7180
9,11,2016,Caffe Nero,Eating Out,2,7178
9,11,2016,Pret A Manger,Eating Out,7,7171
10,11,2016,Costa Coffee,Eating Out,1,7170
10,11,2016,Greggs,Eating Out,4,7166
11,11,2016,Waitrose,Groceries,49,7117
11,11,2016,Starbucks Coffee,Eating Out,2,7115
11,11,2016,Greggs,Eating Out,8,7107
12,11,2016,Fabric Club,Eating Out,12,7095
12,11,2016,Fabric Club,Eating Out,14,7081
12,11,2016,Fabric Club,Eating Out,10,7071
12,11,2016,Dominos Pizza,Eating Out,49,7022
13,11,2016,Dominos Pizza,Eating Out,25,6997
14,11,2016,South West Trains,Transport,38,6959
14,11,2016,Caffe Nero,Eating Out,2,6957
14,11,2016,Tool Shop,,3,6954
15,11,2016,BRGAS-Electricity,Bills,51,6903
15,11,2016,BRGAS-Gas,Bills,28,6875
15,11,2016,Wild Bean Cafe,Eating Out,1,6874
15,11,2016,The West Cornwall Pasty Company,Eating Out,6,6868
16,11,2016,LBS Council Tax,Bills,35,6833
16,11,2016,Costa Coffee,Eating Out,1,6832
16,11,2016,McDonalds,Eating Out,6,6826
17,11,2016,Caffe Nero,Eating Out,2,6824
17,11,2016,The West Cornwall Pasty Company,Eating Out,6,6818
17,11,2016,Paying back James,,8,6810
18,11,2016,Waitrose,Groceries,50,6760
18,11,2016,Costa Coffee,Eating Out,1,6759
18,11,2016,Scott's Restaurant,Eating Out,27,6732
20,11,2016,VIRGIN MEDIA PYMTS,Bills,43,6689
21,11,2016,South West Trains,Transport,26,6663
21,11,2016,Starbucks Coffee,Eating Out,1,6662
21,11,2016,McDonalds,Eating Out,8,6654
22,11,2016,Subway,Eating Out,4,6650
22,11,2016,ATM Cash Withdrawal,General,20,6630
23,11,2016,ATM Cash Withdrawal,General,20,6610
24,11,2016,O2,Bills,26,6584
24,11,2016,Costa Coffee,Eating Out,2,6582
24,11,2016,McDonalds,Eating Out,7,6575
25,11,2016,Waitrose,Groceries,71,6504
25,11,2016,Caffe Nero,Eating Out,2,6502
26,11,2016,ATM Cash Withdrawal,General,10,6492
26,11,2016,Paying back Julie,,4,6488
28,11,2016,South West Trains,Transport,35,6453
28,11,2016,Wild Bean Cafe,Eating Out,2,6451
28,11,2016,Pret A Manger,Eating Out,4,6447
28,11,2016,Red Shop,,6,6441
29,11,2016,Caffe Nero,Eating Out,2,6439
30,11,2016,Costa Coffee,Eating Out,2,6437
30,11,2016,Tool Tec,,2,6435
1,12,2016,Rhino Sports salary,General,1600,8035
1,12,2016,Caffe Nero,Eating Out,2,8033
2,12,2016,ASDA,Groceries,76,7957
2,12,2016,Caffe Nero,Eating Out,2,7955
2,12,2016,Dominos Pizza,Eating Out,30,7925
3,12,2016,Anglo restaurant,Eating Out,29,7896
5,12,2016,South West Trains,Transport,37,7859
5,12,2016,Starbucks Coffee,Eating Out,2,7857
5,12,2016,Subway,Eating Out,5,7852
6,12,2016,Costa Coffee,Eating Out,2,7850
7,12,2016,Cubit and West rent,Rent,440,7410
7,12,2016,Costa Coffee,Eating Out,2,7408
7,12,2016,Subway,Eating Out,4,7404
8,12,2016,Caffe Nero,Eating Out,2,7402
8,12,2016,ATM Cash Withdrawal,General,20,7382
9,12,2016,Morrisons,Groceries,50,7332
9,12,2016,Starbucks Coffee,Eating Out,2,7330
9,12,2016,Fabric Club,Eating Out,8,7322
9,12,2016,Fabric Club,Eating Out,5,7317
9,12,2016,Fabric Club,Eating Out,8,7309
9,12,2016,Fabric Club,Eating Out,7,7302
9,12,2016,Fabric Club,Eating Out,6,7296
9,12,2016,Anglo restaurant,Eating Out,49,7247
10,12,2016,Dominos Pizza,Eating Out,25,7222
10,12,2016,ATM Cash Withdrawal,General,20,7202
10,12,2016,Cheam Service Station,,9,7193
11,12,2016,Dominos Pizza,Eating Out,56,7137
12,12,2016,South West Trains,Transport,36,7101
12,12,2016,Caffe Nero,Eating Out,1,7100
12,12,2016,Pret A Manger,Eating Out,8,7092
13,12,2016,McDonalds,Eating Out,7,7085
13,12,2016,ATM Cash Withdrawal,General,20,7065
14,12,2016,Costa Coffee,Eating Out,2,7063
14,12,2016,McDonalds,Eating Out,5,7058
15,12,2016,BRGAS-Electricity,Bills,37,7021
15,12,2016,BRGAS-Gas,Bills,23,6998
15,12,2016,Costa Coffee,Eating Out,1,6997
15,12,2016,Chicken Cottage,Eating Out,6,6991
16,12,2016,LBS Council Tax,Bills,35,6956
16,12,2016,Waitrose,Groceries,47,6909
16,12,2016,Starbucks Coffee,Eating Out,2,6907
17,12,2016,Restaurant Gordon RamsayPortland Restaurant,Eating Out,51,6856
17,12,2016,ATM Cash Withdrawal,General,10,6846
18,12,2016,Restaurant Gordon RamsayPortland Restaurant,Eating Out,45,6801
18,12,2016,ATM Cash Withdrawal,General,20,6781
19,12,2016,South West Trains,Transport,30,6751
19,12,2016,Starbucks Coffee,Eating Out,1,6750
19,12,2016,ATM Cash Withdrawal,General,20,6730
20,12,2016,VIRGIN MEDIA PYMTS,Bills,22,6708
21,12,2016,Starbucks Coffee,Eating Out,1,6707
21,12,2016,McDonalds,Eating Out,4,6703
22,12,2016,Subway,Eating Out,4,6699
22,12,2016,ATM Cash Withdrawal,General,10,6689
22,12,2016,Civic Shop,,6,6683
23,12,2016,Waitrose,Groceries,56,6627
23,12,2016,Wild Bean Cafe,Eating Out,1,6626
23,12,2016,Subway,Eating Out,8,6618
23,12,2016,The Grand Pub,Eating Out,11,6607
23,12,2016,The Grand Pub,Eating Out,9,6598
23,12,2016,The Grand Pub,Eating Out,12,6586
23,12,2016,The Grand Pub,Eating Out,6,6580
23,12,2016,The Grand Pub,Eating Out,13,6567
23,12,2016,Anglo restaurant,Eating Out,52,6515
23,12,2016,ATM Cash Withdrawal,General,20,6495
23,12,2016,Paying back James,,7,6488
24,12,2016,O2,Bills,30,6458
24,12,2016,Pizza Express,Eating Out,43,6415
26,12,2016,South West Trains,Transport,28,6387
26,12,2016,Caffe Nero,Eating Out,1,6386
26,12,2016,Pret A Manger,Eating Out,6,6380
26,12,2016,ATM Cash Withdrawal,General,10,6370
27,12,2016,Caffe Nero,Eating Out,1,6369
27,12,2016,Paying back Julie,,5,6364
29,12,2016,Chicken Cottage,Eating Out,6,6358
29,12,2016,ATM Cash Withdrawal,General,20,6338
30,12,2016,Waitrose,Groceries,58,6280
30,12,2016,Costa Coffee,Eating Out,2,6278
30,12,2016,McDonalds,Eating Out,5,6273
30,12,2016,ATM Cash Withdrawal,General,10,6263
31,12,2016,Red Shop,,9,6254
1,1,2017,Rhino Sports salary,General,1600,7854
2,1,2017,South West Trains,Transport,37,7817
2,1,2017,Caffe Nero,Eating Out,2,7815
2,1,2017,Greggs,Eating Out,5,7810
3,1,2017,Costa Coffee,Eating Out,2,7808
3,1,2017,McDonalds,Eating Out,7,7801
4,1,2017,Costa Coffee,Eating Out,1,7800
4,1,2017,McDonalds,Eating Out,5,7795
5,1,2017,Wild Bean Cafe,Eating Out,2,7793
5,1,2017,Greggs,Eating Out,8,7785
6,1,2017,Tescos,Groceries,71,7714
6,1,2017,Costa Coffee,Eating Out,2,7712
6,1,2017,Restaurant Gordon RamsayPortland Restaurant,Eating Out,36,7676
7,1,2017,Cubit and West rent,Rent,440,7236
7,1,2017,Restaurant Gordon RamsayPortland Restaurant,Eating Out,27,7209
7,1,2017,ATM Cash Withdrawal,General,20,7189
9,1,2017,South West Trains,Transport,31,7158
9,1,2017,Wild Bean Cafe,Eating Out,1,7157
9,1,2017,Greggs,Eating Out,7,7150
10,1,2017,Starbucks Coffee,Eating Out,2,7148
10,1,2017,Pret A Manger,Eating Out,8,7140
11,1,2017,Wild Bean Cafe,Eating Out,2,7138
11,1,2017,Subway,Eating Out,8,7130
13,1,2017,Morrisons,Groceries,56,7074
13,1,2017,Wild Bean Cafe,Eating Out,2,7072
13,1,2017,Subway,Eating Out,5,7067
13,1,2017,Tool Shop,,2,7065
14,1,2017,ATM Cash Withdrawal,General,20,7045
15,1,2017,BRGAS-Electricity,Bills,64,6981
15,1,2017,BRGAS-Gas,Bills,38,6943
15,1,2017,Pizza Express,Eating Out,51,6892
16,1,2017,LBS Council Tax,Bills,35,6857
16,1,2017,South West Trains,Transport,29,6828
16,1,2017,Costa Coffee,Eating Out,2,6826
16,1,2017,ATM Cash Withdrawal,General,10,6816
17,1,2017,Costa Coffee,Eating Out,2,6814
17,1,2017,Pret A Manger,Eating Out,7,6807
17,1,2017,Paying back James,,6,6801
18,1,2017,Caffe Nero,Eating Out,2,6799
18,1,2017,ATM Cash Withdrawal,General,20,6779
19,1,2017,Costa Coffee,Eating Out,2,6777
19,1,2017,Chicken Cottage,Eating Out,4,6773
19,1,2017,Civic Shop,,6,6767
20,1,2017,VIRGIN MEDIA PYMTS,Bills,25,6742
20,1,2017,Sainsburys,Groceries,50,6692
20,1,2017,Starbucks Coffee,Eating Out,1,6691
20,1,2017,Pret A Manger,Eating Out,5,6686
20,1,2017,ATM Cash Withdrawal,General,10,6676
21,1,2017,Restaurant Gordon RamsayPortland Restaurant,Eating Out,31,6645
21,1,2017,ATM Cash Withdrawal,General,10,6635
22,1,2017,Restaurant Gordon RamsayPortland Restaurant,Eating Out,32,6603
23,1,2017,South West Trains,Transport,31,6572
23,1,2017,Wild Bean Cafe,Eating Out,2,6570
23,1,2017,ATM Cash Withdrawal,General,10,6560
24,1,2017,O2,Bills,29,6531
25,1,2017,Wild Bean Cafe,Eating Out,2,6529
25,1,2017,Chicken Cottage,Eating Out,7,6522
25,1,2017,ATM Cash Withdrawal,General,10,6512
26,1,2017,Costa Coffee,Eating Out,2,6510
26,1,2017,Greggs,Eating Out,8,6502
27,1,2017,Sainsburys,Groceries,63,6439
27,1,2017,Costa Coffee,Eating Out,1,6438
27,1,2017,The West Cornwall Pasty Company,Eating Out,7,6431
27,1,2017,Anglo restaurant,Eating Out,39,6392
28,1,2017,Ministry of Sound ClubXOYO Club,Eating Out,9,6383
28,1,2017,Ministry of Sound ClubXOYO Club,Eating Out,14,6369
28,1,2017,Ministry of Sound ClubXOYO Club,Eating Out,10,6359
28,1,2017,Ministry of Sound ClubXOYO Club,Eating Out,13,6346
29,1,2017,Pizza Express,Eating Out,39,6307
30,1,2017,South West Trains,Transport,28,6279
30,1,2017,Caffe Nero,Eating Out,1,6278
30,1,2017,Subway,Eating Out,5,6273
30,1,2017,ATM Cash Withdrawal,General,10,6263
30,1,2017,Civic Shop,,3,6260
1,2,2017,Rhino Sports salary,General,1600,7860
1,2,2017,The West Cornwall Pasty Company,Eating Out,6,7854
2,2,2017,Caffe Nero,Eating Out,1,7853
2,2,2017,The West Cornwall Pasty Company,Eating Out,5,7848
2,2,2017,Paying back James,,6,7842
3,2,2017,Waitrose,Groceries,55,7787
3,2,2017,Caffe Nero,Eating Out,1,7786
3,2,2017,Chicken Cottage,Eating Out,8,7778
3,2,2017,Fabric Club,Eating Out,12,7766
3,2,2017,Fabric Club,Eating Out,7,7759
3,2,2017,Fabric Club,Eating Out,16,7743
3,2,2017,Fabric Club,Eating Out,6,7737
3,2,2017,ATM Cash Withdrawal,General,20,7717
5,2,2017,Anglo restaurant,Eating Out,54,7663
6,2,2017,South West Trains,Transport,24,7639
6,2,2017,Starbucks Coffee,Eating Out,1,7638
6,2,2017,Chicken Cottage,Eating Out,6,7632
6,2,2017,ATM Cash Withdrawal,General,10,7622
7,2,2017,Cubit and West rent,Rent,440,7182
7,2,2017,Caffe Nero,Eating Out,1,7181
7,2,2017,The West Cornwall Pasty Company,Eating Out,5,7176
8,2,2017,Starbucks Coffee,Eating Out,1,7175
8,2,2017,Chicken Cottage,Eating Out,4,7171
9,2,2017,Costa Coffee,Eating Out,1,7170
9,2,2017,Pret A Manger,Eating Out,4,7166
9,2,2017,ATM Cash Withdrawal,General,10,7156
10,2,2017,Waitrose,Groceries,80,7076
10,2,2017,The West Cornwall Pasty Company,Eating Out,8,7068
10,2,2017,Fabric Club,Eating Out,11,7057
10,2,2017,Fabric Club,Eating Out,11,7046
10,2,2017,Fabric Club,Eating Out,8,7038
11,2,2017,ATM Cash Withdrawal,General,20,7018
13,2,2017,South West Trains,Transport,34,6984
13,2,2017,Wild Bean Cafe,Eating Out,2,6982
13,2,2017,Subway,Eating Out,8,6974
14,2,2017,Starbucks Coffee,Eating Out,2,6972
14,2,2017,The West Cornwall Pasty Company,Eating Out,5,6967
14,2,2017,ATM Cash Withdrawal,General,20,6947
15,2,2017,BRGAS-Electricity,Bills,33,6914
15,2,2017,BRGAS-Gas,Bills,33,6881
15,2,2017,ATM Cash Withdrawal,General,10,6871
16,2,2017,LBS Council Tax,Bills,35,6836
16,2,2017,Wild Bean Cafe,Eating Out,1,6835
17,2,2017,Morrisons,Groceries,65,6770
17,2,2017,Subway,Eating Out,4,6766
19,2,2017,ATM Cash Withdrawal,General,10,6756
20,2,2017,VIRGIN MEDIA PYMTS,Bills,44,6712
20,2,2017,South West Trains,Transport,36,6676
20,2,2017,Wild Bean Cafe,Eating Out,2,6674
20,2,2017,Chicken Cottage,Eating Out,8,6666
21,2,2017,The West Cornwall Pasty Company,Eating Out,4,6662
22,2,2017,Wild Bean Cafe,Eating Out,2,6660
23,2,2017,Costa Coffee,Eating Out,2,6658
23,2,2017,McDonalds,Eating Out,5,6653
24,2,2017,O2,Bills,25,6628
24,2,2017,Tescos,Groceries,77,6551
24,2,2017,Starbucks Coffee,Eating Out,2,6549
24,2,2017,McDonalds,Eating Out,5,6544
24,2,2017,Ministry of Sound ClubXOYO Club,Eating Out,14,6530
24,2,2017,Ministry of Sound ClubXOYO Club,Eating Out,7,6523
24,2,2017,ATM Cash Withdrawal,General,20,6503
24,2,2017,Tool Shop,,9,6494
27,2,2017,South West Trains,Transport,31,6463
27,2,2017,Caffe Nero,Eating Out,2,6461
27,2,2017,Chicken Cottage,Eating Out,5,6456
28,2,2017,Caffe Nero,Eating Out,1,6455
28,2,2017,Pret A Manger,Eating Out,5,6450
28,2,2017,Tool Shop,,5,6445
1,3,2017,Rhino Sports salary,General,1600,8045
1,3,2017,Wild Bean Cafe,Eating Out,2,8043
2,3,2017,Costa Coffee,Eating Out,2,8041
2,3,2017,Chicken Cottage,Eating Out,6,8035
3,3,2017,ASDA,Groceries,55,7980
3,3,2017,Wild Bean Cafe,Eating Out,2,7978
4,3,2017,Scott's Restaurant,Eating Out,50,7928
4,3,2017,ATM Cash Withdrawal,General,20,7908
5,3,2017,Restaurant Gordon RamsayPortland Restaurant,Eating Out,52,7856
6,3,2017,South West Trains,Transport,37,7819
6,3,2017,Starbucks Coffee,Eating Out,2,7817
6,3,2017,Subway,Eating Out,7,7810
6,3,2017,ATM Cash Withdrawal,General,20,7790
7,3,2017,Cubit and West rent,Rent,440,7350
7,3,2017,Costa Coffee,Eating Out,1,7349
7,3,2017,McDonalds,Eating Out,4,7345
7,3,2017,ATM Cash Withdrawal,General,20,7325
8,3,2017,Caffe Nero,Eating Out,2,7323
10,3,2017,ASDA,Groceries,74,7249
10,3,2017,The Grand Pub,Eating Out,6,7243
10,3,2017,The Grand Pub,Eating Out,5,7238
10,3,2017,The Grand Pub,Eating Out,6,7232
10,3,2017,The Grand Pub,Eating Out,11,7221
10,3,2017,The Grand Pub,Eating Out,14,7207
10,3,2017,ATM Cash Withdrawal,General,20,7187
11,3,2017,Pizza Express,Eating Out,55,7132
12,3,2017,Scott's Restaurant,Eating Out,49,7083
12,3,2017,ATM Cash Withdrawal,General,20,7063
12,3,2017,Tool Shop,,8,7055
13,3,2017,South West Trains,Transport,28,7027
13,3,2017,Starbucks Coffee,Eating Out,2,7025
13,3,2017,Greggs,Eating Out,8,7017
13,3,2017,ATM Cash Withdrawal,General,10,7007
14,3,2017,Costa Coffee,Eating Out,1,7006
14,3,2017,Subway,Eating Out,5,7001
15,3,2017,BRGAS-Electricity,Bills,20,6981
15,3,2017,BRGAS-Gas,Bills,20,6961
15,3,2017,Starbucks Coffee,Eating Out,2,6959
15,3,2017,Subway,Eating Out,7,6952
15,3,2017,ATM Cash Withdrawal,General,10,6942
16,3,2017,LBS Council Tax,Bills,35,6907
16,3,2017,Costa Coffee,Eating Out,2,6905
16,3,2017,ATM Cash Withdrawal,General,20,6885
16,3,2017,Red Shop,,2,6883
17,3,2017,Morrisons,Groceries,64,6819
17,3,2017,Starbucks Coffee,Eating Out,2,6817
19,3,2017,Tool Tec,,3,6814
20,3,2017,VIRGIN MEDIA PYMTS,Bills,32,6782
20,3,2017,South West Trains,Transport,38,6744
20,3,2017,Wild Bean Cafe,Eating Out,2,6742
20,3,2017,Chicken Cottage,Eating Out,4,6738
21,3,2017,Costa Coffee,Eating Out,2,6736
22,3,2017,Costa Coffee,Eating Out,1,6735
22,3,2017,Pret A Manger,Eating Out,7,6728
23,3,2017,Chicken Cottage,Eating Out,8,6720
23,3,2017,ATM Cash Withdrawal,General,10,6710
24,3,2017,O2,Bills,25,6685
24,3,2017,ASDA,Groceries,77,6608
24,3,2017,Caffe Nero,Eating Out,2,6606
25,3,2017,ATM Cash Withdrawal,General,10,6596
26,3,2017,Pizza Express,Eating Out,27,6569
26,3,2017,ATM Cash Withdrawal,General,20,6549
27,3,2017,South West Trains,Transport,35,6514
27,3,2017,Greggs,Eating Out,6,6508
28,3,2017,Wild Bean Cafe,Eating Out,2,6506
28,3,2017,Chicken Cottage,Eating Out,8,6498
28,3,2017,Tool Tec,,2,6496
29,3,2017,Starbucks Coffee,Eating Out,2,6494
29,3,2017,Subway,Eating Out,4,6490
30,3,2017,Wild Bean Cafe,Eating Out,2,6488
30,3,2017,Greggs,Eating Out,6,6482
31,3,2017,ASDA,Groceries,71,6411
31,3,2017,McDonalds,Eating Out,8,6403
1,4,2017,Rhino Sports salary,General,1600,8003
1,4,2017,Paying back James,,6,7997
2,4,2017,Dominos Pizza,Eating Out,52,7945
3,4,2017,South West Trains,Transport,33,7912
3,4,2017,Starbucks Coffee,Eating Out,2,7910
3,4,2017,Chicken Cottage,Eating Out,4,7906
3,4,2017,ATM Cash Withdrawal,General,10,7896
4,4,2017,ATM Cash Withdrawal,General,20,7876
5,4,2017,Starbucks Coffee,Eating Out,2,7874
5,4,2017,McDonalds,Eating Out,8,7866
5,4,2017,ATM Cash Withdrawal,General,20,7846
7,4,2017,Cubit and West rent,Rent,440,7406
7,4,2017,Waitrose,Groceries,49,7357
7,4,2017,Subway,Eating Out,4,7353
7,4,2017,Ministry of Sound ClubXOYO Club,Eating Out,10,7343
7,4,2017,Ministry of Sound ClubXOYO Club,Eating Out,6,7337
8,4,2017,Dominos Pizza,Eating Out,42,7295
8,4,2017,ATM Cash Withdrawal,General,20,7275
8,4,2017,Paying back James,,2,7273
9,4,2017,ATM Cash Withdrawal,General,20,7253
9,4,2017,Tool Shop,,2,7251
10,4,2017,South West Trains,Transport,33,7218
10,4,2017,Starbucks Coffee,Eating Out,1,7217
10,4,2017,ATM Cash Withdrawal,General,10,7207
12,4,2017,Costa Coffee,Eating Out,2,7205
12,4,2017,McDonalds,Eating Out,5,7200
13,4,2017,Subway,Eating Out,7,7193
13,4,2017,ATM Cash Withdrawal,General,20,7173
14,4,2017,Waitrose,Groceries,53,7120
14,4,2017,Caffe Nero,Eating Out,1,7119
14,4,2017,Chicken Cottage,Eating Out,6,7113
15,4,2017,BRGAS-Electricity,Bills,21,7092
15,4,2017,BRGAS-Gas,Bills,31,7061
16,4,2017,LBS Council Tax,Bills,35,7026
16,4,2017,ATM Cash Withdrawal,General,20,7006
17,4,2017,South West Trains,Transport,30,6976
17,4,2017,Wild Bean Cafe,Eating Out,1,6975
17,4,2017,Greggs,Eating Out,5,6970
17,4,2017,Tool Shop,,2,6968
18,4,2017,Starbucks Coffee,Eating Out,2,6966
18,4,2017,Chicken Cottage,Eating Out,4,6962
18,4,2017,ATM Cash Withdrawal,General,20,6942
19,4,2017,Caffe Nero,Eating Out,2,6940
19,4,2017,Tool Shop,,2,6938
20,4,2017,VIRGIN MEDIA PYMTS,Bills,43,6895
20,4,2017,Chicken Cottage,Eating Out,8,6887
20,4,2017,ATM Cash Withdrawal,General,20,6867
21,4,2017,Tescos,Groceries,41,6826
21,4,2017,Costa Coffee,Eating Out,1,6825
21,4,2017,Subway,Eating Out,8,6817
24,4,2017,O2,Bills,29,6788
24,4,2017,South West Trains,Transport,35,6753
24,4,2017,Costa Coffee,Eating Out,2,6751
24,4,2017,Greggs,Eating Out,8,6743
25,4,2017,Pret A Manger,Eating Out,5,6738
26,4,2017,Starbucks Coffee,Eating Out,1,6737
26,4,2017,Pret A Manger,Eating Out,8,6729
26,4,2017,Paying back James,,9,6720
27,4,2017,Caffe Nero,Eating Out,2,6718
28,4,2017,Waitrose,Groceries,73,6645
28,4,2017,Caffe Nero,Eating Out,2,6643
28,4,2017,McDonalds,Eating Out,5,6638
28,4,2017,The Grand Pub,Eating Out,7,6631
28,4,2017,The Grand Pub,Eating Out,14,6617
28,4,2017,The Grand Pub,Eating Out,5,6612
28,4,2017,The Grand Pub,Eating Out,5,6607
28,4,2017,The Grand Pub,Eating Out,11,6596
28,4,2017,The Grand Pub,Eating Out,6,6590
28,4,2017,Scott's Restaurant,Eating Out,53,6537
30,4,2017,Scott's Restaurant,Eating Out,31,6506
1,5,2017,Rhino Sports salary,General,1600,8106
1,5,2017,South West Trains,Transport,35,8071
1,5,2017,Costa Coffee,Eating Out,1,8070
1,5,2017,ATM Cash Withdrawal,General,20,8050
3,5,2017,Wild Bean Cafe,Eating Out,1,8049
4,5,2017,Costa Coffee,Eating Out,1,8048
4,5,2017,Greggs,Eating Out,5,8043
4,5,2017,ATM Cash Withdrawal,General,20,8023
5,5,2017,Waitrose,Groceries,65,7958
5,5,2017,Pret A Manger,Eating Out,7,7951
6,5,2017,Cheam Service Station,,8,7943
7,5,2017,Cubit and West rent,Rent,440,7503
7,5,2017,ATM Cash Withdrawal,General,10,7493
8,5,2017,South West Trains,Transport,28,7465
8,5,2017,Wild Bean Cafe,Eating Out,2,7463
8,5,2017,Subway,Eating Out,5,7458
9,5,2017,Costa Coffee,Eating Out,1,7457
9,5,2017,ATM Cash Withdrawal,General,20,7437
10,5,2017,Caffe Nero,Eating Out,2,7435
12,5,2017,Tescos,Groceries,72,7363
12,5,2017,Starbucks Coffee,Eating Out,2,7361
12,5,2017,Pret A Manger,Eating Out,7,7354
12,5,2017,Pizza Express,Eating Out,33,7321
12,5,2017,ATM Cash Withdrawal,General,10,7311
13,5,2017,Pizza Express,Eating Out,28,7283
14,5,2017,ATM Cash Withdrawal,General,20,7263
15,5,2017,BRGAS-Electricity,Bills,24,7239
15,5,2017,BRGAS-Gas,Bills,22,7217
15,5,2017,South West Trains,Transport,30,7187
15,5,2017,Costa Coffee,Eating Out,2,7185
15,5,2017,ATM Cash Withdrawal,General,20,7165
16,5,2017,LBS Council Tax,Bills,35,7130
16,5,2017,Costa Coffee,Eating Out,2,7128
16,5,2017,Greggs,Eating Out,8,7120
17,5,2017,Wild Bean Cafe,Eating Out,2,7118
18,5,2017,Costa Coffee,Eating Out,1,7117
19,5,2017,Tescos,Groceries,41,7076
19,5,2017,Pret A Manger,Eating Out,6,7070
19,5,2017,ATM Cash Withdrawal,General,20,7050
19,5,2017,Paying back James,,1,7049
20,5,2017,VIRGIN MEDIA PYMTS,Bills,30,7019
20,5,2017,Anglo restaurant,Eating Out,35,6984
20,5,2017,ATM Cash Withdrawal,General,20,6964
21,5,2017,Red Shop,,3,6961
22,5,2017,South West Trains,Transport,24,6937
22,5,2017,Starbucks Coffee,Eating Out,1,6936
23,5,2017,Wild Bean Cafe,Eating Out,1,6935
24,5,2017,O2,Bills,32,6903
24,5,2017,Subway,Eating Out,6,6897
25,5,2017,Costa Coffee,Eating Out,2,6895
25,5,2017,Greggs,Eating Out,8,6887
26,5,2017,Waitrose,Groceries,46,6841
26,5,2017,McDonalds,Eating Out,8,6833
27,5,2017,Ministry of Sound ClubXOYO Club,Eating Out,15,6818
27,5,2017,Ministry of Sound ClubXOYO Club,Eating Out,11,6807
27,5,2017,Ministry of Sound ClubXOYO Club,Eating Out,14,6793
27,5,2017,Ministry of Sound ClubXOYO Club,Eating Out,9,6784
27,5,2017,Ministry of Sound ClubXOYO Club,Eating Out,14,6770
27,5,2017,Ministry of Sound ClubXOYO Club,Eating Out,14,6756
27,5,2017,Red Shop,,3,6753
28,5,2017,Pizza Express,Eating Out,57,6696
28,5,2017,Tool Tec,,5,6691
29,5,2017,South West Trains,Transport,36,6655
29,5,2017,Costa Coffee,Eating Out,1,6654
30,5,2017,Wild Bean Cafe,Eating Out,2,6652
30,5,2017,Chicken Cottage,Eating Out,8,6644
31,5,2017,Costa Coffee,Eating Out,1,6643
31,5,2017,ATM Cash Withdrawal,General,20,6623
1,6,2017,Rhino Sports salary,General,1600,8223
1,6,2017,Caffe Nero,Eating Out,2,8221
2,6,2017,ASDA,Groceries,50,8171
2,6,2017,Wild Bean Cafe,Eating Out,2,8169
2,6,2017,Paying back James,,9,8160
3,6,2017,Dominos Pizza,Eating Out,34,8126
4,6,2017,Restaurant Gordon RamsayPortland Restaurant,Eating Out,56,8070
4,6,2017,Tool Tec,,4,8066
5,6,2017,South West Trains,Transport,36,8030
6,6,2017,Starbucks Coffee,Eating Out,1,8029
6,6,2017,McDonalds,Eating Out,4,8025
7,6,2017,Cubit and West rent,Rent,440,7585
7,6,2017,Costa Coffee,Eating Out,2,7583
7,6,2017,ATM Cash Withdrawal,General,20,7563
8,6,2017,ATM Cash Withdrawal,General,20,7543
9,6,2017,Sainsburys,Groceries,55,7488
9,6,2017,Caffe Nero,Eating Out,2,7486
9,6,2017,Pizza Express,Eating Out,38,7448
9,6,2017,ATM Cash Withdrawal,General,10,7438
11,6,2017,ATM Cash Withdrawal,General,10,7428
12,6,2017,South West Trains,Transport,28,7400
12,6,2017,Costa Coffee,Eating Out,2,7398
12,6,2017,McDonalds,Eating Out,7,7391
12,6,2017,ATM Cash Withdrawal,General,10,7381
13,6,2017,Costa Coffee,Eating Out,2,7379
13,6,2017,Greggs,Eating Out,8,7371
14,6,2017,Caffe Nero,Eating Out,2,7369
15,6,2017,BRGAS-Electricity,Bills,31,7338
15,6,2017,BRGAS-Gas,Bills,21,7317
15,6,2017,Caffe Nero,Eating Out,1,7316
16,6,2017,LBS Council Tax,Bills,35,7281
16,6,2017,Waitrose,Groceries,54,7227
16,6,2017,Wild Bean Cafe,Eating Out,2,7225
16,6,2017,Heaven Club,Eating Out,10,7215
16,6,2017,ATM Cash Withdrawal,General,10,7205
16,6,2017,Paying back Julie,,9,7196
17,6,2017,Fabric Club,Eating Out,11,7185
17,6,2017,Fabric Club,Eating Out,8,7177
17,6,2017,Fabric Club,Eating Out,7,7170
17,6,2017,Fabric Club,Eating Out,13,7157
17,6,2017,Fabric Club,Eating Out,8,7149
17,6,2017,Fabric Club,Eating Out,11,7138
17,6,2017,Pizza Express,Eating Out,24,7114
18,6,2017,Restaurant Gordon RamsayPortland Restaurant,Eating Out,32,7082
19,6,2017,South West Trains,Transport,38,7044
19,6,2017,Costa Coffee,Eating Out,2,7042
20,6,2017,VIRGIN MEDIA PYMTS,Bills,22,7020
20,6,2017,Starbucks Coffee,Eating Out,1,7019
21,6,2017,Wild Bean Cafe,Eating Out,2,7017
22,6,2017,Costa Coffee,Eating Out,2,7015
22,6,2017,Chicken Cottage,Eating Out,8,7007
22,6,2017,ATM Cash Withdrawal,General,10,6997
23,6,2017,Waitrose,Groceries,58,6939
23,6,2017,Costa Coffee,Eating Out,1,6938
24,6,2017,O2,Bills,27,6911
26,6,2017,South West Trains,Transport,25,6886
26,6,2017,Wild Bean Cafe,Eating Out,1,6885
26,6,2017,McDonalds,Eating Out,8,6877
27,6,2017,Costa Coffee,Eating Out,2,6875
27,6,2017,McDonalds,Eating Out,7,6868
28,6,2017,Starbucks Coffee,Eating Out,2,6866
29,6,2017,Costa Coffee,Eating Out,1,6865
29,6,2017,The West Cornwall Pasty Company,Eating Out,6,6859
29,6,2017,Red Shop,,7,6852
30,6,2017,Sainsburys,Groceries,49,6803
30,6,2017,Wild Bean Cafe,Eating Out,2,6801
30,6,2017,Subway,Eating Out,5,6796
30,6,2017,Ministry of Sound ClubXOYO Club,Eating Out,15,6781
30,6,2017,Ministry of Sound ClubXOYO Club,Eating Out,7,6774
30,6,2017,Ministry of Sound ClubXOYO Club,Eating Out,15,6759
30,6,2017,Ministry of Sound ClubXOYO Club,Eating Out,5,6754
30,6,2017,Restaurant Gordon RamsayPortland Restaurant,Eating Out,29,6725
1,7,2017,Rhino Sports salary,General,1600,8325
2,7,2017,Dominos Pizza,Eating Out,45,8280
2,7,2017,ATM Cash Withdrawal,General,20,8260
2,7,2017,Tool Shop,,1,8259
3,7,2017,South West Trains,Transport,31,8228
3,7,2017,Starbucks Coffee,Eating Out,1,8227
3,7,2017,Greggs,Eating Out,6,8221
5,7,2017,Caffe Nero,Eating Out,1,8220
5,7,2017,The West Cornwall Pasty Company,Eating Out,7,8213
5,7,2017,ATM Cash Withdrawal,General,10,8203
5,7,2017,Red Shop,,2,8201
6,7,2017,Wild Bean Cafe,Eating Out,2,8199
7,7,2017,Cubit and West rent,Rent,440,7759
7,7,2017,Sainsburys,Groceries,44,7715
7,7,2017,Caffe Nero,Eating Out,2,7713
7,7,2017,Greggs,Eating Out,5,7708
7,7,2017,The Grand Pub,Eating Out,10,7698
7,7,2017,Dominos Pizza,Eating Out,56,7642
7,7,2017,ATM Cash Withdrawal,General,20,7622
8,7,2017,Pizza Express,Eating Out,47,7575
9,7,2017,ATM Cash Withdrawal,General,20,7555
10,7,2017,South West Trains,Transport,31,7524
10,7,2017,Caffe Nero,Eating Out,2,7522
10,7,2017,Pret A Manger,Eating Out,6,7516
10,7,2017,ATM Cash Withdrawal,General,10,7506
10,7,2017,Paying back Julie,,6,7500
11,7,2017,Caffe Nero,Eating Out,2,7498
11,7,2017,Subway,Eating Out,8,7490
12,7,2017,Pret A Manger,Eating Out,8,7482
12,7,2017,ATM Cash Withdrawal,General,10,7472
13,7,2017,Caffe Nero,Eating Out,2,7470
13,7,2017,Pret A Manger,Eating Out,7,7463
14,7,2017,Waitrose,Groceries,61,7402
14,7,2017,Wild Bean Cafe,Eating Out,1,7401
14,7,2017,Pizza Express,Eating Out,46,7355
14,7,2017,ATM Cash Withdrawal,General,20,7335
14,7,2017,Tool Tec,,7,7328
15,7,2017,BRGAS-Electricity,Bills,19,7309
15,7,2017,BRGAS-Gas,Bills,32,7277
15,7,2017,ATM Cash Withdrawal,General,20,7257
16,7,2017,LBS Council Tax,Bills,35,7222
16,7,2017,Dominos Pizza,Eating Out,32,7190
16,7,2017,ATM Cash Withdrawal,General,20,7170
17,7,2017,South West Trains,Transport,38,7132
17,7,2017,Greggs,Eating Out,6,7126
18,7,2017,Caffe Nero,Eating Out,2,7124
18,7,2017,Greggs,Eating Out,5,7119
19,7,2017,Wild Bean Cafe,Eating Out,2,7117
20,7,2017,VIRGIN MEDIA PYMTS,Bills,24,7093
20,7,2017,Starbucks Coffee,Eating Out,1,7092
21,7,2017,Sainsburys,Groceries,81,7011
21,7,2017,Starbucks Coffee,Eating Out,1,7010
21,7,2017,Anglo restaurant,Eating Out,24,6986
22,7,2017,Tool Shop,,3,6983
23,7,2017,Dominos Pizza,Eating Out,44,6939
24,7,2017,O2,Bills,31,6908
24,7,2017,South West Trains,Transport,37,6871
24,7,2017,Caffe Nero,Eating Out,1,6870
24,7,2017,Greggs,Eating Out,6,6864
25,7,2017,Wild Bean Cafe,Eating Out,1,6863
26,7,2017,Costa Coffee,Eating Out,2,6861
26,7,2017,The West Cornwall Pasty Company,Eating Out,7,6854
26,7,2017,ATM Cash Withdrawal,General,20,6834
27,7,2017,Caffe Nero,Eating Out,2,6832
27,7,2017,Pret A Manger,Eating Out,8,6824
28,7,2017,Sainsburys,Groceries,46,6778
28,7,2017,Wild Bean Cafe,Eating Out,2,6776
28,7,2017,Greggs,Eating Out,5,6771
29,7,2017,Heaven Club,Eating Out,12,6759
29,7,2017,Heaven Club,Eating Out,13,6746
29,7,2017,Heaven Club,Eating Out,13,6733
29,7,2017,Heaven Club,Eating Out,13,6720
29,7,2017,Restaurant Gordon RamsayPortland Restaurant,Eating Out,38,6682
29,7,2017,ATM Cash Withdrawal,General,20,6662
30,7,2017,Pizza Express,Eating Out,36,6626
31,7,2017,South West Trains,Transport,37,6589
31,7,2017,Subway,Eating Out,8,6581
1,8,2017,Rhino Sports salary,General,1600,8181
1,8,2017,The West Cornwall Pasty Company,Eating Out,5,8176
2,8,2017,ATM Cash Withdrawal,General,20,8156
3,8,2017,Chicken Cottage,Eating Out,8,8148
4,8,2017,Waitrose,Groceries,39,8109
4,8,2017,Caffe Nero,Eating Out,1,8108
5,8,2017,Pizza Express,Eating Out,47,8061
6,8,2017,Scott's Restaurant,Eating Out,35,8026
7,8,2017,Cubit and West rent,Rent,440,7586
7,8,2017,South West Trains,Transport,33,7553
7,8,2017,Pret A Manger,Eating Out,7,7546
8,8,2017,Starbucks Coffee,Eating Out,2,7544
9,8,2017,Starbucks Coffee,Eating Out,1,7543
9,8,2017,Subway,Eating Out,8,7535
9,8,2017,ATM Cash Withdrawal,General,10,7525
10,8,2017,Costa Coffee,Eating Out,1,7524
10,8,2017,Greggs,Eating Out,5,7519
10,8,2017,ATM Cash Withdrawal,General,20,7499
11,8,2017,Sainsburys,Groceries,63,7436
11,8,2017,Costa Coffee,Eating Out,2,7434
11,8,2017,Scott's Restaurant,Eating Out,36,7398
11,8,2017,ATM Cash Withdrawal,General,20,7378
14,8,2017,South West Trains,Transport,36,7342
14,8,2017,Starbucks Coffee,Eating Out,2,7340
14,8,2017,Subway,Eating Out,5,7335
15,8,2017,BRGAS-Electricity,Bills,29,7306
15,8,2017,BRGAS-Gas,Bills,33,7273
15,8,2017,Wild Bean Cafe,Eating Out,2,7271
16,8,2017,LBS Council Tax,Bills,35,7236
16,8,2017,Wild Bean Cafe,Eating Out,2,7234
16,8,2017,Pret A Manger,Eating Out,7,7227
16,8,2017,ATM Cash Withdrawal,General,20,7207
16,8,2017,Red Shop,,3,7204
17,8,2017,Costa Coffee,Eating Out,2,7202
17,8,2017,Subway,Eating Out,7,7195
17,8,2017,ATM Cash Withdrawal,General,10,7185
18,8,2017,ASDA,Groceries,40,7145
18,8,2017,Wild Bean Cafe,Eating Out,2,7143
18,8,2017,Heaven Club,Eating Out,5,7138
18,8,2017,Heaven Club,Eating Out,10,7128
18,8,2017,Heaven Club,Eating Out,11,7117
18,8,2017,Heaven Club,Eating Out,9,7108
20,8,2017,VIRGIN MEDIA PYMTS,Bills,29,7079
20,8,2017,Anglo restaurant,Eating Out,46,7033
20,8,2017,ATM Cash Withdrawal,General,10,7023
21,8,2017,South West Trains,Transport,35,6988
21,8,2017,Wild Bean Cafe,Eating Out,2,6986
21,8,2017,The West Cornwall Pasty Company,Eating Out,4,6982
22,8,2017,Chicken Cottage,Eating Out,6,6976
23,8,2017,Starbucks Coffee,Eating Out,1,6975
23,8,2017,Chicken Cottage,Eating Out,6,6969
24,8,2017,O2,Bills,29,6940
24,8,2017,Wild Bean Cafe,Eating Out,2,6938
24,8,2017,The West Cornwall Pasty Company,Eating Out,8,6930
24,8,2017,Tool Tec,,9,6921
25,8,2017,Waitrose,Groceries,72,6849
25,8,2017,Wild Bean Cafe,Eating Out,2,6847
25,8,2017,ATM Cash Withdrawal,General,10,6837
25,8,2017,Tool Shop,,6,6831
26,8,2017,Restaurant Gordon RamsayPortland Restaurant,Eating Out,37,6794
27,8,2017,ATM Cash Withdrawal,General,10,6784
28,8,2017,South West Trains,Transport,26,6758
28,8,2017,Starbucks Coffee,Eating Out,2,6756
28,8,2017,ATM Cash Withdrawal,General,10,6746
29,8,2017,Caffe Nero,Eating Out,2,6744
30,8,2017,Wild Bean Cafe,Eating Out,1,6743
31,8,2017,Pret A Manger,Eating Out,6,6737
31,8,2017,Cheam Service Station,,2,6735
1,9,2017,Rhino Sports salary,General,1600,8335
1,9,2017,Waitrose,Groceries,39,8296
1,9,2017,The West Cornwall Pasty Company,Eating Out,6,8290
4,9,2017,South West Trains,Transport,26,8264
4,9,2017,Starbucks Coffee,Eating Out,2,8262
4,9,2017,McDonalds,Eating Out,8,8254
5,9,2017,Wild Bean Cafe,Eating Out,2,8252
5,9,2017,Chicken Cottage,Eating Out,6,8246
7,9,2017,Cubit and West rent,Rent,440,7806
7,9,2017,Starbucks Coffee,Eating Out,2,7804
7,9,2017,The West Cornwall Pasty Company,Eating Out,8,7796
8,9,2017,Sainsburys,Groceries,49,7747
8,9,2017,The West Cornwall Pasty Company,Eating Out,7,7740
8,9,2017,Tool Tec,,2,7738
11,9,2017,South West Trains,Transport,25,7713
11,9,2017,Starbucks Coffee,Eating Out,2,7711
12,9,2017,Wild Bean Cafe,Eating Out,2,7709
12,9,2017,Pret A Manger,Eating Out,8,7701
12,9,2017,ATM Cash Withdrawal,General,20,7681
13,9,2017,Starbucks Coffee,Eating Out,2,7679
13,9,2017,Subway,Eating Out,7,7672
13,9,2017,ATM Cash Withdrawal,General,20,7652
14,9,2017,Caffe Nero,Eating Out,1,7651
14,9,2017,Greggs,Eating Out,6,7645
15,9,2017,BRGAS-Electricity,Bills,26,7619
15,9,2017,BRGAS-Gas,Bills,20,7599
15,9,2017,Waitrose,Groceries,64,7535
15,9,2017,Starbucks Coffee,Eating Out,1,7534
15,9,2017,Subway,Eating Out,5,7529
15,9,2017,The Grand Pub,Eating Out,13,7516
15,9,2017,The Grand Pub,Eating Out,12,7504
15,9,2017,Scott's Restaurant,Eating Out,31,7473
15,9,2017,ATM Cash Withdrawal,General,10,7463
15,9,2017,Paying back James,,2,7461
16,9,2017,LBS Council Tax,Bills,35,7426
17,9,2017,Restaurant Gordon RamsayPortland Restaurant,Eating Out,31,7395
18,9,2017,South West Trains,Transport,27,7368
18,9,2017,Starbucks Coffee,Eating Out,2,7366
18,9,2017,Pret A Manger,Eating Out,5,7361
19,9,2017,Starbucks Coffee,Eating Out,2,7359
19,9,2017,McDonalds,Eating Out,6,7353
19,9,2017,ATM Cash Withdrawal,General,20,7333
20,9,2017,VIRGIN MEDIA PYMTS,Bills,21,7312
20,9,2017,Starbucks Coffee,Eating Out,2,7310
20,9,2017,Pret A Manger,Eating Out,7,7303
21,9,2017,Caffe Nero,Eating Out,1,7302
21,9,2017,McDonalds,Eating Out,5,7297
22,9,2017,Morrisons,Groceries,76,7221
22,9,2017,Wild Bean Cafe,Eating Out,2,7219
22,9,2017,Scott's Restaurant,Eating Out,57,7162
22,9,2017,ATM Cash Withdrawal,General,20,7142
24,9,2017,O2,Bills,29,7113
25,9,2017,South West Trains,Transport,29,7084
25,9,2017,Chicken Cottage,Eating Out,6,7078
26,9,2017,Wild Bean Cafe,Eating Out,2,7076
26,9,2017,Chicken Cottage,Eating Out,5,7071
27,9,2017,Costa Coffee,Eating Out,2,7069
27,9,2017,Pret A Manger,Eating Out,7,7062
28,9,2017,The West Cornwall Pasty Company,Eating Out,7,7055
28,9,2017,ATM Cash Withdrawal,General,20,7035
29,9,2017,Tescos,Groceries,40,6995
29,9,2017,Caffe Nero,Eating Out,2,6993
29,9,2017,Pret A Manger,Eating Out,5,6988
29,9,2017,ATM Cash Withdrawal,General,10,6978
30,9,2017,The Grand Pub,Eating Out,5,6973
30,9,2017,The Grand Pub,Eating Out,7,6966
30,9,2017,The Grand Pub,Eating Out,7,6959
1,10,2017,Rhino Sports salary,General,1600,8559
2,10,2017,South West Trains,Transport,36,8523
2,10,2017,Costa Coffee,Eating Out,1,8522
2,10,2017,Cheam Service Station,,2,8520
3,10,2017,McDonalds,Eating Out,6,8514
3,10,2017,ATM Cash Withdrawal,General,10,8504
4,10,2017,Wild Bean Cafe,Eating Out,2,8502
4,10,2017,McDonalds,Eating Out,4,8498
5,10,2017,Costa Coffee,Eating Out,1,8497
5,10,2017,ATM Cash Withdrawal,General,20,8477
6,10,2017,Morrisons,Groceries,41,8436
6,10,2017,Caffe Nero,Eating Out,1,8435
6,10,2017,The West Cornwall Pasty Company,Eating Out,6,8429
7,10,2017,Cubit and West rent,Rent,440,7989
7,10,2017,Restaurant Gordon RamsayPortland Restaurant,Eating Out,56,7933
9,10,2017,South West Trains,Transport,27,7906
9,10,2017,Caffe Nero,Eating Out,1,7905
9,10,2017,Chicken Cottage,Eating Out,4,7901
9,10,2017,ATM Cash Withdrawal,General,20,7881
10,10,2017,Caffe Nero,Eating Out,2,7879
10,10,2017,Greggs,Eating Out,4,7875
10,10,2017,Cheam Service Station,,5,7870
11,10,2017,Costa Coffee,Eating Out,1,7869
11,10,2017,ATM Cash Withdrawal,General,10,7859
13,10,2017,ASDA,Groceries,68,7791
13,10,2017,Starbucks Coffee,Eating Out,1,7790
13,10,2017,Fabric Club,Eating Out,13,7777
13,10,2017,Fabric Club,Eating Out,16,7761
13,10,2017,Fabric Club,Eating Out,9,7752
13,10,2017,Fabric Club,Eating Out,10,7742
13,10,2017,Fabric Club,Eating Out,15,7727
13,10,2017,Dominos Pizza,Eating Out,32,7695
15,10,2017,BRGAS-Electricity,Bills,27,7668
15,10,2017,BRGAS-Gas,Bills,36,7632
15,10,2017,Restaurant Gordon RamsayPortland Restaurant,Eating Out,26,7606
15,10,2017,ATM Cash Withdrawal,General,10,7596
16,10,2017,LBS Council Tax,Bills,35,7561
16,10,2017,South West Trains,Transport,26,7535
16,10,2017,Costa Coffee,Eating Out,2,7533
16,10,2017,McDonalds,Eating Out,6,7527
17,10,2017,Starbucks Coffee,Eating Out,2,7525
17,10,2017,ATM Cash Withdrawal,General,10,7515
17,10,2017,Tool Tec,,8,7507
18,10,2017,Costa Coffee,Eating Out,1,7506
19,10,2017,Wild Bean Cafe,Eating Out,2,7504
19,10,2017,Chicken Cottage,Eating Out,6,7498
19,10,2017,ATM Cash Withdrawal,General,10,7488
20,10,2017,VIRGIN MEDIA PYMTS,Bills,22,7466
20,10,2017,Waitrose,Groceries,57,7409
20,10,2017,Greggs,Eating Out,4,7405
20,10,2017,The Grand Pub,Eating Out,5,7400
20,10,2017,The Grand Pub,Eating Out,15,7385
20,10,2017,The Grand Pub,Eating Out,5,7380
20,10,2017,The Grand Pub,Eating Out,7,7373
20,10,2017,The Grand Pub,Eating Out,8,7365
20,10,2017,The Grand Pub,Eating Out,16,7349
21,10,2017,Pizza Express,Eating Out,26,7323
22,10,2017,ATM Cash Withdrawal,General,10,7313
22,10,2017,Tool Shop,,7,7306
23,10,2017,South West Trains,Transport,37,7269
23,10,2017,Caffe Nero,Eating Out,2,7267
23,10,2017,Greggs,Eating Out,7,7260
23,10,2017,Tool Shop,,9,7251
24,10,2017,O2,Bills,30,7221
24,10,2017,ATM Cash Withdrawal,General,10,7211
25,10,2017,Starbucks Coffee,Eating Out,2,7209
26,10,2017,Greggs,Eating Out,6,7203
26,10,2017,Tool Tec,,6,7197
27,10,2017,ASDA,Groceries,38,7159
27,10,2017,Costa Coffee,Eating Out,1,7158
27,10,2017,ATM Cash Withdrawal,General,10,7148
27,10,2017,Cheam Service Station,,1,7147
28,10,2017,Pizza Express,Eating Out,55,7092
28,10,2017,Civic Shop,,6,7086
29,10,2017,Tool Tec,,4,7082
30,10,2017,South West Trains,Transport,34,7048
30,10,2017,Starbucks Coffee,Eating Out,1,7047
30,10,2017,Pret A Manger,Eating Out,4,7043
30,10,2017,Cheam Service Station,,7,7036
31,10,2017,Costa Coffee,Eating Out,1,7035
31,10,2017,The West Cornwall Pasty Company,Eating Out,6,7029
1,11,2017,Rhino Sports salary,General,1600,8629
1,11,2017,Caffe Nero,Eating Out,2,8627
1,11,2017,Greggs,Eating Out,5,8622
2,11,2017,The West Cornwall Pasty Company,Eating Out,7,8615
3,11,2017,Sainsburys,Groceries,69,8546
3,11,2017,Starbucks Coffee,Eating Out,2,8544
3,11,2017,Greggs,Eating Out,8,8536
3,11,2017,ATM Cash Withdrawal,General,20,8516
4,11,2017,The Grand Pub,Eating Out,11,8505
4,11,2017,The Grand Pub,Eating Out,6,8499
4,11,2017,Scott's Restaurant,Eating Out,50,8449
6,11,2017,South West Trains,Transport,25,8424
6,11,2017,Chicken Cottage,Eating Out,7,8417
6,11,2017,ATM Cash Withdrawal,General,10,8407
7,11,2017,Cubit and West rent,Rent,440,7967
7,11,2017,Starbucks Coffee,Eating Out,2,7965
7,11,2017,ATM Cash Withdrawal,General,10,7955
8,11,2017,Caffe Nero,Eating Out,2,7953
8,11,2017,Subway,Eating Out,4,7949
8,11,2017,Cheam Service Station,,8,7941
9,11,2017,Starbucks Coffee,Eating Out,2,7939
9,11,2017,ATM Cash Withdrawal,General,10,7929
10,11,2017,ASDA,Groceries,67,7862
10,11,2017,Costa Coffee,Eating Out,2,7860
10,11,2017,Greggs,Eating Out,8,7852
10,11,2017,Fabric Club,Eating Out,15,7837
10,11,2017,Fabric Club,Eating Out,7,7830
10,11,2017,ATM Cash Withdrawal,General,20,7810
11,11,2017,ATM Cash Withdrawal,General,20,7790
11,11,2017,Paying back Julie,,8,7782
12,11,2017,Restaurant Gordon RamsayPortland Restaurant,Eating Out,34,7748
12,11,2017,Tool Tec,,1,7747
13,11,2017,South West Trains,Transport,34,7713
13,11,2017,Subway,Eating Out,8,7705
13,11,2017,ATM Cash Withdrawal,General,10,7695
14,11,2017,Starbucks Coffee,Eating Out,1,7694
14,11,2017,McDonalds,Eating Out,8,7686
15,11,2017,BRGAS-Electricity,Bills,38,7648
15,11,2017,BRGAS-Gas,Bills,21,7627
15,11,2017,Wild Bean Cafe,Eating Out,2,7625
15,11,2017,Civic Shop,,4,7621
16,11,2017,LBS Council Tax,Bills,35,7586
16,11,2017,Caffe Nero,Eating Out,2,7584
17,11,2017,Sainsburys,Groceries,72,7512
17,11,2017,Wild Bean Cafe,Eating Out,1,7511
17,11,2017,The West Cornwall Pasty Company,Eating Out,8,7503
17,11,2017,Ministry of Sound ClubXOYO Club,Eating Out,14,7489
17,11,2017,Ministry of Sound ClubXOYO Club,Eating Out,9,7480
17,11,2017,Ministry of Sound ClubXOYO Club,Eating Out,7,7473
18,11,2017,Restaurant Gordon RamsayPortland Restaurant,Eating Out,49,7424
18,11,2017,ATM Cash Withdrawal,General,10,7414
20,11,2017,VIRGIN MEDIA PYMTS,Bills,32,7382
20,11,2017,South West Trains,Transport,27,7355
20,11,2017,Wild Bean Cafe,Eating Out,1,7354
22,11,2017,Wild Bean Cafe,Eating Out,1,7353
22,11,2017,Chicken Cottage,Eating Out,7,7346
22,11,2017,ATM Cash Withdrawal,General,10,7336
23,11,2017,Starbucks Coffee,Eating Out,1,7335
23,11,2017,Subway,Eating Out,8,7327
24,11,2017,O2,Bills,26,7301
24,11,2017,Tescos,Groceries,70,7231
24,11,2017,McDonalds,Eating Out,4,7227
25,11,2017,Anglo restaurant,Eating Out,52,7175
27,11,2017,South West Trains,Transport,31,7144
27,11,2017,Costa Coffee,Eating Out,1,7143
28,11,2017,Caffe Nero,Eating Out,1,7142
28,11,2017,ATM Cash Withdrawal,General,20,7122
29,11,2017,Costa Coffee,Eating Out,2,7120
29,11,2017,Chicken Cottage,Eating Out,8,7112
29,11,2017,Red Shop,,3,7109
30,11,2017,Starbucks Coffee,Eating Out,2,7107
30,11,2017,Pret A Manger,Eating Out,7,7100
1,12,2017,Rhino Sports salary,General,1600,8700
1,12,2017,Sainsburys,Groceries,43,8657
1,12,2017,Greggs,Eating Out,4,8653
4,12,2017,South West Trains,Transport,38,8615
4,12,2017,Wild Bean Cafe,Eating Out,1,8614
4,12,2017,The West Cornwall Pasty Company,Eating Out,8,8606
4,12,2017,Tool Tec,,5,8601
5,12,2017,Starbucks Coffee,Eating Out,2,8599
5,12,2017,ATM Cash Withdrawal,General,10,8589
6,12,2017,McDonalds,Eating Out,8,8581
7,12,2017,Cubit and West rent,Rent,440,8141
7,12,2017,Wild Bean Cafe,Eating Out,2,8139
7,12,2017,Pret A Manger,Eating Out,8,8131
8,12,2017,Morrisons,Groceries,54,8077
8,12,2017,Wild Bean Cafe,Eating Out,2,8075
8,12,2017,The West Cornwall Pasty Company,Eating Out,7,8068
8,12,2017,ATM Cash Withdrawal,General,10,8058
9,12,2017,Ministry of Sound ClubXOYO Club,Eating Out,7,8051
9,12,2017,Ministry of Sound ClubXOYO Club,Eating Out,8,8043
9,12,2017,Ministry of Sound ClubXOYO Club,Eating Out,15,8028
9,12,2017,Ministry of Sound ClubXOYO Club,Eating Out,11,8017
10,12,2017,ATM Cash Withdrawal,General,10,8007
11,12,2017,South West Trains,Transport,30,7977
11,12,2017,Wild Bean Cafe,Eating Out,2,7975
11,12,2017,ATM Cash Withdrawal,General,20,7955
12,12,2017,Wild Bean Cafe,Eating Out,1,7954
12,12,2017,Subway,Eating Out,5,7949
13,12,2017,Caffe Nero,Eating Out,2,7947
13,12,2017,Subway,Eating Out,8,7939
14,12,2017,Caffe Nero,Eating Out,1,7938
15,12,2017,BRGAS-Electricity,Bills,32,7906
15,12,2017,BRGAS-Gas,Bills,36,7870
15,12,2017,Waitrose,Groceries,42,7828
15,12,2017,Starbucks Coffee,Eating Out,2,7826
15,12,2017,Greggs,Eating Out,8,7818
15,12,2017,Dominos Pizza,Eating Out,39,7779
16,12,2017,LBS Council Tax,Bills,35,7744
16,12,2017,ATM Cash Withdrawal,General,10,7734
18,12,2017,South West Trains,Transport,33,7701
18,12,2017,Caffe Nero,Eating Out,1,7700
18,12,2017,The West Cornwall Pasty Company,Eating Out,4,7696
19,12,2017,Caffe Nero,Eating Out,2,7694
19,12,2017,Chicken Cottage,Eating Out,8,7686
20,12,2017,VIRGIN MEDIA PYMTS,Bills,36,7650
20,12,2017,Costa Coffee,Eating Out,2,7648
21,12,2017,Caffe Nero,Eating Out,2,7646
21,12,2017,ATM Cash Withdrawal,General,20,7626
22,12,2017,Sainsburys,Groceries,66,7560
22,12,2017,Starbucks Coffee,Eating Out,2,7558
24,12,2017,O2,Bills,29,7529
25,12,2017,South West Trains,Transport,35,7494
25,12,2017,Costa Coffee,Eating Out,1,7493
25,12,2017,Subway,Eating Out,8,7485
25,12,2017,ATM Cash Withdrawal,General,20,7465
26,12,2017,Starbucks Coffee,Eating Out,2,7463
26,12,2017,Chicken Cottage,Eating Out,7,7456
27,12,2017,Chicken Cottage,Eating Out,7,7449
28,12,2017,Wild Bean Cafe,Eating Out,1,7448
28,12,2017,ATM Cash Withdrawal,General,20,7428
29,12,2017,Waitrose,Groceries,39,7389
29,12,2017,Starbucks Coffee,Eating Out,2,7387
29,12,2017,Subway,Eating Out,7,7380
31,12,2017,Restaurant Gordon RamsayPortland Restaurant,Eating Out,44,7336
1,1,2018,Rhino Sports salary,General,1600,8936
1,1,2018,South West Trains,Transport,28,8908
1,1,2018,Costa Coffee,Eating Out,2,8906
1,1,2018,ATM Cash Withdrawal,General,10,8896
1,1,2018,Paying back Julie,,6,8890
2,1,2018,Chicken Cottage,Eating Out,4,8886
3,1,2018,Costa Coffee,Eating Out,1,8885
3,1,2018,Subway,Eating Out,7,8878
3,1,2018,Cheam Service Station,,1,8877
4,1,2018,Greggs,Eating Out,7,8870
4,1,2018,Civic Shop,,5,8865
5,1,2018,Waitrose,Groceries,51,8814
5,1,2018,Wild Bean Cafe,Eating Out,2,8812
5,1,2018,Subway,Eating Out,6,8806
6,1,2018,Dominos Pizza,Eating Out,56,8750
6,1,2018,Paying back James,,5,8745
7,1,2018,Cubit and West rent,Rent,440,8305
7,1,2018,Scott's Restaurant,Eating Out,32,8273
7,1,2018,ATM Cash Withdrawal,General,20,8253
8,1,2018,South West Trains,Transport,26,8227
8,1,2018,Costa Coffee,Eating Out,2,8225
8,1,2018,McDonalds,Eating Out,5,8220
9,1,2018,Costa Coffee,Eating Out,1,8219
9,1,2018,McDonalds,Eating Out,7,8212
9,1,2018,ATM Cash Withdrawal,General,10,8202
9,1,2018,Paying back James,,3,8199
11,1,2018,Wild Bean Cafe,Eating Out,1,8198
11,1,2018,ATM Cash Withdrawal,General,10,8188
12,1,2018,Morrisons,Groceries,44,8144
12,1,2018,Starbucks Coffee,Eating Out,2,8142
12,1,2018,Greggs,Eating Out,5,8137
12,1,2018,ATM Cash Withdrawal,General,10,8127
13,1,2018,Heaven Club,Eating Out,16,8111
13,1,2018,Heaven Club,Eating Out,16,8095
13,1,2018,Cheam Service Station,,8,8087
14,1,2018,Restaurant Gordon RamsayPortland Restaurant,Eating Out,38,8049
15,1,2018,BRGAS-Electricity,Bills,35,8014
15,1,2018,BRGAS-Gas,Bills,58,7956
15,1,2018,South West Trains,Transport,36,7920
15,1,2018,Costa Coffee,Eating Out,2,7918
15,1,2018,ATM Cash Withdrawal,General,10,7908
15,1,2018,Paying back James,,5,7903
16,1,2018,LBS Council Tax,Bills,35,7868
16,1,2018,Costa Coffee,Eating Out,2,7866
16,1,2018,The West Cornwall Pasty Company,Eating Out,4,7862
16,1,2018,Tool Shop,,7,7855
17,1,2018,Wild Bean Cafe,Eating Out,1,7854
17,1,2018,Subway,Eating Out,6,7848
18,1,2018,Caffe Nero,Eating Out,1,7847
18,1,2018,Greggs,Eating Out,6,7841
18,1,2018,ATM Cash Withdrawal,General,20,7821
19,1,2018,Sainsburys,Groceries,78,7743
19,1,2018,Pret A Manger,Eating Out,4,7739
20,1,2018,VIRGIN MEDIA PYMTS,Bills,40,7699
22,1,2018,South West Trains,Transport,36,7663
23,1,2018,Caffe Nero,Eating Out,2,7661
24,1,2018,O2,Bills,29,7632
24,1,2018,Caffe Nero,Eating Out,2,7630
24,1,2018,Chicken Cottage,Eating Out,4,7626
25,1,2018,Starbucks Coffee,Eating Out,2,7624
25,1,2018,Greggs,Eating Out,6,7618
26,1,2018,ASDA,Groceries,53,7565
26,1,2018,Wild Bean Cafe,Eating Out,1,7564
26,1,2018,McDonalds,Eating Out,7,7557
26,1,2018,Dominos Pizza,Eating Out,31,7526
27,1,2018,ATM Cash Withdrawal,General,10,7516
27,1,2018,Tool Shop,,1,7515
28,1,2018,Restaurant Gordon RamsayPortland Restaurant,Eating Out,24,7491
28,1,2018,Paying back Julie,,7,7484
29,1,2018,South West Trains,Transport,30,7454
29,1,2018,Caffe Nero,Eating Out,2,7452
29,1,2018,Subway,Eating Out,6,7446
29,1,2018,ATM Cash Withdrawal,General,10,7436
30,1,2018,Caffe Nero,Eating Out,1,7435
30,1,2018,Chicken Cottage,Eating Out,4,7431
31,1,2018,Starbucks Coffee,Eating Out,2,7429
1,2,2018,Rhino Sports salary,General,1600,9029
1,2,2018,Caffe Nero,Eating Out,2,9027
1,2,2018,Subway,Eating Out,5,9022
2,2,2018,Tescos,Groceries,66,8956
2,2,2018,Caffe Nero,Eating Out,1,8955
2,2,2018,Greggs,Eating Out,7,8948
4,2,2018,Pizza Express,Eating Out,46,8902
5,2,2018,South West Trains,Transport,29,8873
5,2,2018,Caffe Nero,Eating Out,1,8872
5,2,2018,The West Cornwall Pasty Company,Eating Out,4,8868
5,2,2018,ATM Cash Withdrawal,General,10,8858
5,2,2018,Tool Tec,,5,8853
6,2,2018,Caffe Nero,Eating Out,2,8851
6,2,2018,Greggs,Eating Out,8,8843
6,2,2018,ATM Cash Withdrawal,General,20,8823
7,2,2018,Cubit and West rent,Rent,440,8383
7,2,2018,Starbucks Coffee,Eating Out,1,8382
7,2,2018,Greggs,Eating Out,8,8374
8,2,2018,Costa Coffee,Eating Out,2,8372
8,2,2018,Greggs,Eating Out,8,8364
9,2,2018,Tescos,Groceries,59,8305
9,2,2018,Costa Coffee,Eating Out,1,8304
9,2,2018,Pizza Express,Eating Out,45,8259
10,2,2018,Pizza Express,Eating Out,24,8235
11,2,2018,Scott's Restaurant,Eating Out,58,8177
11,2,2018,ATM Cash Withdrawal,General,10,8167
12,2,2018,South West Trains,Transport,26,8141
12,2,2018,Subway,Eating Out,7,8134
13,2,2018,Wild Bean Cafe,Eating Out,2,8132
13,2,2018,The West Cornwall Pasty Company,Eating Out,6,8126
13,2,2018,ATM Cash Withdrawal,General,10,8116
14,2,2018,Caffe Nero,Eating Out,2,8114
14,2,2018,McDonalds,Eating Out,7,8107
14,2,2018,ATM Cash Withdrawal,General,10,8097
15,2,2018,BRGAS-Electricity,Bills,34,8063
15,2,2018,BRGAS-Gas,Bills,29,8034
15,2,2018,Starbucks Coffee,Eating Out,1,8033
15,2,2018,Chicken Cottage,Eating Out,8,8025
15,2,2018,ATM Cash Withdrawal,General,10,8015
16,2,2018,LBS Council Tax,Bills,35,7980
16,2,2018,Sainsburys,Groceries,71,7909
16,2,2018,Starbucks Coffee,Eating Out,2,7907
16,2,2018,McDonalds,Eating Out,4,7903
17,2,2018,ATM Cash Withdrawal,General,10,7893
18,2,2018,ATM Cash Withdrawal,General,10,7883
19,2,2018,South West Trains,Transport,26,7857
19,2,2018,Wild Bean Cafe,Eating Out,2,7855
19,2,2018,ATM Cash Withdrawal,General,20,7835
20,2,2018,VIRGIN MEDIA PYMTS,Bills,33,7802
20,2,2018,Caffe Nero,Eating Out,2,7800
21,2,2018,Wild Bean Cafe,Eating Out,2,7798
22,2,2018,Wild Bean Cafe,Eating Out,2,7796
23,2,2018,Sainsburys,Groceries,82,7714
23,2,2018,Starbucks Coffee,Eating Out,2,7712
23,2,2018,Subway,Eating Out,7,7705
23,2,2018,ATM Cash Withdrawal,General,20,7685
24,2,2018,O2,Bills,27,7658
25,2,2018,Restaurant Gordon RamsayPortland Restaurant,Eating Out,43,7615
26,2,2018,South West Trains,Transport,24,7591
26,2,2018,Caffe Nero,Eating Out,1,7590
26,2,2018,The West Cornwall Pasty Company,Eating Out,7,7583
26,2,2018,ATM Cash Withdrawal,General,10,7573
27,2,2018,Costa Coffee,Eating Out,2,7571
27,2,2018,Greggs,Eating Out,7,7564
28,2,2018,Pret A Manger,Eating Out,7,7557
1,3,2018,Rhino Sports salary,General,1600,9157
1,3,2018,Starbucks Coffee,Eating Out,2,9155
1,3,2018,McDonalds,Eating Out,8,9147
2,3,2018,ASDA,Groceries,49,9098
2,3,2018,Caffe Nero,Eating Out,1,9097
2,3,2018,McDonalds,Eating Out,4,9093
3,3,2018,Fabric Club,Eating Out,8,9085
3,3,2018,Fabric Club,Eating Out,11,9074
3,3,2018,Fabric Club,Eating Out,13,9061
3,3,2018,Fabric Club,Eating Out,9,9052
3,3,2018,Fabric Club,Eating Out,5,9047
3,3,2018,Pizza Express,Eating Out,30,9017
5,3,2018,South West Trains,Transport,36,8981
5,3,2018,Wild Bean Cafe,Eating Out,2,8979
6,3,2018,Caffe Nero,Eating Out,2,8977
6,3,2018,Pret A Manger,Eating Out,4,8973
6,3,2018,Tool Shop,,9,8964
7,3,2018,Cubit and West rent,Rent,440,8524
7,3,2018,Starbucks Coffee,Eating Out,2,8522
7,3,2018,The West Cornwall Pasty Company,Eating Out,7,8515
8,3,2018,McDonalds,Eating Out,5,8510
9,3,2018,ASDA,Groceries,44,8466
9,3,2018,Costa Coffee,Eating Out,2,8464
9,3,2018,ATM Cash Withdrawal,General,20,8444
11,3,2018,Paying back James,,5,8439
12,3,2018,South West Trains,Transport,38,8401
12,3,2018,Subway,Eating Out,8,8393
13,3,2018,Wild Bean Cafe,Eating Out,2,8391
13,3,2018,Chicken Cottage,Eating Out,5,8386
13,3,2018,ATM Cash Withdrawal,General,10,8376
14,3,2018,Costa Coffee,Eating Out,2,8374
14,3,2018,The West Cornwall Pasty Company,Eating Out,7,8367
15,3,2018,BRGAS-Electricity,Bills,19,8348
15,3,2018,BRGAS-Gas,Bills,19,8329
15,3,2018,Starbucks Coffee,Eating Out,2,8327
16,3,2018,LBS Council Tax,Bills,35,8292
16,3,2018,Morrisons,Groceries,59,8233
16,3,2018,Costa Coffee,Eating Out,1,8232
16,3,2018,Pret A Manger,Eating Out,7,8225
17,3,2018,Restaurant Gordon RamsayPortland Restaurant,Eating Out,59,8166
17,3,2018,Cheam Service Station,,6,8160
18,3,2018,Scott's Restaurant,Eating Out,32,8128
18,3,2018,ATM Cash Withdrawal,General,20,8108
18,3,2018,Paying back James,,4,8104
19,3,2018,South West Trains,Transport,27,8077
19,3,2018,Greggs,Eating Out,6,8071
19,3,2018,ATM Cash Withdrawal,General,10,8061
20,3,2018,VIRGIN MEDIA PYMTS,Bills,39,8022
20,3,2018,Starbucks Coffee,Eating Out,2,8020
21,3,2018,Wild Bean Cafe,Eating Out,2,8018
21,3,2018,Subway,Eating Out,8,8010
22,3,2018,Costa Coffee,Eating Out,1,8009
23,3,2018,ASDA,Groceries,62,7947
23,3,2018,Caffe Nero,Eating Out,2,7945
23,3,2018,Chicken Cottage,Eating Out,4,7941
23,3,2018,ATM Cash Withdrawal,General,10,7931
24,3,2018,O2,Bills,31,7900
24,3,2018,Cheam Service Station,,1,7899
25,3,2018,Scott's Restaurant,Eating Out,36,7863
25,3,2018,ATM Cash Withdrawal,General,10,7853
26,3,2018,South West Trains,Transport,25,7828
26,3,2018,Caffe Nero,Eating Out,1,7827
27,3,2018,Wild Bean Cafe,Eating Out,1,7826
27,3,2018,Subway,Eating Out,5,7821
27,3,2018,ATM Cash Withdrawal,General,20,7801
28,3,2018,Costa Coffee,Eating Out,2,7799
28,3,2018,The West Cornwall Pasty Company,Eating Out,7,7792
28,3,2018,Cheam Service Station,,8,7784
30,3,2018,Waitrose,Groceries,79,7705
30,3,2018,Starbucks Coffee,Eating Out,1,7704
30,3,2018,Subway,Eating Out,8,7696
30,3,2018,Restaurant Gordon RamsayPortland Restaurant,Eating Out,36,7660
1,4,2018,Rhino Sports salary,General,1600,9260
2,4,2018,South West Trains,Transport,37,9223
2,4,2018,Caffe Nero,Eating Out,2,9221
4,4,2018,Caffe Nero,Eating Out,2,9219
5,4,2018,ATM Cash Withdrawal,General,20,9199
6,4,2018,Waitrose,Groceries,78,9121
6,4,2018,Wild Bean Cafe,Eating Out,2,9119
6,4,2018,McDonalds,Eating Out,7,9112
7,4,2018,Cubit and West rent,Rent,440,8672
7,4,2018,ATM Cash Withdrawal,General,20,8652
8,4,2018,Scott's Restaurant,Eating Out,59,8593
9,4,2018,South West Trains,Transport,24,8569
10,4,2018,Starbucks Coffee,Eating Out,1,8568
11,4,2018,Wild Bean Cafe,Eating Out,2,8566
11,4,2018,McDonalds,Eating Out,6,8560
12,4,2018,Caffe Nero,Eating Out,1,8559
12,4,2018,Chicken Cottage,Eating Out,4,8555
12,4,2018,ATM Cash Withdrawal,General,20,8535
12,4,2018,Tool Tec,,1,8534
13,4,2018,Morrisons,Groceries,61,8473
13,4,2018,Caffe Nero,Eating Out,2,8471
13,4,2018,Pret A Manger,Eating Out,7,8464
13,4,2018,Scott's Restaurant,Eating Out,32,8432
14,4,2018,Restaurant Gordon RamsayPortland Restaurant,Eating Out,46,8386
14,4,2018,ATM Cash Withdrawal,General,20,8366
15,4,2018,BRGAS-Electricity,Bills,27,8339
15,4,2018,BRGAS-Gas,Bills,35,8304
15,4,2018,Restaurant Gordon RamsayPortland Restaurant,Eating Out,27,8277
16,4,2018,LBS Council Tax,Bills,35,8242
16,4,2018,South West Trains,Transport,37,8205
16,4,2018,Costa Coffee,Eating Out,2,8203
17,4,2018,Starbucks Coffee,Eating Out,1,8202
17,4,2018,McDonalds,Eating Out,7,8195
18,4,2018,Caffe Nero,Eating Out,2,8193
18,4,2018,Chicken Cottage,Eating Out,4,8189
19,4,2018,Costa Coffee,Eating Out,1,8188
20,4,2018,VIRGIN MEDIA PYMTS,Bills,40,8148
20,4,2018,Sainsburys,Groceries,64,8084
20,4,2018,Costa Coffee,Eating Out,1,8083
21,4,2018,Red Shop,,8,8075
