Day,Month,Year,Description,Category,Value,Balance
1,1,2010,Rhino Sports salary,General,1700,1700
1,1,2010,ASDA,Groceries,80,1620
1,1,2010,Caffe Nero,Eating Out,2,1618
1,1,2010,Greggs,Eating Out,7,1611
2,1,2010,Dominos Pizza,Eating Out,54,1557
4,1,2010,South West Trains,Transport,31,1526
5,1,2010,Wild Bean Cafe,Eating Out,1,1525
5,1,2010,The West Cornwall Pasty Company,Eating Out,6,1519
6,1,2010,Costa Coffee,Eating Out,2,1517
6,1,2010,McDonalds,Eating Out,5,1512
7,1,2010,Cubit and West rent,Rent,550,962
7,1,2010,Caffe Nero,Eating Out,2,960
7,1,2010,The West Cornwall Pasty Company,Eating Out,6,954
7,1,2010,ATM Cash Withdrawal,General,20,934
8,1,2010,Morrisons,Groceries,81,853
8,1,2010,Costa Coffee,Eating Out,2,851
8,1,2010,The West Cornwall Pasty Company,Eating Out,7,844
8,1,2010,Dominos Pizza,Eating Out,55,789
8,1,2010,Cheam Service Station,,7,782
9,1,2010,Paying back James,,2,780
11,1,2010,South West Trains,Transport,35,745
11,1,2010,Caffe Nero,Eating Out,1,744
11,1,2010,Pret A Manger,Eating Out,5,739
12,1,2010,Starbucks Coffee,Eating Out,2,737
12,1,2010,Greggs,Eating Out,8,729
13,1,2010,Wild Bean Cafe,Eating Out,2,727
13,1,2010,McDonalds,Eating Out,4,723
13,1,2010,ATM Cash Withdrawal,General,10,713
14,1,2010,Caffe Nero,Eating Out,2,711
14,1,2010,ATM Cash Withdrawal,General,10,701
14,1,2010,Paying back James,,1,700
15,1,2010,BRGAS-Electricity,Bills,40,660
15,1,2010,BRGAS-Gas,Bills,52,608
15,1,2010,Tescos,Groceries,61,547
15,1,2010,Costa Coffee,Eating Out,2,545
15,1,2010,McDonalds,Eating Out,6,539
16,1,2010,LBS Council Tax,Bills,50,489
16,1,2010,Anglo restaurant,Eating Out,27,462
17,1,2010,Paying back James,,9,453
18,1,2010,South West Trains,Transport,30,423
18,1,2010,Caffe Nero,Eating Out,1,422
18,1,2010,ATM Cash Withdrawal,General,10,412
19,1,2010,Wild Bean Cafe,Eating Out,2,410
19,1,2010,ATM Cash Withdrawal,General,10,400
20,1,2010,VIRGIN MEDIA PYMTS,Bills,46,354
20,1,2010,Pret A Manger,Eating Out,4,350
20,1,2010,ATM Cash Withdrawal,General,10,340
21,1,2010,Wild Bean Cafe,Eating Out,2,338
21,1,2010,McDonalds,Eating Out,7,331
22,1,2010,Sainsburys,Groceries,42,289
22,1,2010,Starbucks Coffee,Eating Out,2,287
22,1,2010,Chicken Cottage,Eating Out,6,281
22,1,2010,ATM Cash Withdrawal,General,10,271
23,1,2010,Heaven Club,Eating Out,11,260
23,1,2010,Heaven Club,Eating Out,9,251
23,1,2010,Heaven Club,Eating Out,5,246
23,1,2010,Anglo restaurant,Eating Out,42,204
24,1,2010,O2,Bills,31,173
24,1,2010,Red Shop,,2,171
25,1,2010,South West Trains,Transport,24,147
25,1,2010,Caffe Nero,Eating Out,2,145
25,1,2010,Greggs,Eating Out,7,138
25,1,2010,ATM Cash Withdrawal,General,10,128
27,1,2010,Wild Bean Cafe,Eating Out,2,126
27,1,2010,The West Cornwall Pasty Company,Eating Out,7,119
28,1,2010,Wild Bean Cafe,Eating Out,1,118
28,1,2010,Greggs,Eating Out,5,113
29,1,2010,Waitrose,Groceries,47,66
29,1,2010,Costa Coffee,Eating Out,2,64
29,1,2010,The West Cornwall Pasty Company,Eating Out,8,56
29,1,2010,Anglo restaurant,Eating Out,29,27
29,1,2010,ATM Cash Withdrawal,General,10,17
30,1,2010,Restaurant Gordon RamsayPortland Restaurant,Eating Out,33,-16
30,1,2010,Cheam Service Station,,4,-20
1,2,2010,Rhino Sports salary,General,1700,1680
1,2,2010,South West Trains,Transport,25,1655
1,2,2010,ATM Cash Withdrawal,General,20,1635
2,2,2010,Costa Coffee,Eating Out,2,1633
3,2,2010,Costa Coffee,Eating Out,2,1631
3,2,2010,Chicken Cottage,Eating Out,6,1625
4,2,2010,Caffe Nero,Eating Out,1,1624
4,2,2010,The West Cornwall Pasty Company,Eating Out,6,1618
5,2,2010,Sainsburys,Groceries,75,1543
5,2,2010,Caffe Nero,Eating Out,1,1542
5,2,2010,McDonalds,Eating Out,4,1538
7,2,2010,Cubit and West rent,Rent,550,988
8,2,2010,South West Trains,Transport,24,964
8,2,2010,Caffe Nero,Eating Out,2,962
8,2,2010,Greggs,Eating Out,5,957
8,2,2010,ATM Cash Withdrawal,General,20,937
9,2,2010,Costa Coffee,Eating Out,1,936
10,2,2010,Costa Coffee,Eating Out,1,935
10,2,2010,ATM Cash Withdrawal,General,10,925
11,2,2010,Starbucks Coffee,Eating Out,1,924
11,2,2010,Greggs,Eating Out,5,919
12,2,2010,Morrisons,Groceries,65,854
12,2,2010,Caffe Nero,Eating Out,2,852
12,2,2010,McDonalds,Eating Out,8,844
12,2,2010,The Grand Pub,Eating Out,14,830
12,2,2010,The Grand Pub,Eating Out,7,823
12,2,2010,Pizza Express,Eating Out,26,797
12,2,2010,Tool Shop,,6,791
14,2,2010,Dominos Pizza,Eating Out,40,751
14,2,2010,Tool Shop,,6,745
15,2,2010,BRGAS-Electricity,Bills,29,716
15,2,2010,BRGAS-Gas,Bills,30,686
15,2,2010,South West Trains,Transport,36,650
15,2,2010,Wild Bean Cafe,Eating Out,1,649
15,2,2010,Greggs,Eating Out,4,645
16,2,2010,LBS Council Tax,Bills,50,595
16,2,2010,Costa Coffee,Eating Out,1,594
16,2,2010,Greggs,Eating Out,7,587
18,2,2010,Wild Bean Cafe,Eating Out,1,586
18,2,2010,McDonalds,Eating Out,5,581
19,2,2010,Waitrose,Groceries,75,506
19,2,2010,Starbucks Coffee,Eating Out,2,504
19,2,2010,Greggs,Eating Out,6,498
20,2,2010,VIRGIN MEDIA PYMTS,Bills,45,453
21,2,2010,Pizza Express,Eating Out,51,402
21,2,2010,Civic Shop,,4,398
22,2,2010,South West Trains,Transport,27,371
22,2,2010,Wild Bean Cafe,Eating Out,1,370
22,2,2010,The West Cornwall Pasty Company,Eating Out,4,366
23,2,2010,Subway,Eating Out,7,359
23,2,2010,ATM Cash Withdrawal,General,10,349
24,2,2010,O2,Bills,36,313
24,2,2010,Caffe Nero,Eating Out,1,312
24,2,2010,Greggs,Eating Out,8,304
25,2,2010,Costa Coffee,Eating Out,2,302
25,2,2010,Greggs,Eating Out,8,294
26,2,2010,Sainsburys,Groceries,58,236
26,2,2010,The West Cornwall Pasty Company,Eating Out,4,232
27,2,2010,ATM Cash Withdrawal,General,10,222
28,2,2010,Pizza Express,Eating Out,48,174
1,3,2010,Rhino Sports salary,General,1700,1874
1,3,2010,South West Trains,Transport,38,1836
1,3,2010,Caffe Nero,Eating Out,2,1834
1,3,2010,Greggs,Eating Out,7,1827
2,3,2010,Costa Coffee,Eating Out,2,1825
2,3,2010,The West Cornwall Pasty Company,Eating Out,4,1821
2,3,2010,ATM Cash Withdrawal,General,20,1801
3,3,2010,Costa Coffee,Eating Out,2,1799
3,3,2010,Pret A Manger,Eating Out,5,1794
4,3,2010,Caffe Nero,Eating Out,1,1793
5,3,2010,ASDA,Groceries,74,1719
5,3,2010,Starbucks Coffee,Eating Out,1,1718
5,3,2010,Ministry of Sound ClubXOYO Club,Eating Out,15,1703
5,3,2010,Ministry of Sound ClubXOYO Club,Eating Out,8,1695
5,3,2010,Ministry of Sound ClubXOYO Club,Eating Out,5,1690
5,3,2010,Ministry of Sound ClubXOYO Club,Eating Out,5,1685
6,3,2010,ATM Cash Withdrawal,General,20,1665
7,3,2010,Cubit and West rent,Rent,550,1115
7,3,2010,ATM Cash Withdrawal,General,10,1105
8,3,2010,South West Trains,Transport,37,1068
8,3,2010,Wild Bean Cafe,Eating Out,1,1067
9,3,2010,Costa Coffee,Eating Out,2,1065
9,3,2010,The West Cornwall Pasty Company,Eating Out,5,1060
10,3,2010,Wild Bean Cafe,Eating Out,1,1059
10,3,2010,Greggs,Eating Out,7,1052
11,3,2010,Wild Bean Cafe,Eating Out,2,1050
11,3,2010,McDonalds,Eating Out,7,1043
12,3,2010,Tescos,Groceries,57,986
12,3,2010,Caffe Nero,Eating Out,1,985
12,3,2010,McDonalds,Eating Out,5,980
12,3,2010,Heaven Club,Eating Out,10,970
13,3,2010,ATM Cash Withdrawal,General,20,950
14,3,2010,Anglo restaurant,Eating Out,44,906
14,3,2010,ATM Cash Withdrawal,General,10,896
15,3,2010,BRGAS-Electricity,Bills,35,861
15,3,2010,BRGAS-Gas,Bills,39,822
15,3,2010,South West Trains,Transport,36,786
15,3,2010,Caffe Nero,Eating Out,2,784
16,3,2010,LBS Council Tax,Bills,50,734
16,3,2010,Caffe Nero,Eating Out,1,733
16,3,2010,ATM Cash Withdrawal,General,10,723
17,3,2010,Caffe Nero,Eating Out,2,721
17,3,2010,Greggs,Eating Out,6,715
18,3,2010,Starbucks Coffee,Eating Out,2,713
19,3,2010,Sainsburys,Groceries,63,650
19,3,2010,Caffe Nero,Eating Out,1,649
19,3,2010,Greggs,Eating Out,8,641
19,3,2010,Fabric Club,Eating Out,7,634
19,3,2010,Fabric Club,Eating Out,9,625
19,3,2010,Fabric Club,Eating Out,16,609
19,3,2010,Dominos Pizza,Eating Out,47,562
19,3,2010,ATM Cash Withdrawal,General,20,542
20,3,2010,VIRGIN MEDIA PYMTS,Bills,29,513
21,3,2010,ATM Cash Withdrawal,General,20,493
22,3,2010,South West Trains,Transport,35,458
22,3,2010,Starbucks Coffee,Eating Out,2,456
22,3,2010,ATM Cash Withdrawal,General,10,446
23,3,2010,Starbucks Coffee,Eating Out,2,444
23,3,2010,ATM Cash Withdrawal,General,20,424
24,3,2010,O2,Bills,30,394
24,3,2010,Greggs,Eating Out,6,388
24,3,2010,ATM Cash Withdrawal,General,20,368
26,3,2010,Sainsburys,Groceries,65,303
26,3,2010,McDonalds,Eating Out,5,298
28,3,2010,Pizza Express,Eating Out,31,267
29,3,2010,South West Trains,Transport,29,238
29,3,2010,Wild Bean Cafe,Eating Out,1,237
29,3,2010,The West Cornwall Pasty Company,Eating Out,8,229
29,3,2010,ATM Cash Withdrawal,General,10,219
29,3,2010,Tool Shop,,3,216
30,3,2010,Caffe Nero,Eating Out,2,214
1,4,2010,Rhino Sports salary,General,1700,1914
1,4,2010,Caffe Nero,Eating Out,2,1912
1,4,2010,Subway,Eating Out,4,1908
1,4,2010,Tool Shop,,7,1901
2,4,2010,Sainsburys,Groceries,74,1827
2,4,2010,Costa Coffee,Eating Out,1,1826
2,4,2010,Greggs,Eating Out,6,1820
2,4,2010,ATM Cash Withdrawal,General,10,1810
3,4,2010,Pizza Express,Eating Out,51,1759
4,4,2010,Anglo restaurant,Eating Out,40,1719
4,4,2010,ATM Cash Withdrawal,General,20,1699
5,4,2010,South West Trains,Transport,26,1673
5,4,2010,McDonalds,Eating Out,4,1669
5,4,2010,ATM Cash Withdrawal,General,20,1649
6,4,2010,Costa Coffee,Eating Out,2,1647
7,4,2010,Cubit and West rent,Rent,550,1097
7,4,2010,Starbucks Coffee,Eating Out,2,1095
7,4,2010,The West Cornwall Pasty Company,Eating Out,7,1088
8,4,2010,Caffe Nero,Eating Out,1,1087
8,4,2010,Subway,Eating Out,7,1080
9,4,2010,Waitrose,Groceries,43,1037
9,4,2010,Wild Bean Cafe,Eating Out,1,1036
9,4,2010,ATM Cash Withdrawal,General,10,1026
10,4,2010,ATM Cash Withdrawal,General,10,1016
10,4,2010,Paying back James,,6,1010
12,4,2010,South West Trains,Transport,27,983
12,4,2010,Caffe Nero,Eating Out,2,981
12,4,2010,McDonalds,Eating Out,7,974
13,4,2010,Starbucks Coffee,Eating Out,2,972
14,4,2010,Wild Bean Cafe,Eating Out,2,970
14,4,2010,Pret A Manger,Eating Out,6,964
15,4,2010,BRGAS-Electricity,Bills,42,922
15,4,2010,BRGAS-Gas,Bills,30,892
15,4,2010,Costa Coffee,Eating Out,1,891
15,4,2010,Chicken Cottage,Eating Out,4,887
16,4,2010,LBS Council Tax,Bills,50,837
16,4,2010,Waitrose,Groceries,71,766
16,4,2010,Starbucks Coffee,Eating Out,2,764
17,4,2010,Anglo restaurant,Eating Out,38,726
19,4,2010,South West Trains,Transport,25,701
19,4,2010,Starbucks Coffee,Eating Out,2,699
19,4,2010,ATM Cash Withdrawal,General,20,679
20,4,2010,VIRGIN MEDIA PYMTS,Bills,49,630
20,4,2010,Wild Bean Cafe,Eating Out,1,629
20,4,2010,Chicken Cottage,Eating Out,8,621
21,4,2010,Caffe Nero,Eating Out,1,620
21,4,2010,McDonalds,Eating Out,4,616
22,4,2010,Starbucks Coffee,Eating Out,1,615
22,4,2010,McDonalds,Eating Out,6,609
22,4,2010,ATM Cash Withdrawal,General,20,589
23,4,2010,Waitrose,Groceries,62,527
23,4,2010,Wild Bean Cafe,Eating Out,1,526
24,4,2010,O2,Bills,36,490
24,4,2010,Restaurant Gordon RamsayPortland Restaurant,Eating Out,48,442
24,4,2010,ATM Cash Withdrawal,General,20,422
26,4,2010,South West Trains,Transport,36,386
26,4,2010,Costa Coffee,Eating Out,2,384
26,4,2010,McDonalds,Eating Out,8,376
26,4,2010,ATM Cash Withdrawal,General,10,366
27,4,2010,Chicken Cottage,Eating Out,4,362
28,4,2010,Caffe Nero,Eating Out,2,360
29,4,2010,Costa Coffee,Eating Out,2,358
29,4,2010,ATM Cash Withdrawal,General,20,338
30,4,2010,Sainsburys,Groceries,68,270
30,4,2010,Costa Coffee,Eating Out,1,269
30,4,2010,Greggs,Eating Out,5,264
30,4,2010,Dominos Pizza,Eating Out,50,214
1,5,2010,Rhino Sports salary,General,1700,1914
1,5,2010,ATM Cash Withdrawal,General,10,1904
2,5,2010,ATM Cash Withdrawal,General,10,1894
3,5,2010,South West Trains,Transport,26,1868
3,5,2010,Caffe Nero,Eating Out,2,1866
3,5,2010,McDonalds,Eating Out,8,1858
4,5,2010,ATM Cash Withdrawal,General,10,1848
5,5,2010,Starbucks Coffee,Eating Out,2,1846
7,5,2010,Cubit and West rent,Rent,550,1296
7,5,2010,Tescos,Groceries,75,1221
7,5,2010,Costa Coffee,Eating Out,1,1220
7,5,2010,The West Cornwall Pasty Company,Eating Out,5,1215
8,5,2010,Anglo restaurant,Eating Out,46,1169
8,5,2010,ATM Cash Withdrawal,General,10,1159
9,5,2010,Pizza Express,Eating Out,26,1133
10,5,2010,South West Trains,Transport,34,1099
10,5,2010,Costa Coffee,Eating Out,2,1097
10,5,2010,Greggs,Eating Out,6,1091
11,5,2010,Costa Coffee,Eating Out,1,1090
11,5,2010,Pret A Manger,Eating Out,7,1083
12,5,2010,Caffe Nero,Eating Out,1,1082
12,5,2010,ATM Cash Withdrawal,General,20,1062
12,5,2010,Tool Tec,,4,1058
13,5,2010,Caffe Nero,Eating Out,1,1057
13,5,2010,ATM Cash Withdrawal,General,10,1047
14,5,2010,Sainsburys,Groceries,78,969
15,5,2010,BRGAS-Electricity,Bills,28,941
15,5,2010,BRGAS-Gas,Bills,37,904
15,5,2010,ATM Cash Withdrawal,General,10,894
15,5,2010,Cheam Service Station,,4,890
16,5,2010,LBS Council Tax,Bills,50,840
17,5,2010,South West Trains,Transport,24,816
17,5,2010,Starbucks Coffee,Eating Out,2,814
18,5,2010,Wild Bean Cafe,Eating Out,1,813
18,5,2010,Pret A Manger,Eating Out,8,805
19,5,2010,Wild Bean Cafe,Eating Out,2,803
19,5,2010,Pret A Manger,Eating Out,4,799
20,5,2010,VIRGIN MEDIA PYMTS,Bills,47,752
21,5,2010,Morrisons,Groceries,48,704
21,5,2010,Starbucks Coffee,Eating Out,2,702
21,5,2010,Pizza Express,Eating Out,29,673
23,5,2010,ATM Cash Withdrawal,General,10,663
24,5,2010,O2,Bills,35,628
24,5,2010,South West Trains,Transport,28,600
24,5,2010,The West Cornwall Pasty Company,Eating Out,7,593
25,5,2010,Wild Bean Cafe,Eating Out,2,591
25,5,2010,The West Cornwall Pasty Company,Eating Out,5,586
26,5,2010,Costa Coffee,Eating Out,2,584
26,5,2010,Pret A Manger,Eating Out,4,580
27,5,2010,Caffe Nero,Eating Out,1,579
27,5,2010,The West Cornwall Pasty Company,Eating Out,8,571
28,5,2010,Waitrose,Groceries,82,489
28,5,2010,Costa Coffee,Eating Out,1,488
28,5,2010,Cheam Service Station,,9,479
31,5,2010,South West Trains,Transport,31,448
1,6,2010,Rhino Sports salary,General,1700,2148
1,6,2010,Caffe Nero,Eating Out,2,2146
1,6,2010,Subway,Eating Out,6,2140
2,6,2010,Caffe Nero,Eating Out,2,2138
2,6,2010,McDonalds,Eating Out,6,2132
2,6,2010,ATM Cash Withdrawal,General,10,2122
3,6,2010,Costa Coffee,Eating Out,1,2121
3,6,2010,Pret A Manger,Eating Out,6,2115
4,6,2010,Waitrose,Groceries,74,2041
4,6,2010,Wild Bean Cafe,Eating Out,2,2039
4,6,2010,Greggs,Eating Out,8,2031
4,6,2010,Dominos Pizza,Eating Out,34,1997
7,6,2010,Cubit and West rent,Rent,550,1447
7,6,2010,South West Trains,Transport,24,1423
7,6,2010,Starbucks Coffee,Eating Out,2,1421
7,6,2010,Pret A Manger,Eating Out,6,1415
8,6,2010,Costa Coffee,Eating Out,1,1414
8,6,2010,Pret A Manger,Eating Out,8,1406
9,6,2010,Wild Bean Cafe,Eating Out,2,1404
9,6,2010,The West Cornwall Pasty Company,Eating Out,6,1398
9,6,2010,ATM Cash Withdrawal,General,10,1388
10,6,2010,McDonalds,Eating Out,7,1381
10,6,2010,Tool Shop,,1,1380
11,6,2010,Sainsburys,Groceries,58,1322
11,6,2010,Costa Coffee,Eating Out,1,1321
11,6,2010,Pret A Manger,Eating Out,6,1315
11,6,2010,Ministry of Sound ClubXOYO Club,Eating Out,16,1299
11,6,2010,Ministry of Sound ClubXOYO Club,Eating Out,16,1283
11,6,2010,Ministry of Sound ClubXOYO Club,Eating Out,12,1271
11,6,2010,Ministry of Sound ClubXOYO Club,Eating Out,10,1261
12,6,2010,Ministry of Sound ClubXOYO Club,Eating Out,15,1246
12,6,2010,Ministry of Sound ClubXOYO Club,Eating Out,7,1239
12,6,2010,Ministry of Sound ClubXOYO Club,Eating Out,5,1234
12,6,2010,Ministry of Sound ClubXOYO Club,Eating Out,7,1227
12,6,2010,Ministry of Sound ClubXOYO Club,Eating Out,16,1211
12,6,2010,Ministry of Sound ClubXOYO Club,Eating Out,16,1195
12,6,2010,Pizza Express,Eating Out,41,1154
12,6,2010,ATM Cash Withdrawal,General,10,1144
14,6,2010,South West Trains,Transport,28,1116
14,6,2010,Wild Bean Cafe,Eating Out,2,1114
14,6,2010,Pret A Manger,Eating Out,4,1110
14,6,2010,Paying back James,,6,1104
15,6,2010,BRGAS-Electricity,Bills,21,1083
15,6,2010,BRGAS-Gas,Bills,41,1042
15,6,2010,Starbucks Coffee,Eating Out,1,1041
15,6,2010,ATM Cash Withdrawal,General,20,1021
16,6,2010,LBS Council Tax,Bills,50,971
16,6,2010,Starbucks Coffee,Eating Out,1,970
16,6,2010,Civic Shop,,2,968
17,6,2010,Caffe Nero,Eating Out,2,966
18,6,2010,Morrisons,Groceries,56,910
18,6,2010,Pret A Manger,Eating Out,8,902
19,6,2010,Restaurant Gordon RamsayPortland Restaurant,Eating Out,45,857
20,6,2010,VIRGIN MEDIA PYMTS,Bills,43,814
21,6,2010,South West Trains,Transport,37,777
21,6,2010,Caffe Nero,Eating Out,2,775
22,6,2010,Caffe Nero,Eating Out,2,773
23,6,2010,Caffe Nero,Eating Out,2,771
23,6,2010,The West Cornwall Pasty Company,Eating Out,6,765
23,6,2010,ATM Cash Withdrawal,General,20,745
23,6,2010,Tool Shop,,2,743
24,6,2010,O2,Bills,33,710
24,6,2010,Starbucks Coffee,Eating Out,1,709
24,6,2010,Chicken Cottage,Eating Out,6,703
25,6,2010,Tescos,Groceries,78,625
25,6,2010,Wild Bean Cafe,Eating Out,2,623
25,6,2010,The West Cornwall Pasty Company,Eating Out,7,616
25,6,2010,Restaurant Gordon RamsayPortland Restaurant,Eating Out,29,587
25,6,2010,Cheam Service Station,,2,585
26,6,2010,Dominos Pizza,Eating Out,42,543
28,6,2010,South West Trains,Transport,28,515
29,6,2010,Greggs,Eating Out,5,510
30,6,2010,Costa Coffee,Eating Out,2,508
1,7,2010,Rhino Sports salary,General,1700,2208
1,7,2010,Wild Bean Cafe,Eating Out,2,2206
1,7,2010,The West Cornwall Pasty Company,Eating Out,8,2198
2,7,2010,Waitrose,Groceries,66,2132
2,7,2010,Caffe Nero,Eating Out,2,2130
2,7,2010,Pret A Manger,Eating Out,8,2122
2,7,2010,Dominos Pizza,Eating Out,40,2082
3,7,2010,Pizza Express,Eating Out,53,2029
5,7,2010,South West Trains,Transport,27,2002
5,7,2010,Wild Bean Cafe,Eating Out,2,2000
5,7,2010,Chicken Cottage,Eating Out,6,1994
6,7,2010,Starbucks Coffee,Eating Out,2,1992
6,7,2010,The West Cornwall Pasty Company,Eating Out,8,1984
6,7,2010,ATM Cash Withdrawal,General,10,1974
6,7,2010,Tool Shop,,7,1967
7,7,2010,Cubit and West rent,Rent,550,1417
7,7,2010,Caffe Nero,Eating Out,2,1415
7,7,2010,McDonalds,Eating Out,4,1411
8,7,2010,Costa Coffee,Eating Out,1,1410
8,7,2010,Civic Shop,,5,1405
9,7,2010,Tescos,Groceries,54,1351
9,7,2010,Wild Bean Cafe,Eating Out,2,1349
9,7,2010,The West Cornwall Pasty Company,Eating Out,7,1342
9,7,2010,The Grand Pub,Eating Out,13,1329
9,7,2010,The Grand Pub,Eating Out,7,1322
9,7,2010,The Grand Pub,Eating Out,10,1312
9,7,2010,The Grand Pub,Eating Out,12,1300
9,7,2010,Restaurant Gordon RamsayPortland Restaurant,Eating Out,30,1270
10,7,2010,Heaven Club,Eating Out,8,1262
10,7,2010,Heaven Club,Eating Out,7,1255
10,7,2010,Heaven Club,Eating Out,14,1241
11,7,2010,ATM Cash Withdrawal,General,10,1231
11,7,2010,British Airways,General,118,1113
12,7,2010,South West Trains,Transport,37,1076
13,7,2010,Starbucks Coffee,Eating Out,1,1075
14,7,2010,ATM Cash Withdrawal,General,10,1065
15,7,2010,BRGAS-Electricity,Bills,23,1042
15,7,2010,BRGAS-Gas,Bills,44,998
15,7,2010,Pret A Manger,Eating Out,5,993
16,7,2010,LBS Council Tax,Bills,50,943
16,7,2010,ASDA,Groceries,68,875
16,7,2010,Starbucks Coffee,Eating Out,2,873
16,7,2010,ATM Cash Withdrawal,General,20,853
16,7,2010,Cheam Service Station,,5,848
17,7,2010,Scott's Restaurant,Eating Out,30,818
17,7,2010,ATM Cash Withdrawal,General,20,798
18,7,2010,Pizza Express,Eating Out,29,769
19,7,2010,South West Trains,Transport,33,736
19,7,2010,Wild Bean Cafe,Eating Out,1,735
19,7,2010,Subway,Eating Out,7,728
19,7,2010,ATM Cash Withdrawal,General,10,718
20,7,2010,VIRGIN MEDIA PYMTS,Bills,55,663
20,7,2010,Caffe Nero,Eating Out,1,662
20,7,2010,ATM Cash Withdrawal,General,10,652
21,7,2010,Wild Bean Cafe,Eating Out,2,650
22,7,2010,Costa Coffee,Eating Out,1,649
23,7,2010,Sainsburys,Groceries,63,586
23,7,2010,ATM Cash Withdrawal,General,20,566
23,7,2010,Paying back Julie,,6,560
24,7,2010,O2,Bills,36,524
24,7,2010,Anglo restaurant,Eating Out,47,477
24,7,2010,Paying back Julie,,6,471
25,7,2010,Dominos Pizza,Eating Out,35,436
26,7,2010,South West Trains,Transport,32,404
26,7,2010,Wild Bean Cafe,Eating Out,1,403
26,7,2010,McDonalds,Eating Out,6,397
27,7,2010,Caffe Nero,Eating Out,2,395
27,7,2010,McDonalds,Eating Out,8,387
29,7,2010,Costa Coffee,Eating Out,2,385
29,7,2010,ATM Cash Withdrawal,General,10,375
30,7,2010,Morrisons,Groceries,66,309
30,7,2010,Wild Bean Cafe,Eating Out,1,308
30,7,2010,ATM Cash Withdrawal,General,10,298
31,7,2010,Pizza Express,Eating Out,26,272
31,7,2010,ATM Cash Withdrawal,General,20,252
1,8,2010,Rhino Sports salary,General,1700,1952
2,8,2010,South West Trains,Transport,25,1927
2,8,2010,Caffe Nero,Eating Out,2,1925
3,8,2010,Costa Coffee,Eating Out,1,1924
3,8,2010,Greggs,Eating Out,6,1918
3,8,2010,ATM Cash Withdrawal,General,20,1898
4,8,2010,Chicken Cottage,Eating Out,7,1891
5,8,2010,Wild Bean Cafe,Eating Out,2,1889
5,8,2010,Pret A Manger,Eating Out,4,1885
6,8,2010,Sainsburys,Groceries,66,1819
6,8,2010,Wild Bean Cafe,Eating Out,2,1817
6,8,2010,Chicken Cottage,Eating Out,6,1811
6,8,2010,Heaven Club,Eating Out,11,1800
6,8,2010,Heaven Club,Eating Out,6,1794
6,8,2010,Heaven Club,Eating Out,5,1789
6,8,2010,Heaven Club,Eating Out,12,1777
7,8,2010,Cubit and West rent,Rent,550,1227
7,8,2010,The Grand Pub,Eating Out,7,1220
7,8,2010,The Grand Pub,Eating Out,14,1206
7,8,2010,The Grand Pub,Eating Out,13,1193
7,8,2010,The Grand Pub,Eating Out,5,1188
7,8,2010,The Grand Pub,Eating Out,7,1181
7,8,2010,The Grand Pub,Eating Out,10,1171
7,8,2010,Pizza Express,Eating Out,39,1132
7,8,2010,ATM Cash Withdrawal,General,10,1122
8,8,2010,ATM Cash Withdrawal,General,20,1102
8,8,2010,Tool Tec,,6,1096
9,8,2010,South West Trains,Transport,26,1070
9,8,2010,Subway,Eating Out,6,1064
9,8,2010,ATM Cash Withdrawal,General,10,1054
10,8,2010,The West Cornwall Pasty Company,Eating Out,6,1048
10,8,2010,ATM Cash Withdrawal,General,20,1028
11,8,2010,Caffe Nero,Eating Out,1,1027
11,8,2010,Chicken Cottage,Eating Out,8,1019
12,8,2010,The West Cornwall Pasty Company,Eating Out,7,1012
12,8,2010,ATM Cash Withdrawal,General,20,992
13,8,2010,Morrisons,Groceries,55,937
13,8,2010,Caffe Nero,Eating Out,1,936
13,8,2010,McDonalds,Eating Out,8,928
13,8,2010,Anglo restaurant,Eating Out,31,897
13,8,2010,ATM Cash Withdrawal,General,10,887
13,8,2010,Civic Shop,,3,884
15,8,2010,BRGAS-Electricity,Bills,37,847
15,8,2010,BRGAS-Gas,Bills,39,808
15,8,2010,Scott's Restaurant,Eating Out,28,780
16,8,2010,LBS Council Tax,Bills,50,730
16,8,2010,South West Trains,Transport,26,704
16,8,2010,ATM Cash Withdrawal,General,10,694
17,8,2010,Starbucks Coffee,Eating Out,2,692
17,8,2010,Chicken Cottage,Eating Out,7,685
18,8,2010,Wild Bean Cafe,Eating Out,1,684
18,8,2010,Greggs,Eating Out,5,679
18,8,2010,Paying back Julie,,7,672
19,8,2010,Chicken Cottage,Eating Out,8,664
20,8,2010,VIRGIN MEDIA PYMTS,Bills,56,608
20,8,2010,ASDA,Groceries,60,548
20,8,2010,Starbucks Coffee,Eating Out,1,547
20,8,2010,ATM Cash Withdrawal,General,10,537
21,8,2010,Dominos Pizza,Eating Out,32,505
21,8,2010,Tool Shop,,3,502
22,8,2010,ATM Cash Withdrawal,General,10,492
23,8,2010,South West Trains,Transport,24,468
23,8,2010,Costa Coffee,Eating Out,2,466
24,8,2010,O2,Bills,30,436
24,8,2010,Starbucks Coffee,Eating Out,2,434
25,8,2010,Caffe Nero,Eating Out,2,432
25,8,2010,The West Cornwall Pasty Company,Eating Out,7,425
25,8,2010,ATM Cash Withdrawal,General,10,415
26,8,2010,Caffe Nero,Eating Out,2,413
27,8,2010,Waitrose,Groceries,85,328
27,8,2010,Wild Bean Cafe,Eating Out,2,326
27,8,2010,Subway,Eating Out,7,319
28,8,2010,Restaurant Gordon RamsayPortland Restaurant,Eating Out,39,280
28,8,2010,Tool Tec,,7,273
29,8,2010,Scott's Restaurant,Eating Out,33,240
29,8,2010,ATM Cash Withdrawal,General,10,230
29,8,2010,Paying back James,,5,225
30,8,2010,South West Trains,Transport,27,198
30,8,2010,Caffe Nero,Eating Out,2,196
31,8,2010,Greggs,Eating Out,5,191
31,8,2010,Tool Shop,,5,186
1,9,2010,Rhino Sports salary,General,1700,1886
1,9,2010,Wild Bean Cafe,Eating Out,2,1884
1,9,2010,Subway,Eating Out,5,1879
2,9,2010,Caffe Nero,Eating Out,2,1877
2,9,2010,The West Cornwall Pasty Company,Eating Out,5,1872
3,9,2010,ASDA,Groceries,72,1800
3,9,2010,Caffe Nero,Eating Out,1,1799
3,9,2010,Pret A Manger,Eating Out,7,1792
5,9,2010,Pizza Express,Eating Out,35,1757
6,9,2010,South West Trains,Transport,35,1722
6,9,2010,The West Cornwall Pasty Company,Eating Out,5,1717
6,9,2010,Civic Shop,,4,1713
7,9,2010,Cubit and West rent,Rent,550,1163
7,9,2010,Starbucks Coffee,Eating Out,1,1162
7,9,2010,Chicken Cottage,Eating Out,6,1156
7,9,2010,ATM Cash Withdrawal,General,10,1146
8,9,2010,Caffe Nero,Eating Out,1,1145
8,9,2010,Subway,Eating Out,4,1141
9,9,2010,Starbucks Coffee,Eating Out,1,1140
9,9,2010,Subway,Eating Out,8,1132
10,9,2010,Morrisons,Groceries,63,1069
10,9,2010,Pret A Manger,Eating Out,6,1063
11,9,2010,Dominos Pizza,Eating Out,43,1020
12,9,2010,ATM Cash Withdrawal,General,10,1010
13,9,2010,South West Trains,Transport,26,984
13,9,2010,Costa Coffee,Eating Out,1,983
13,9,2010,Subway,Eating Out,5,978
14,9,2010,Wild Bean Cafe,Eating Out,2,976
14,9,2010,Greggs,Eating Out,6,970
15,9,2010,BRGAS-Electricity,Bills,38,932
15,9,2010,BRGAS-Gas,Bills,34,898
15,9,2010,Costa Coffee,Eating Out,1,897
15,9,2010,McDonalds,Eating Out,5,892
16,9,2010,LBS Council Tax,Bills,50,842
16,9,2010,Wild Bean Cafe,Eating Out,2,840
17,9,2010,ASDA,Groceries,76,764
17,9,2010,Wild Bean Cafe,Eating Out,2,762
17,9,2010,Greggs,Eating Out,4,758
17,9,2010,Restaurant Gordon RamsayPortland Restaurant,Eating Out,44,714
19,9,2010,Pizza Express,Eating Out,25,689
19,9,2010,Paying back James,,7,682
20,9,2010,VIRGIN MEDIA PYMTS,Bills,50,632
20,9,2010,South West Trains,Transport,24,608
20,9,2010,Starbucks Coffee,Eating Out,1,607
21,9,2010,Starbucks Coffee,Eating Out,1,606
21,9,2010,Subway,Eating Out,8,598
22,9,2010,Starbucks Coffee,Eating Out,1,597
22,9,2010,Greggs,Eating Out,8,589
23,9,2010,Starbucks Coffee,Eating Out,2,587
24,9,2010,O2,Bills,32,555
24,9,2010,Tescos,Groceries,46,509
24,9,2010,Costa Coffee,Eating Out,2,507
24,9,2010,ATM Cash Withdrawal,General,10,497
25,9,2010,ATM Cash Withdrawal,General,10,487
27,9,2010,South West Trains,Transport,34,453
27,9,2010,Caffe Nero,Eating Out,1,452
28,9,2010,Starbucks Coffee,Eating Out,2,450
28,9,2010,The West Cornwall Pasty Company,Eating Out,6,444
29,9,2010,Costa Coffee,Eating Out,1,443
29,9,2010,The West Cornwall Pasty Company,Eating Out,6,437
29,9,2010,ATM Cash Withdrawal,General,10,427
29,9,2010,Red Shop,,9,418
30,9,2010,Costa Coffee,Eating Out,2,416
30,9,2010,Greggs,Eating Out,6,410
1,10,2010,Rhino Sports salary,General,1700,2110
1,10,2010,Morrisons,Groceries,43,2067
1,10,2010,Caffe Nero,Eating Out,1,2066
1,10,2010,Restaurant Gordon RamsayPortland Restaurant,Eating Out,57,2009
4,10,2010,South West Trains,Transport,33,1976
4,10,2010,Caffe Nero,Eating Out,2,1974
4,10,2010,Subway,Eating Out,8,1966
5,10,2010,Wild Bean Cafe,Eating Out,1,1965
5,10,2010,McDonalds,Eating Out,7,1958
5,10,2010,Tool Tec,,3,1955
6,10,2010,Costa Coffee,Eating Out,1,1954
6,10,2010,Subway,Eating Out,7,1947
7,10,2010,Cubit and West rent,Rent,550,1397
7,10,2010,Caffe Nero,Eating Out,1,1396
7,10,2010,The West Cornwall Pasty Company,Eating Out,4,1392
8,10,2010,Sainsburys,Groceries,84,1308
8,10,2010,Wild Bean Cafe,Eating Out,2,1306
10,10,2010,Pizza Express,Eating Out,39,1267
11,10,2010,South West Trains,Transport,35,1232
11,10,2010,Greggs,Eating Out,7,1225
11,10,2010,ATM Cash Withdrawal,General,20,1205
12,10,2010,Wild Bean Cafe,Eating Out,2,1203
12,10,2010,The West Cornwall Pasty Company,Eating Out,8,1195
13,10,2010,Wild Bean Cafe,Eating Out,1,1194
13,10,2010,ATM Cash Withdrawal,General,20,1174
14,10,2010,Starbucks Coffee,Eating Out,2,1172
14,10,2010,Greggs,Eating Out,8,1164
14,10,2010,ATM Cash Withdrawal,General,20,1144
15,10,2010,BRGAS-Electricity,Bills,31,1113
15,10,2010,BRGAS-Gas,Bills,29,1084
15,10,2010,Tescos,Groceries,79,1005
15,10,2010,Wild Bean Cafe,Eating Out,1,1004
15,10,2010,Subway,Eating Out,5,999
15,10,2010,Pizza Express,Eating Out,57,942
15,10,2010,ATM Cash Withdrawal,General,20,922
16,10,2010,LBS Council Tax,Bills,50,872
17,10,2010,Paying back Julie,,6,866
18,10,2010,South West Trains,Transport,27,839
18,10,2010,Starbucks Coffee,Eating Out,2,837
18,10,2010,Cheam Service Station,,4,833
19,10,2010,Starbucks Coffee,Eating Out,2,831
19,10,2010,The West Cornwall Pasty Company,Eating Out,5,826
20,10,2010,VIRGIN MEDIA PYMTS,Bills,44,782
20,10,2010,Wild Bean Cafe,Eating Out,2,780
20,10,2010,Pret A Manger,Eating Out,6,774
21,10,2010,Wild Bean Cafe,Eating Out,1,773
21,10,2010,ATM Cash Withdrawal,General,20,753
22,10,2010,Sainsburys,Groceries,62,691
22,10,2010,Anglo restaurant,Eating Out,38,653
23,10,2010,Restaurant Gordon RamsayPortland Restaurant,Eating Out,28,625
24,10,2010,O2,Bills,38,587
24,10,2010,Tool Tec,,8,579
25,10,2010,South West Trains,Transport,24,555
25,10,2010,Greggs,Eating Out,6,549
26,10,2010,Caffe Nero,Eating Out,2,547
27,10,2010,Costa Coffee,Eating Out,2,545
27,10,2010,Greggs,Eating Out,7,538
28,10,2010,ATM Cash Withdrawal,General,20,518
29,10,2010,ASDA,Groceries,75,443
29,10,2010,Chicken Cottage,Eating Out,7,436
29,10,2010,Restaurant Gordon RamsayPortland Restaurant,Eating Out,57,379
31,10,2010,Anglo restaurant,Eating Out,31,348
1,11,2010,Rhino Sports salary,General,1700,2048
1,11,2010,South West Trains,Transport,29,2019
1,11,2010,Starbucks Coffee,Eating Out,2,2017
1,11,2010,The West Cornwall Pasty Company,Eating Out,7,2010
1,11,2010,Red Shop,,5,2005
2,11,2010,Starbucks Coffee,Eating Out,1,2004
2,11,2010,Pret A Manger,Eating Out,5,1999
3,11,2010,Starbucks Coffee,Eating Out,2,1997
3,11,2010,Pret A Manger,Eating Out,7,1990
4,11,2010,McDonalds,Eating Out,4,1986
4,11,2010,ATM Cash Withdrawal,General,20,1966
4,11,2010,Tool Tec,,2,1964
5,11,2010,Sainsburys,Groceries,60,1904
5,11,2010,Caffe Nero,Eating Out,2,1902
5,11,2010,The West Cornwall Pasty Company,Eating Out,7,1895
5,11,2010,Pizza Express,Eating Out,24,1871
7,11,2010,Cubit and West rent,Rent,550,1321
7,11,2010,Pizza Express,Eating Out,57,1264
7,11,2010,ATM Cash Withdrawal,General,10,1254
8,11,2010,South West Trains,Transport,27,1227
8,11,2010,Costa Coffee,Eating Out,1,1226
8,11,2010,The West Cornwall Pasty Company,Eating Out,6,1220
8,11,2010,ATM Cash Withdrawal,General,20,1200
9,11,2010,Wild Bean Cafe,Eating Out,1,1199
9,11,2010,Subway,Eating Out,5,1194
9,11,2010,Tool Shop,,4,1190
10,11,2010,Wild Bean Cafe,Eating Out,1,1189
10,11,2010,McDonalds,Eating Out,7,1182
11,11,2010,Caffe Nero,Eating Out,2,1180
12,11,2010,Sainsburys,Groceries,52,1128
12,11,2010,Starbucks Coffee,Eating Out,2,1126
12,11,2010,ATM Cash Withdrawal,General,10,1116
13,11,2010,ATM Cash Withdrawal,General,20,1096
14,11,2010,Scott's Restaurant,Eating Out,50,1046
14,11,2010,ATM Cash Withdrawal,General,20,1026
14,11,2010,Paying back Julie,,5,1021
15,11,2010,BRGAS-Electricity,Bills,55,966
15,11,2010,BRGAS-Gas,Bills,67,899
15,11,2010,South West Trains,Transport,29,870
15,11,2010,Wild Bean Cafe,Eating Out,2,868
15,11,2010,ATM Cash Withdrawal,General,20,848
16,11,2010,LBS Council Tax,Bills,50,798
16,11,2010,Wild Bean Cafe,Eating Out,1,797
16,11,2010,Greggs,Eating Out,7,790
16,11,2010,ATM Cash Withdrawal,General,20,770
17,11,2010,Starbucks Coffee,Eating Out,2,768
17,11,2010,The West Cornwall Pasty Company,Eating Out,7,761
18,11,2010,Wild Bean Cafe,Eating Out,2,759
18,11,2010,ATM Cash Withdrawal,General,20,739
19,11,2010,ASDA,Groceries,64,675
19,11,2010,Wild Bean Cafe,Eating Out,2,673
19,11,2010,Pret A Manger,Eating Out,5,668
19,11,2010,ATM Cash Withdrawal,General,10,658
20,11,2010,VIRGIN MEDIA PYMTS,Bills,56,602
20,11,2010,ATM Cash Withdrawal,General,20,582
22,11,2010,South West Trains,Transport,29,553
23,11,2010,Starbucks Coffee,Eating Out,2,551
23,11,2010,ATM Cash Withdrawal,General,20,531
24,11,2010,O2,Bills,32,499
24,11,2010,Wild Bean Cafe,Eating Out,2,497
24,11,2010,The West Cornwall Pasty Company,Eating Out,8,489
25,11,2010,Starbucks Coffee,Eating Out,2,487
26,11,2010,Sainsburys,Groceries,89,398
26,11,2010,Costa Coffee,Eating Out,1,397
26,11,2010,The Grand Pub,Eating Out,11,386
26,11,2010,The Grand Pub,Eating Out,12,374
26,11,2010,The Grand Pub,Eating Out,8,366
26,11,2010,The Grand Pub,Eating Out,7,359
26,11,2010,The Grand Pub,Eating Out,9,350
26,11,2010,The Grand Pub,Eating Out,8,342
26,11,2010,Anglo restaurant,Eating Out,56,286
26,11,2010,ATM Cash Withdrawal,General,20,266
27,11,2010,The Grand Pub,Eating Out,5,261
27,11,2010,Pizza Express,Eating Out,27,234
28,11,2010,Dominos Pizza,Eating Out,56,178
29,11,2010,South West Trains,Transport,34,144
29,11,2010,Caffe Nero,Eating Out,2,142
29,11,2010,Greggs,Eating Out,4,138
30,11,2010,Caffe Nero,Eating Out,1,137
30,11,2010,Pret A Manger,Eating Out,6,131
30,11,2010,Tool Shop,,6,125
1,12,2010,Rhino Sports salary,General,1700,1825
1,12,2010,Caffe Nero,Eating Out,1,1824
1,12,2010,Greggs,Eating Out,5,1819
2,12,2010,Starbucks Coffee,Eating Out,2,1817
2,12,2010,McDonalds,Eating Out,5,1812
2,12,2010,ATM Cash Withdrawal,General,20,1792
3,12,2010,Tescos,Groceries,71,1721
3,12,2010,Costa Coffee,Eating Out,1,1720
3,12,2010,Scott's Restaurant,Eating Out,39,1681
4,12,2010,Fabric Club,Eating Out,12,1669
4,12,2010,Dominos Pizza,Eating Out,39,1630
5,12,2010,ATM Cash Withdrawal,General,20,1610
6,12,2010,South West Trains,Transport,26,1584
6,12,2010,Costa Coffee,Eating Out,2,1582
6,12,2010,The West Cornwall Pasty Company,Eating Out,5,1577
6,12,2010,Red Shop,,4,1573
7,12,2010,Cubit and West rent,Rent,550,1023
7,12,2010,Costa Coffee,Eating Out,1,1022
7,12,2010,Subway,Eating Out,7,1015
7,12,2010,ATM Cash Withdrawal,General,20,995
8,12,2010,Greggs,Eating Out,8,987
9,12,2010,The West Cornwall Pasty Company,Eating Out,4,983
10,12,2010,ASDA,Groceries,79,904
10,12,2010,Caffe Nero,Eating Out,1,903
10,12,2010,ATM Cash Withdrawal,General,20,883
13,12,2010,South West Trains,Transport,28,855
13,12,2010,Wild Bean Cafe,Eating Out,1,854
13,12,2010,Greggs,Eating Out,8,846
14,12,2010,Costa Coffee,Eating Out,2,844
15,12,2010,BRGAS-Electricity,Bills,43,801
15,12,2010,BRGAS-Gas,Bills,38,763
15,12,2010,Wild Bean Cafe,Eating Out,1,762
15,12,2010,Greggs,Eating Out,5,757
16,12,2010,LBS Council Tax,Bills,50,707
16,12,2010,Caffe Nero,Eating Out,2,705
16,12,2010,The West Cornwall Pasty Company,Eating Out,7,698
17,12,2010,ASDA,Groceries,54,644
17,12,2010,Caffe Nero,Eating Out,2,642
17,12,2010,Subway,Eating Out,5,637
17,12,2010,Scott's Restaurant,Eating Out,25,612
17,12,2010,ATM Cash Withdrawal,General,20,592
19,12,2010,Restaurant Gordon RamsayPortland Restaurant,Eating Out,48,544
20,12,2010,VIRGIN MEDIA PYMTS,Bills,48,496
20,12,2010,South West Trains,Transport,34,462
20,12,2010,Greggs,Eating Out,6,456
21,12,2010,Subway,Eating Out,6,450
22,12,2010,Caffe Nero,Eating Out,2,448
22,12,2010,Pret A Manger,Eating Out,7,441
22,12,2010,Red Shop,,7,434
23,12,2010,ATM Cash Withdrawal,General,20,414
23,12,2010,Paying back James,,7,407
24,12,2010,O2,Bills,31,376
24,12,2010,Tescos,Groceries,47,329
24,12,2010,Caffe Nero,Eating Out,2,327
24,12,2010,Chicken Cottage,Eating Out,5,322
24,12,2010,ATM Cash Withdrawal,General,20,302
25,12,2010,ATM Cash Withdrawal,General,20,282
26,12,2010,Restaurant Gordon RamsayPortland Restaurant,Eating Out,40,242
26,12,2010,ATM Cash Withdrawal,General,20,222
27,12,2010,South West Trains,Transport,24,198
27,12,2010,Starbucks Coffee,Eating Out,2,196
27,12,2010,Chicken Cottage,Eating Out,4,192
28,12,2010,Wild Bean Cafe,Eating Out,2,190
28,12,2010,The West Cornwall Pasty Company,Eating Out,5,185
28,12,2010,ATM Cash Withdrawal,General,10,175
28,12,2010,Cheam Service Station,,1,174
29,12,2010,Caffe Nero,Eating Out,2,172
29,12,2010,Chicken Cottage,Eating Out,5,167
30,12,2010,Caffe Nero,Eating Out,2,165
30,12,2010,Chicken Cottage,Eating Out,7,158
31,12,2010,Morrisons,Groceries,87,71
31,12,2010,Wild Bean Cafe,Eating Out,1,70
31,12,2010,McDonalds,Eating Out,7,63
1,1,2011,Rhino Sports salary,General,1700,1763
2,1,2011,Pizza Express,Eating Out,50,1713
2,1,2011,Paying back James,,2,1711
3,1,2011,South West Trains,Transport,28,1683
3,1,2011,Caffe Nero,Eating Out,1,1682
3,1,2011,McDonalds,Eating Out,6,1676
4,1,2011,Starbucks Coffee,Eating Out,2,1674
4,1,2011,McDonalds,Eating Out,8,1666
5,1,2011,Caffe Nero,Eating Out,2,1664
5,1,2011,McDonalds,Eating Out,5,1659
5,1,2011,ATM Cash Withdrawal,General,10,1649
6,1,2011,ATM Cash Withdrawal,General,20,1629
7,1,2011,Cubit and West rent,Rent,550,1079
7,1,2011,Waitrose,Groceries,83,996
7,1,2011,Costa Coffee,Eating Out,2,994
7,1,2011,Pizza Express,Eating Out,45,949
9,1,2011,Dominos Pizza,Eating Out,29,920
9,1,2011,ATM Cash Withdrawal,General,10,910
9,1,2011,Tool Shop,,9,901
10,1,2011,South West Trains,Transport,37,864
10,1,2011,Starbucks Coffee,Eating Out,2,862
10,1,2011,ATM Cash Withdrawal,General,10,852
11,1,2011,Chicken Cottage,Eating Out,6,846
11,1,2011,ATM Cash Withdrawal,General,10,836
12,1,2011,Costa Coffee,Eating Out,2,834
12,1,2011,Subway,Eating Out,6,828
13,1,2011,Wild Bean Cafe,Eating Out,1,827
13,1,2011,ATM Cash Withdrawal,General,10,817
14,1,2011,Morrisons,Groceries,76,741
14,1,2011,Caffe Nero,Eating Out,2,739
14,1,2011,Anglo restaurant,Eating Out,41,698
15,1,2011,BRGAS-Electricity,Bills,44,654
15,1,2011,BRGAS-Gas,Bills,39,615
15,1,2011,Scott's Restaurant,Eating Out,25,590
15,1,2011,Civic Shop,,6,584
16,1,2011,LBS Council Tax,Bills,50,534
17,1,2011,South West Trains,Transport,35,499
17,1,2011,Starbucks Coffee,Eating Out,2,497
17,1,2011,Paying back Julie,,7,490
18,1,2011,Caffe Nero,Eating Out,2,488
18,1,2011,The West Cornwall Pasty Company,Eating Out,5,483
19,1,2011,Costa Coffee,Eating Out,2,481
20,1,2011,VIRGIN MEDIA PYMTS,Bills,56,425
20,1,2011,Caffe Nero,Eating Out,2,423
20,1,2011,Pret A Manger,Eating Out,4,419
21,1,2011,Waitrose,Groceries,44,375
21,1,2011,Starbucks Coffee,Eating Out,2,373
21,1,2011,Subway,Eating Out,5,368
21,1,2011,Dominos Pizza,Eating Out,41,327
21,1,2011,ATM Cash Withdrawal,General,10,317
22,1,2011,Scott's Restaurant,Eating Out,32,285
24,1,2011,O2,Bills,37,248
24,1,2011,South West Trains,Transport,36,212
24,1,2011,Pret A Manger,Eating Out,8,204
24,1,2011,ATM Cash Withdrawal,General,20,184
25,1,2011,Costa Coffee,Eating Out,2,182
26,1,2011,Wild Bean Cafe,Eating Out,2,180
26,1,2011,Pret A Manger,Eating Out,8,172
26,1,2011,ATM Cash Withdrawal,General,10,162
27,1,2011,Starbucks Coffee,Eating Out,1,161
27,1,2011,Greggs,Eating Out,5,156
27,1,2011,ATM Cash Withdrawal,General,10,146
27,1,2011,Paying back Julie,,5,141
28,1,2011,Waitrose,Groceries,44,97
28,1,2011,Subway,Eating Out,7,90
28,1,2011,ATM Cash Withdrawal,General,10,80
31,1,2011,South West Trains,Transport,36,44
31,1,2011,Starbucks Coffee,Eating Out,1,43
31,1,2011,ATM Cash Withdrawal,General,10,33
1,2,2011,Rhino Sports salary,General,1700,1733
1,2,2011,Wild Bean Cafe,Eating Out,2,1731
1,2,2011,Greggs,Eating Out,8,1723
1,2,2011,ATM Cash Withdrawal,General,20,1703
2,2,2011,Wild Bean Cafe,Eating Out,2,1701
3,2,2011,Caffe Nero,Eating Out,2,1699
3,2,2011,ATM Cash Withdrawal,General,20,1679
3,2,2011,Civic Shop,,2,1677
4,2,2011,Waitrose,Groceries,48,1629
4,2,2011,Costa Coffee,Eating Out,1,1628
4,2,2011,Greggs,Eating Out,8,1620
4,2,2011,Fabric Club,Eating Out,5,1615
4,2,2011,Fabric Club,Eating Out,8,1607
4,2,2011,Fabric Club,Eating Out,13,1594
4,2,2011,Civic Shop,,8,1586
7,2,2011,Cubit and West rent,Rent,550,1036
7,2,2011,South West Trains,Transport,36,1000
7,2,2011,Costa Coffee,Eating Out,2,998
7,2,2011,Pret A Manger,Eating Out,5,993
7,2,2011,ATM Cash Withdrawal,General,20,973
7,2,2011,Red Shop,,4,969
8,2,2011,Wild Bean Cafe,Eating Out,2,967
8,2,2011,Greggs,Eating Out,8,959
8,2,2011,ATM Cash Withdrawal,General,10,949
9,2,2011,Caffe Nero,Eating Out,2,947
9,2,2011,Greggs,Eating Out,4,943
10,2,2011,The West Cornwall Pasty Company,Eating Out,8,935
11,2,2011,Sainsburys,Groceries,49,886
11,2,2011,Costa Coffee,Eating Out,2,884
11,2,2011,The West Cornwall Pasty Company,Eating Out,6,878
11,2,2011,Pizza Express,Eating Out,27,851
11,2,2011,ATM Cash Withdrawal,General,10,841
11,2,2011,Tool Shop,,8,833
12,2,2011,Restaurant Gordon RamsayPortland Restaurant,Eating Out,35,798
12,2,2011,Paying back Julie,,7,791
13,2,2011,ATM Cash Withdrawal,General,10,781
14,2,2011,South West Trains,Transport,29,752
14,2,2011,Wild Bean Cafe,Eating Out,2,750
14,2,2011,Subway,Eating Out,5,745
15,2,2011,BRGAS-Electricity,Bills,38,707
15,2,2011,BRGAS-Gas,Bills,28,679
15,2,2011,Chicken Cottage,Eating Out,5,674
16,2,2011,LBS Council Tax,Bills,50,624
16,2,2011,Caffe Nero,Eating Out,2,622
16,2,2011,Pret A Manger,Eating Out,8,614
16,2,2011,ATM Cash Withdrawal,General,10,604
16,2,2011,Civic Shop,,5,599
17,2,2011,Caffe Nero,Eating Out,2,597
17,2,2011,McDonalds,Eating Out,6,591
17,2,2011,ATM Cash Withdrawal,General,20,571
17,2,2011,Paying back Julie,,1,570
18,2,2011,ASDA,Groceries,69,501
18,2,2011,Pret A Manger,Eating Out,8,493
18,2,2011,Tool Tec,,9,484
19,2,2011,Fabric Club,Eating Out,11,473
19,2,2011,Fabric Club,Eating Out,15,458
19,2,2011,Fabric Club,Eating Out,16,442
19,2,2011,Fabric Club,Eating Out,8,434
19,2,2011,Fabric Club,Eating Out,5,429
19,2,2011,Fabric Club,Eating Out,5,424
20,2,2011,VIRGIN MEDIA PYMTS,Bills,34,390
20,2,2011,ATM Cash Withdrawal,General,20,370
21,2,2011,South West Trains,Transport,38,332
21,2,2011,Chicken Cottage,Eating Out,6,326
21,2,2011,Tool Shop,,5,321
22,2,2011,Costa Coffee,Eating Out,1,320
22,2,2011,McDonalds,Eating Out,7,313
22,2,2011,Tool Tec,,1,312
23,2,2011,Costa Coffee,Eating Out,2,310
23,2,2011,Subway,Eating Out,7,303
24,2,2011,O2,Bills,38,265
24,2,2011,Costa Coffee,Eating Out,2,263
24,2,2011,McDonalds,Eating Out,5,258
25,2,2011,Waitrose,Groceries,66,192
25,2,2011,Greggs,Eating Out,6,186
25,2,2011,ATM Cash Withdrawal,General,20,166
26,2,2011,Pizza Express,Eating Out,36,130
26,2,2011,ATM Cash Withdrawal,General,20,110
27,2,2011,Pizza Express,Eating Out,50,60
27,2,2011,ATM Cash Withdrawal,General,10,50
28,2,2011,South West Trains,Transport,25,25
28,2,2011,Caffe Nero,Eating Out,1,24
28,2,2011,The West Cornwall Pasty Company,Eating Out,5,19
1,3,2011,Rhino Sports salary,General,1700,1719
1,3,2011,Costa Coffee,Eating Out,2,1717
1,3,2011,McDonalds,Eating Out,7,1710
1,3,2011,Tool Shop,,9,1701
2,3,2011,Wild Bean Cafe,Eating Out,2,1699
3,3,2011,Pret A Manger,Eating Out,6,1693
3,3,2011,ATM Cash Withdrawal,General,10,1683
3,3,2011,Red Shop,,8,1675
4,3,2011,Waitrose,Groceries,48,1627
4,3,2011,Costa Coffee,Eating Out,2,1625
4,3,2011,Greggs,Eating Out,4,1621
5,3,2011,Tool Shop,,2,1619
6,3,2011,Red Shop,,8,1611
7,3,2011,Cubit and West rent,Rent,550,1061
7,3,2011,South West Trains,Transport,27,1034
7,3,2011,Costa Coffee,Eating Out,2,1032
7,3,2011,Subway,Eating Out,7,1025
8,3,2011,Starbucks Coffee,Eating Out,2,1023
8,3,2011,Chicken Cottage,Eating Out,7,1016
9,3,2011,Caffe Nero,Eating Out,2,1014
9,3,2011,ATM Cash Withdrawal,General,10,1004
10,3,2011,Costa Coffee,Eating Out,2,1002
11,3,2011,Tescos,Groceries,69,933
11,3,2011,Starbucks Coffee,Eating Out,1,932
11,3,2011,Pizza Express,Eating Out,51,881
12,3,2011,Anglo restaurant,Eating Out,52,829
12,3,2011,ATM Cash Withdrawal,General,10,819
13,3,2011,Restaurant Gordon RamsayPortland Restaurant,Eating Out,44,775
13,3,2011,ATM Cash Withdrawal,General,10,765
14,3,2011,South West Trains,Transport,26,739
14,3,2011,Wild Bean Cafe,Eating Out,2,737
14,3,2011,Tool Tec,,8,729
15,3,2011,BRGAS-Electricity,Bills,29,700
15,3,2011,BRGAS-Gas,Bills,28,672
15,3,2011,Costa Coffee,Eating Out,2,670
15,3,2011,The West Cornwall Pasty Company,Eating Out,8,662
16,3,2011,LBS Council Tax,Bills,50,612
16,3,2011,Wild Bean Cafe,Eating Out,2,610
16,3,2011,Greggs,Eating Out,7,603
17,3,2011,Wild Bean Cafe,Eating Out,2,601
18,3,2011,Sainsburys,Groceries,43,558
18,3,2011,Starbucks Coffee,Eating Out,2,556
19,3,2011,Anglo restaurant,Eating Out,57,499
19,3,2011,ATM Cash Withdrawal,General,20,479
20,3,2011,VIRGIN MEDIA PYMTS,Bills,32,447
20,3,2011,Dominos Pizza,Eating Out,42,405
20,3,2011,ATM Cash Withdrawal,General,10,395
21,3,2011,South West Trains,Transport,28,367
21,3,2011,Wild Bean Cafe,Eating Out,2,365
21,3,2011,Greggs,Eating Out,8,357
21,3,2011,ATM Cash Withdrawal,General,20,337
22,3,2011,Caffe Nero,Eating Out,2,335
22,3,2011,ATM Cash Withdrawal,General,10,325
23,3,2011,Caffe Nero,Eating Out,1,324
23,3,2011,Chicken Cottage,Eating Out,5,319
24,3,2011,O2,Bills,34,285
24,3,2011,Costa Coffee,Eating Out,2,283
24,3,2011,Paying back James,,5,278
25,3,2011,Waitrose,Groceries,64,214
25,3,2011,Starbucks Coffee,Eating Out,2,212
26,3,2011,Anglo restaurant,Eating Out,30,182
28,3,2011,South West Trains,Transport,27,155
28,3,2011,Costa Coffee,Eating Out,2,153
28,3,2011,Chicken Cottage,Eating Out,8,145
28,3,2011,ATM Cash Withdrawal,General,20,125
29,3,2011,Starbucks Coffee,Eating Out,1,124
30,3,2011,Pret A Manger,Eating Out,4,120
31,3,2011,Wild Bean Cafe,Eating Out,2,118
1,4,2011,Rhino Sports salary,General,1700,1818
1,4,2011,ASDA,Groceries,57,1761
1,4,2011,Wild Bean Cafe,Eating Out,1,1760
1,4,2011,Pret A Manger,Eating Out,4,1756
1,4,2011,ATM Cash Withdrawal,General,10,1746
2,4,2011,The Grand Pub,Eating Out,12,1734
2,4,2011,The Grand Pub,Eating Out,15,1719
2,4,2011,The Grand Pub,Eating Out,5,1714
2,4,2011,The Grand Pub,Eating Out,14,1700
2,4,2011,The Grand Pub,Eating Out,7,1693
2,4,2011,The Grand Pub,Eating Out,5,1688
2,4,2011,Dominos Pizza,Eating Out,59,1629
4,4,2011,South West Trains,Transport,30,1599
4,4,2011,Starbucks Coffee,Eating Out,2,1597
4,4,2011,Chicken Cottage,Eating Out,6,1591
4,4,2011,ATM Cash Withdrawal,General,10,1581
4,4,2011,Cheam Service Station,,1,1580
5,4,2011,Wild Bean Cafe,Eating Out,2,1578
6,4,2011,ATM Cash Withdrawal,General,20,1558
7,4,2011,Cubit and West rent,Rent,550,1008
8,4,2011,ASDA,Groceries,82,926
8,4,2011,Subway,Eating Out,4,922
8,4,2011,Anglo restaurant,Eating Out,32,890
8,4,2011,ATM Cash Withdrawal,General,20,870
10,4,2011,Scott's Restaurant,Eating Out,49,821
11,4,2011,South West Trains,Transport,28,793
11,4,2011,Starbucks Coffee,Eating Out,1,792
11,4,2011,Chicken Cottage,Eating Out,4,788
12,4,2011,Costa Coffee,Eating Out,1,787
12,4,2011,Greggs,Eating Out,7,780
13,4,2011,Greggs,Eating Out,7,773
13,4,2011,Tool Tec,,9,764
14,4,2011,Costa Coffee,Eating Out,2,762
15,4,2011,BRGAS-Electricity,Bills,29,733
15,4,2011,BRGAS-Gas,Bills,37,696
15,4,2011,Waitrose,Groceries,49,647
15,4,2011,The West Cornwall Pasty Company,Eating Out,4,643
15,4,2011,Dominos Pizza,Eating Out,49,594
15,4,2011,ATM Cash Withdrawal,General,10,584
16,4,2011,LBS Council Tax,Bills,50,534
18,4,2011,South West Trains,Transport,35,499
18,4,2011,Caffe Nero,Eating Out,1,498
19,4,2011,Wild Bean Cafe,Eating Out,1,497
19,4,2011,McDonalds,Eating Out,6,491
20,4,2011,VIRGIN MEDIA PYMTS,Bills,49,442
20,4,2011,Costa Coffee,Eating Out,1,441
20,4,2011,Chicken Cottage,Eating Out,8,433
21,4,2011,The West Cornwall Pasty Company,Eating Out,5,428
22,4,2011,Waitrose,Groceries,52,376
22,4,2011,Chicken Cottage,Eating Out,5,371
22,4,2011,Scott's Restaurant,Eating Out,43,328
23,4,2011,Restaurant Gordon RamsayPortland Restaurant,Eating Out,51,277
24,4,2011,O2,Bills,36,241
24,4,2011,Pizza Express,Eating Out,29,212
24,4,2011,ATM Cash Withdrawal,General,10,202
25,4,2011,South West Trains,Transport,27,175
25,4,2011,Wild Bean Cafe,Eating Out,2,173
25,4,2011,Chicken Cottage,Eating Out,6,167
26,4,2011,Caffe Nero,Eating Out,2,165
26,4,2011,The West Cornwall Pasty Company,Eating Out,7,158
27,4,2011,McDonalds,Eating Out,7,151
28,4,2011,Wild Bean Cafe,Eating Out,2,149
28,4,2011,Chicken Cottage,Eating Out,5,144
28,4,2011,ATM Cash Withdrawal,General,20,124
29,4,2011,ASDA,Groceries,49,75
29,4,2011,Caffe Nero,Eating Out,1,74
29,4,2011,Greggs,Eating Out,6,68
30,4,2011,ATM Cash Withdrawal,General,10,58
1,5,2011,Rhino Sports salary,General,1700,1758
1,5,2011,Restaurant Gordon RamsayPortland Restaurant,Eating Out,34,1724
2,5,2011,South West Trains,Transport,37,1687
2,5,2011,Costa Coffee,Eating Out,2,1685
3,5,2011,Costa Coffee,Eating Out,1,1684
4,5,2011,McDonalds,Eating Out,5,1679
4,5,2011,ATM Cash Withdrawal,General,20,1659
5,5,2011,Wild Bean Cafe,Eating Out,2,1657
5,5,2011,McDonalds,Eating Out,4,1653
6,5,2011,Sainsburys,Groceries,80,1573
6,5,2011,Wild Bean Cafe,Eating Out,2,1571
6,5,2011,Greggs,Eating Out,8,1563
6,5,2011,Scott's Restaurant,Eating Out,55,1508
7,5,2011,Cubit and West rent,Rent,550,958
9,5,2011,South West Trains,Transport,32,926
9,5,2011,Starbucks Coffee,Eating Out,1,925
9,5,2011,McDonalds,Eating Out,5,920
10,5,2011,Starbucks Coffee,Eating Out,2,918
10,5,2011,McDonalds,Eating Out,7,911
11,5,2011,Costa Coffee,Eating Out,2,909
11,5,2011,Pret A Manger,Eating Out,7,902
11,5,2011,ATM Cash Withdrawal,General,20,882
12,5,2011,Costa Coffee,Eating Out,2,880
12,5,2011,Chicken Cottage,Eating Out,4,876
13,5,2011,Sainsburys,Groceries,86,790
13,5,2011,Costa Coffee,Eating Out,2,788
13,5,2011,The West Cornwall Pasty Company,Eating Out,5,783
13,5,2011,Anglo restaurant,Eating Out,25,758
14,5,2011,Restaurant Gordon RamsayPortland Restaurant,Eating Out,39,719
14,5,2011,ATM Cash Withdrawal,General,10,709
15,5,2011,BRGAS-Electricity,Bills,35,674
15,5,2011,BRGAS-Gas,Bills,31,643
15,5,2011,ATM Cash Withdrawal,General,20,623
16,5,2011,LBS Council Tax,Bills,50,573
16,5,2011,South West Trains,Transport,32,541
16,5,2011,Costa Coffee,Eating Out,2,539
17,5,2011,Costa Coffee,Eating Out,2,537
18,5,2011,Starbucks Coffee,Eating Out,1,536
18,5,2011,Chicken Cottage,Eating Out,4,532
19,5,2011,Starbucks Coffee,Eating Out,2,530
19,5,2011,McDonalds,Eating Out,8,522
19,5,2011,ATM Cash Withdrawal,General,10,512
20,5,2011,VIRGIN MEDIA PYMTS,Bills,40,472
20,5,2011,Waitrose,Groceries,66,406
20,5,2011,Wild Bean Cafe,Eating Out,1,405
22,5,2011,Tool Tec,,5,400
23,5,2011,South West Trains,Transport,32,368
23,5,2011,Wild Bean Cafe,Eating Out,2,366
23,5,2011,Tool Tec,,3,363
24,5,2011,O2,Bills,35,328
24,5,2011,Costa Coffee,Eating Out,1,327
24,5,2011,The West Cornwall Pasty Company,Eating Out,7,320
24,5,2011,Tool Tec,,6,314
25,5,2011,ATM Cash Withdrawal,General,10,304
25,5,2011,Paying back James,,6,298
26,5,2011,Wild Bean Cafe,Eating Out,1,297
26,5,2011,Chicken Cottage,Eating Out,5,292
26,5,2011,ATM Cash Withdrawal,General,10,282
27,5,2011,Morrisons,Groceries,88,194
27,5,2011,Anglo restaurant,Eating Out,45,149
27,5,2011,ATM Cash Withdrawal,General,10,139
28,5,2011,Scott's Restaurant,Eating Out,31,108
29,5,2011,Dominos Pizza,Eating Out,32,76
30,5,2011,South West Trains,Transport,37,39
30,5,2011,Caffe Nero,Eating Out,2,37
30,5,2011,Chicken Cottage,Eating Out,6,31
31,5,2011,Wild Bean Cafe,Eating Out,1,30
31,5,2011,Greggs,Eating Out,7,23
31,5,2011,ATM Cash Withdrawal,General,10,13
1,6,2011,Rhino Sports salary,General,1700,1713
2,6,2011,Costa Coffee,Eating Out,2,1711
2,6,2011,ATM Cash Withdrawal,General,20,1691
3,6,2011,Waitrose,Groceries,85,1606
3,6,2011,Wild Bean Cafe,Eating Out,1,1605
3,6,2011,Restaurant Gordon RamsayPortland Restaurant,Eating Out,54,1551
4,6,2011,Ministry of Sound ClubXOYO Club,Eating Out,15,1536
4,6,2011,Pizza Express,Eating Out,38,1498
5,6,2011,ATM Cash Withdrawal,General,10,1488
6,6,2011,South West Trains,Transport,34,1454
6,6,2011,Costa Coffee,Eating Out,1,1453
6,6,2011,Subway,Eating Out,6,1447
7,6,2011,Cubit and West rent,Rent,550,897
7,6,2011,Greggs,Eating Out,8,889
7,6,2011,ATM Cash Withdrawal,General,20,869
8,6,2011,Costa Coffee,Eating Out,1,868
9,6,2011,Costa Coffee,Eating Out,1,867
9,6,2011,Tool Tec,,4,863
10,6,2011,Waitrose,Groceries,49,814
10,6,2011,Costa Coffee,Eating Out,1,813
10,6,2011,ATM Cash Withdrawal,General,20,793
11,6,2011,Anglo restaurant,Eating Out,57,736
12,6,2011,Scott's Restaurant,Eating Out,36,700
12,6,2011,Civic Shop,,9,691
13,6,2011,South West Trains,Transport,27,664
13,6,2011,Costa Coffee,Eating Out,2,662
14,6,2011,Costa Coffee,Eating Out,2,660
15,6,2011,BRGAS-Electricity,Bills,32,628
15,6,2011,BRGAS-Gas,Bills,37,591
15,6,2011,Caffe Nero,Eating Out,2,589
16,6,2011,LBS Council Tax,Bills,50,539
16,6,2011,Greggs,Eating Out,7,532
16,6,2011,ATM Cash Withdrawal,General,10,522
17,6,2011,Tescos,Groceries,61,461
17,6,2011,McDonalds,Eating Out,8,453
17,6,2011,The Grand Pub,Eating Out,5,448
17,6,2011,The Grand Pub,Eating Out,10,438
17,6,2011,ATM Cash Withdrawal,General,20,418
18,6,2011,Paying back Julie,,2,416
20,6,2011,VIRGIN MEDIA PYMTS,Bills,49,367
20,6,2011,South West Trains,Transport,32,335
20,6,2011,Starbucks Coffee,Eating Out,2,333
20,6,2011,McDonalds,Eating Out,5,328
21,6,2011,Costa Coffee,Eating Out,2,326
22,6,2011,ATM Cash Withdrawal,General,20,306
23,6,2011,Caffe Nero,Eating Out,2,304
23,6,2011,Chicken Cottage,Eating Out,7,297
24,6,2011,O2,Bills,31,266
24,6,2011,Sainsburys,Groceries,69,197
24,6,2011,Wild Bean Cafe,Eating Out,2,195
24,6,2011,ATM Cash Withdrawal,General,10,185
26,6,2011,Anglo restaurant,Eating Out,33,152
27,6,2011,South West Trains,Transport,27,125
27,6,2011,Costa Coffee,Eating Out,2,123
27,6,2011,Subway,Eating Out,4,119
27,6,2011,Tool Shop,,8,111
28,6,2011,Costa Coffee,Eating Out,1,110
28,6,2011,Tool Tec,,6,104
29,6,2011,Subway,Eating Out,8,96
30,6,2011,Costa Coffee,Eating Out,1,95
30,6,2011,Tool Shop,,4,91
1,7,2011,Rhino Sports salary,General,1700,1791
1,7,2011,Waitrose,Groceries,79,1712
1,7,2011,Starbucks Coffee,Eating Out,2,1710
1,7,2011,Subway,Eating Out,6,1704
1,7,2011,The Grand Pub,Eating Out,12,1692
1,7,2011,The Grand Pub,Eating Out,6,1686
1,7,2011,The Grand Pub,Eating Out,11,1675
1,7,2011,The Grand Pub,Eating Out,13,1662
4,7,2011,South West Trains,Transport,29,1633
4,7,2011,McDonalds,Eating Out,7,1626
4,7,2011,Paying back James,,3,1623
5,7,2011,Starbucks Coffee,Eating Out,1,1622
6,7,2011,ATM Cash Withdrawal,General,20,1602
7,7,2011,Cubit and West rent,Rent,550,1052
7,7,2011,Starbucks Coffee,Eating Out,1,1051
8,7,2011,Waitrose,Groceries,50,1001
8,7,2011,Caffe Nero,Eating Out,2,999
8,7,2011,Restaurant Gordon RamsayPortland Restaurant,Eating Out,36,963
8,7,2011,ATM Cash Withdrawal,General,10,953
9,7,2011,Anglo restaurant,Eating Out,37,916
10,7,2011,Scott's Restaurant,Eating Out,28,888
11,7,2011,South West Trains,Transport,29,859
11,7,2011,Wild Bean Cafe,Eating Out,2,857
11,7,2011,ATM Cash Withdrawal,General,20,837
13,7,2011,Costa Coffee,Eating Out,2,835
14,7,2011,Wild Bean Cafe,Eating Out,1,834
14,7,2011,Greggs,Eating Out,5,829
15,7,2011,BRGAS-Electricity,Bills,35,794
15,7,2011,BRGAS-Gas,Bills,27,767
15,7,2011,Tescos,Groceries,86,681
15,7,2011,Costa Coffee,Eating Out,1,680
15,7,2011,Dominos Pizza,Eating Out,57,623
15,7,2011,ATM Cash Withdrawal,General,10,613
16,7,2011,LBS Council Tax,Bills,50,563
16,7,2011,Fabric Club,Eating Out,6,557
16,7,2011,Fabric Club,Eating Out,7,550
18,7,2011,South West Trains,Transport,33,517
18,7,2011,Caffe Nero,Eating Out,1,516
18,7,2011,Greggs,Eating Out,4,512
18,7,2011,Red Shop,,6,506
19,7,2011,Starbucks Coffee,Eating Out,1,505
19,7,2011,McDonalds,Eating Out,8,497
20,7,2011,VIRGIN MEDIA PYMTS,Bills,45,452
20,7,2011,Caffe Nero,Eating Out,1,451
21,7,2011,Starbucks Coffee,Eating Out,1,450
21,7,2011,Subway,Eating Out,5,445
22,7,2011,Waitrose,Groceries,84,361
22,7,2011,Chicken Cottage,Eating Out,4,357
22,7,2011,Anglo restaurant,Eating Out,27,330
22,7,2011,ATM Cash Withdrawal,General,20,310
23,7,2011,ATM Cash Withdrawal,General,20,290
24,7,2011,O2,Bills,37,253
25,7,2011,South West Trains,Transport,26,227
25,7,2011,Starbucks Coffee,Eating Out,2,225
25,7,2011,Pret A Manger,Eating Out,4,221
26,7,2011,Costa Coffee,Eating Out,2,219
26,7,2011,Subway,Eating Out,4,215
27,7,2011,Starbucks Coffee,Eating Out,1,214
27,7,2011,Chicken Cottage,Eating Out,4,210
27,7,2011,ATM Cash Withdrawal,General,20,190
29,7,2011,Waitrose,Groceries,61,129
29,7,2011,Chicken Cottage,Eating Out,7,122
30,7,2011,Anglo restaurant,Eating Out,28,94
30,7,2011,ATM Cash Withdrawal,General,20,74
1,8,2011,Rhino Sports salary,General,1700,1774
1,8,2011,South West Trains,Transport,29,1745
1,8,2011,Wild Bean Cafe,Eating Out,2,1743
1,8,2011,Pret A Manger,Eating Out,6,1737
3,8,2011,Caffe Nero,Eating Out,1,1736
3,8,2011,Chicken Cottage,Eating Out,8,1728
5,8,2011,Morrisons,Groceries,52,1676
5,8,2011,Starbucks Coffee,Eating Out,2,1674
5,8,2011,The Grand Pub,Eating Out,15,1659
5,8,2011,The Grand Pub,Eating Out,16,1643
5,8,2011,The Grand Pub,Eating Out,13,1630
5,8,2011,The Grand Pub,Eating Out,8,1622
5,8,2011,The Grand Pub,Eating Out,8,1614
6,8,2011,ATM Cash Withdrawal,General,20,1594
7,8,2011,Cubit and West rent,Rent,550,1044
7,8,2011,ATM Cash Withdrawal,General,20,1024
8,8,2011,South West Trains,Transport,29,995
8,8,2011,Starbucks Coffee,Eating Out,2,993
8,8,2011,ATM Cash Withdrawal,General,20,973
10,8,2011,ATM Cash Withdrawal,General,10,963
11,8,2011,Wild Bean Cafe,Eating Out,2,961
12,8,2011,ASDA,Groceries,85,876
12,8,2011,Starbucks Coffee,Eating Out,2,874
12,8,2011,McDonalds,Eating Out,6,868
13,8,2011,ATM Cash Withdrawal,General,10,858
14,8,2011,ATM Cash Withdrawal,General,10,848
15,8,2011,BRGAS-Electricity,Bills,43,805
15,8,2011,BRGAS-Gas,Bills,29,776
15,8,2011,South West Trains,Transport,33,743
15,8,2011,Caffe Nero,Eating Out,2,741
16,8,2011,LBS Council Tax,Bills,50,691
16,8,2011,McDonalds,Eating Out,7,684
17,8,2011,Starbucks Coffee,Eating Out,2,682
17,8,2011,ATM Cash Withdrawal,General,20,662
18,8,2011,Costa Coffee,Eating Out,2,660
18,8,2011,Greggs,Eating Out,6,654
19,8,2011,Waitrose,Groceries,74,580
19,8,2011,Caffe Nero,Eating Out,1,579
19,8,2011,Scott's Restaurant,Eating Out,37,542
20,8,2011,VIRGIN MEDIA PYMTS,Bills,59,483
21,8,2011,ATM Cash Withdrawal,General,20,463
21,8,2011,Red Shop,,8,455
22,8,2011,South West Trains,Transport,34,421
22,8,2011,ATM Cash Withdrawal,General,20,401
23,8,2011,McDonalds,Eating Out,7,394
24,8,2011,O2,Bills,31,363
25,8,2011,Greggs,Eating Out,5,358
25,8,2011,ATM Cash Withdrawal,General,20,338
26,8,2011,Waitrose,Groceries,89,249
26,8,2011,Starbucks Coffee,Eating Out,2,247
26,8,2011,The West Cornwall Pasty Company,Eating Out,4,243
26,8,2011,Red Shop,,7,236
27,8,2011,Heaven Club,Eating Out,5,231
27,8,2011,Heaven Club,Eating Out,11,220
27,8,2011,Heaven Club,Eating Out,12,208
28,8,2011,Dominos Pizza,Eating Out,27,181
29,8,2011,South West Trains,Transport,34,147
29,8,2011,Costa Coffee,Eating Out,2,145
29,8,2011,Pret A Manger,Eating Out,6,139
29,8,2011,ATM Cash Withdrawal,General,20,119
29,8,2011,Paying back James,,1,118
30,8,2011,Wild Bean Cafe,Eating Out,2,116
30,8,2011,McDonalds,Eating Out,7,109
31,8,2011,Starbucks Coffee,Eating Out,2,107
31,8,2011,ATM Cash Withdrawal,General,10,97
1,9,2011,Rhino Sports salary,General,1700,1797
2,9,2011,Tescos,Groceries,86,1711
2,9,2011,Wild Bean Cafe,Eating Out,2,1709
2,9,2011,Greggs,Eating Out,8,1701
2,9,2011,ATM Cash Withdrawal,General,10,1691
5,9,2011,South West Trains,Transport,25,1666
5,9,2011,Caffe Nero,Eating Out,1,1665
6,9,2011,Wild Bean Cafe,Eating Out,2,1663
6,9,2011,Greggs,Eating Out,6,1657
7,9,2011,Cubit and West rent,Rent,550,1107
8,9,2011,Caffe Nero,Eating Out,2,1105
9,9,2011,Sainsburys,Groceries,89,1016
9,9,2011,Wild Bean Cafe,Eating Out,2,1014
9,9,2011,The West Cornwall Pasty Company,Eating Out,6,1008
10,9,2011,ATM Cash Withdrawal,General,10,998
10,9,2011,Paying back Julie,,6,992
11,9,2011,ATM Cash Withdrawal,General,20,972
12,9,2011,South West Trains,Transport,30,942
12,9,2011,Starbucks Coffee,Eating Out,2,940
12,9,2011,Greggs,Eating Out,8,932
13,9,2011,Costa Coffee,Eating Out,2,930
13,9,2011,The West Cornwall Pasty Company,Eating Out,7,923
14,9,2011,Wild Bean Cafe,Eating Out,1,922
14,9,2011,Subway,Eating Out,5,917
14,9,2011,ATM Cash Withdrawal,General,10,907
15,9,2011,BRGAS-Electricity,Bills,42,865
15,9,2011,BRGAS-Gas,Bills,42,823
15,9,2011,Costa Coffee,Eating Out,1,822
15,9,2011,Subway,Eating Out,5,817
16,9,2011,LBS Council Tax,Bills,50,767
16,9,2011,ASDA,Groceries,78,689
16,9,2011,Caffe Nero,Eating Out,2,687
16,9,2011,McDonalds,Eating Out,7,680
16,9,2011,Restaurant Gordon RamsayPortland Restaurant,Eating Out,41,639
17,9,2011,Restaurant Gordon RamsayPortland Restaurant,Eating Out,55,584
18,9,2011,Pizza Express,Eating Out,26,558
19,9,2011,South West Trains,Transport,24,534
19,9,2011,The West Cornwall Pasty Company,Eating Out,5,529
20,9,2011,VIRGIN MEDIA PYMTS,Bills,48,481
21,9,2011,Caffe Nero,Eating Out,1,480
21,9,2011,Subway,Eating Out,7,473
22,9,2011,Costa Coffee,Eating Out,2,471
22,9,2011,The West Cornwall Pasty Company,Eating Out,8,463
22,9,2011,ATM Cash Withdrawal,General,20,443
23,9,2011,Waitrose,Groceries,83,360
23,9,2011,McDonalds,Eating Out,6,354
23,9,2011,The Grand Pub,Eating Out,13,341
23,9,2011,The Grand Pub,Eating Out,13,328
23,9,2011,The Grand Pub,Eating Out,14,314
23,9,2011,The Grand Pub,Eating Out,16,298
23,9,2011,The Grand Pub,Eating Out,15,283
23,9,2011,Pizza Express,Eating Out,39,244
24,9,2011,O2,Bills,37,207
25,9,2011,Anglo restaurant,Eating Out,58,149
26,9,2011,South West Trains,Transport,35,114
26,9,2011,Starbucks Coffee,Eating Out,1,113
26,9,2011,Subway,Eating Out,6,107
27,9,2011,Starbucks Coffee,Eating Out,2,105
27,9,2011,The West Cornwall Pasty Company,Eating Out,8,97
28,9,2011,Pret A Manger,Eating Out,6,91
28,9,2011,ATM Cash Withdrawal,General,20,71
29,9,2011,Wild Bean Cafe,Eating Out,1,70
29,9,2011,ATM Cash Withdrawal,General,20,50
30,9,2011,ASDA,Groceries,82,-32
30,9,2011,Starbucks Coffee,Eating Out,2,-34
30,9,2011,Pret A Manger,Eating Out,7,-41
30,9,2011,The Grand Pub,Eating Out,13,-54
30,9,2011,The Grand Pub,Eating Out,15,-69
30,9,2011,The Grand Pub,Eating Out,12,-81
30,9,2011,The Grand Pub,Eating Out,15,-96
30,9,2011,The Grand Pub,Eating Out,10,-106
30,9,2011,ATM Cash Withdrawal,General,10,-116
30,9,2011,Paying back James,,8,-124
1,10,2011,Rhino Sports salary,General,1700,1576
1,10,2011,Anglo restaurant,Eating Out,56,1520
3,10,2011,South West Trains,Transport,28,1492
3,10,2011,Wild Bean Cafe,Eating Out,2,1490
4,10,2011,Starbucks Coffee,Eating Out,1,1489
4,10,2011,Subway,Eating Out,6,1483
5,10,2011,Starbucks Coffee,Eating Out,2,1481
5,10,2011,The West Cornwall Pasty Company,Eating Out,6,1475
6,10,2011,Wild Bean Cafe,Eating Out,2,1473
6,10,2011,The West Cornwall Pasty Company,Eating Out,6,1467
7,10,2011,Cubit and West rent,Rent,550,917
7,10,2011,Tescos,Groceries,51,866
7,10,2011,Caffe Nero,Eating Out,2,864
7,10,2011,The West Cornwall Pasty Company,Eating Out,4,860
8,10,2011,Restaurant Gordon RamsayPortland Restaurant,Eating Out,57,803
8,10,2011,ATM Cash Withdrawal,General,10,793
9,10,2011,ATM Cash Withdrawal,General,20,773
10,10,2011,South West Trains,Transport,34,739
10,10,2011,Starbucks Coffee,Eating Out,2,737
11,10,2011,The West Cornwall Pasty Company,Eating Out,7,730
12,10,2011,Costa Coffee,Eating Out,2,728
12,10,2011,Chicken Cottage,Eating Out,7,721
13,10,2011,Caffe Nero,Eating Out,2,719
13,10,2011,Greggs,Eating Out,5,714
14,10,2011,Morrisons,Groceries,85,629
14,10,2011,Wild Bean Cafe,Eating Out,2,627
14,10,2011,The West Cornwall Pasty Company,Eating Out,8,619
14,10,2011,Scott's Restaurant,Eating Out,43,576
15,10,2011,BRGAS-Electricity,Bills,40,536
15,10,2011,BRGAS-Gas,Bills,22,514
15,10,2011,Pizza Express,Eating Out,54,460
15,10,2011,ATM Cash Withdrawal,General,10,450
16,10,2011,LBS Council Tax,Bills,50,400
16,10,2011,Restaurant Gordon RamsayPortland Restaurant,Eating Out,24,376
17,10,2011,South West Trains,Transport,29,347
17,10,2011,Wild Bean Cafe,Eating Out,2,345
17,10,2011,McDonalds,Eating Out,4,341
17,10,2011,ATM Cash Withdrawal,General,20,321
18,10,2011,Caffe Nero,Eating Out,2,319
18,10,2011,ATM Cash Withdrawal,General,10,309
19,10,2011,Pret A Manger,Eating Out,5,304
20,10,2011,VIRGIN MEDIA PYMTS,Bills,49,255
20,10,2011,Caffe Nero,Eating Out,2,253
20,10,2011,Greggs,Eating Out,4,249
21,10,2011,ASDA,Groceries,64,185
21,10,2011,McDonalds,Eating Out,6,179
24,10,2011,O2,Bills,30,149
24,10,2011,South West Trains,Transport,38,111
24,10,2011,ATM Cash Withdrawal,General,20,91
25,10,2011,Caffe Nero,Eating Out,2,89
25,10,2011,Pret A Manger,Eating Out,7,82
26,10,2011,Wild Bean Cafe,Eating Out,2,80
26,10,2011,Pret A Manger,Eating Out,5,75
26,10,2011,ATM Cash Withdrawal,General,10,65
27,10,2011,Caffe Nero,Eating Out,2,63
28,10,2011,ASDA,Groceries,88,-25
28,10,2011,Starbucks Coffee,Eating Out,1,-26
28,10,2011,Pret A Manger,Eating Out,6,-32
30,10,2011,Dominos Pizza,Eating Out,25,-57
30,10,2011,Paying back Julie,,3,-60
31,10,2011,South West Trains,Transport,28,-88
31,10,2011,Wild Bean Cafe,Eating Out,2,-90
31,10,2011,ATM Cash Withdrawal,General,20,-110
1,11,2011,Rhino Sports salary,General,1700,1590
1,11,2011,Caffe Nero,Eating Out,2,1588
1,11,2011,The West Cornwall Pasty Company,Eating Out,4,1584
2,11,2011,Wild Bean Cafe,Eating Out,2,1582
2,11,2011,Subway,Eating Out,8,1574
2,11,2011,Paying back James,,8,1566
3,11,2011,Costa Coffee,Eating Out,2,1564
4,11,2011,ASDA,Groceries,89,1475
4,11,2011,McDonalds,Eating Out,6,1469
5,11,2011,Restaurant Gordon RamsayPortland Restaurant,Eating Out,34,1435
6,11,2011,ATM Cash Withdrawal,General,20,1415
7,11,2011,Cubit and West rent,Rent,550,865
7,11,2011,South West Trains,Transport,26,839
7,11,2011,Wild Bean Cafe,Eating Out,2,837
7,11,2011,Chicken Cottage,Eating Out,5,832
8,11,2011,Costa Coffee,Eating Out,2,830
9,11,2011,Costa Coffee,Eating Out,2,828
9,11,2011,The West Cornwall Pasty Company,Eating Out,6,822
9,11,2011,ATM Cash Withdrawal,General,10,812
11,11,2011,Waitrose,Groceries,56,756
11,11,2011,Wild Bean Cafe,Eating Out,2,754
11,11,2011,McDonalds,Eating Out,7,747
11,11,2011,Dominos Pizza,Eating Out,39,708
13,11,2011,Dominos Pizza,Eating Out,27,681
14,11,2011,South West Trains,Transport,27,654
14,11,2011,Greggs,Eating Out,7,647
15,11,2011,BRGAS-Electricity,Bills,90,557
15,11,2011,BRGAS-Gas,Bills,67,490
15,11,2011,Wild Bean Cafe,Eating Out,2,488
15,11,2011,McDonalds,Eating Out,7,481
15,11,2011,ATM Cash Withdrawal,General,20,461
16,11,2011,LBS Council Tax,Bills,50,411
16,11,2011,Costa Coffee,Eating Out,1,410
16,11,2011,The West Cornwall Pasty Company,Eating Out,6,404
17,11,2011,Starbucks Coffee,Eating Out,2,402
18,11,2011,Waitrose,Groceries,87,315
18,11,2011,Wild Bean Cafe,Eating Out,1,314
18,11,2011,Chicken Cottage,Eating Out,5,309
18,11,2011,Heaven Club,Eating Out,5,304
18,11,2011,Heaven Club,Eating Out,8,296
18,11,2011,Heaven Club,Eating Out,14,282
18,11,2011,Heaven Club,Eating Out,10,272
18,11,2011,ATM Cash Withdrawal,General,10,262
19,11,2011,Restaurant Gordon RamsayPortland Restaurant,Eating Out,39,223
20,11,2011,VIRGIN MEDIA PYMTS,Bills,35,188
20,11,2011,Paying back James,,1,187
21,11,2011,South West Trains,Transport,28,159
21,11,2011,Caffe Nero,Eating Out,2,157
21,11,2011,Chicken Cottage,Eating Out,6,151
21,11,2011,ATM Cash Withdrawal,General,10,141
22,11,2011,Caffe Nero,Eating Out,2,139
22,11,2011,The West Cornwall Pasty Company,Eating Out,4,135
23,11,2011,Starbucks Coffee,Eating Out,1,134
23,11,2011,Subway,Eating Out,4,130
23,11,2011,ATM Cash Withdrawal,General,10,120
23,11,2011,Cheam Service Station,,4,116
24,11,2011,O2,Bills,35,81
24,11,2011,Caffe Nero,Eating Out,1,80
25,11,2011,Sainsburys,Groceries,58,22
25,11,2011,Restaurant Gordon RamsayPortland Restaurant,Eating Out,35,-13
26,11,2011,The Grand Pub,Eating Out,16,-29
26,11,2011,The Grand Pub,Eating Out,16,-45
26,11,2011,The Grand Pub,Eating Out,16,-61
26,11,2011,The Grand Pub,Eating Out,6,-67
26,11,2011,The Grand Pub,Eating Out,12,-79
26,11,2011,The Grand Pub,Eating Out,15,-94
26,11,2011,Paying back James,,1,-95
27,11,2011,ATM Cash Withdrawal,General,20,-115
28,11,2011,South West Trains,Transport,34,-149
28,11,2011,Costa Coffee,Eating Out,1,-150
28,11,2011,McDonalds,Eating Out,6,-156
29,11,2011,Costa Coffee,Eating Out,2,-158
29,11,2011,Tool Shop,,6,-164
30,11,2011,Starbucks Coffee,Eating Out,1,-165
30,11,2011,Subway,Eating Out,6,-171
30,11,2011,ATM Cash Withdrawal,General,20,-191
1,12,2011,Rhino Sports salary,General,1700,1509
1,12,2011,Starbucks Coffee,Eating Out,2,1507
1,12,2011,The West Cornwall Pasty Company,Eating Out,5,1502
1,12,2011,ATM Cash Withdrawal,General,10,1492
1,12,2011,Tool Tec,,2,1490
2,12,2011,Sainsburys,Groceries,45,1445
2,12,2011,McDonalds,Eating Out,8,1437
3,12,2011,Scott's Restaurant,Eating Out,36,1401
3,12,2011,ATM Cash Withdrawal,General,20,1381
4,12,2011,Pizza Express,Eating Out,46,1335
5,12,2011,South West Trains,Transport,25,1310
5,12,2011,Greggs,Eating Out,8,1302
6,12,2011,Costa Coffee,Eating Out,2,1300
6,12,2011,The West Cornwall Pasty Company,Eating Out,4,1296
7,12,2011,Cubit and West rent,Rent,550,746
7,12,2011,Caffe Nero,Eating Out,2,744
7,12,2011,Subway,Eating Out,7,737
7,12,2011,Tool Shop,,1,736
8,12,2011,The West Cornwall Pasty Company,Eating Out,6,730
9,12,2011,Waitrose,Groceries,88,642
9,12,2011,Starbucks Coffee,Eating Out,2,640
9,12,2011,Pret A Manger,Eating Out,7,633
10,12,2011,ATM Cash Withdrawal,General,20,613
11,12,2011,Dominos Pizza,Eating Out,32,581
12,12,2011,South West Trains,Transport,26,555
12,12,2011,Wild Bean Cafe,Eating Out,1,554
13,12,2011,Starbucks Coffee,Eating Out,1,553
13,12,2011,ATM Cash Withdrawal,General,20,533
14,12,2011,Costa Coffee,Eating Out,2,531
14,12,2011,Pret A Manger,Eating Out,4,527
14,12,2011,ATM Cash Withdrawal,General,20,507
15,12,2011,BRGAS-Electricity,Bills,36,471
15,12,2011,BRGAS-Gas,Bills,33,438
15,12,2011,The West Cornwall Pasty Company,Eating Out,4,434
16,12,2011,LBS Council Tax,Bills,50,384
16,12,2011,ASDA,Groceries,72,312
16,12,2011,Wild Bean Cafe,Eating Out,2,310
16,12,2011,Greggs,Eating Out,8,302
19,12,2011,South West Trains,Transport,25,277
19,12,2011,Costa Coffee,Eating Out,2,275
20,12,2011,VIRGIN MEDIA PYMTS,Bills,49,226
20,12,2011,Chicken Cottage,Eating Out,7,219
21,12,2011,Starbucks Coffee,Eating Out,2,217
21,12,2011,Chicken Cottage,Eating Out,4,213
22,12,2011,Costa Coffee,Eating Out,1,212
22,12,2011,Subway,Eating Out,6,206
22,12,2011,Cheam Service Station,,9,197
23,12,2011,Morrisons,Groceries,52,145
23,12,2011,Wild Bean Cafe,Eating Out,2,143
23,12,2011,The West Cornwall Pasty Company,Eating Out,4,139
23,12,2011,Scott's Restaurant,Eating Out,48,91
23,12,2011,ATM Cash Withdrawal,General,10,81
24,12,2011,O2,Bills,30,51
24,12,2011,ATM Cash Withdrawal,General,10,41
24,12,2011,Tool Shop,,8,33
25,12,2011,ATM Cash Withdrawal,General,10,23
26,12,2011,South West Trains,Transport,32,-9
26,12,2011,Wild Bean Cafe,Eating Out,2,-11
27,12,2011,Cheam Service Station,,1,-12
28,12,2011,Caffe Nero,Eating Out,1,-13
28,12,2011,Greggs,Eating Out,7,-20
29,12,2011,Chicken Cottage,Eating Out,7,-27
29,12,2011,ATM Cash Withdrawal,General,20,-47
30,12,2011,Tescos,Groceries,79,-126
30,12,2011,Wild Bean Cafe,Eating Out,1,-127
30,12,2011,McDonalds,Eating Out,8,-135
1,1,2012,Rhino Sports salary,General,1700,1565
2,1,2012,South West Trains,Transport,29,1536
2,1,2012,Starbucks Coffee,Eating Out,2,1534
2,1,2012,Chicken Cottage,Eating Out,6,1528
3,1,2012,Tool Tec,,4,1524
4,1,2012,Costa Coffee,Eating Out,2,1522
4,1,2012,Subway,Eating Out,5,1517
4,1,2012,Paying back Julie,,5,1512
5,1,2012,Chicken Cottage,Eating Out,7,1505
6,1,2012,ASDA,Groceries,42,1463
6,1,2012,Wild Bean Cafe,Eating Out,2,1461
6,1,2012,Subway,Eating Out,6,1455
6,1,2012,Anglo restaurant,Eating Out,40,1415
7,1,2012,Cubit and West rent,Rent,550,865
8,1,2012,ATM Cash Withdrawal,General,20,845
9,1,2012,South West Trains,Transport,30,815
9,1,2012,Starbucks Coffee,Eating Out,1,814
9,1,2012,McDonalds,Eating Out,4,810
9,1,2012,ATM Cash Withdrawal,General,10,800
9,1,2012,Paying back James,,2,798
10,1,2012,Costa Coffee,Eating Out,1,797
10,1,2012,Greggs,Eating Out,4,793
10,1,2012,ATM Cash Withdrawal,General,10,783
11,1,2012,Greggs,Eating Out,4,779
12,1,2012,Starbucks Coffee,Eating Out,2,777
12,1,2012,Chicken Cottage,Eating Out,5,772
13,1,2012,Morrisons,Groceries,55,717
13,1,2012,Wild Bean Cafe,Eating Out,2,715
13,1,2012,The West Cornwall Pasty Company,Eating Out,8,707
15,1,2012,BRGAS-Electricity,Bills,82,625
15,1,2012,BRGAS-Gas,Bills,35,590
16,1,2012,LBS Council Tax,Bills,50,540
16,1,2012,South West Trains,Transport,31,509
16,1,2012,Costa Coffee,Eating Out,2,507
16,1,2012,The West Cornwall Pasty Company,Eating Out,7,500
17,1,2012,Chicken Cottage,Eating Out,8,492
18,1,2012,Costa Coffee,Eating Out,1,491
18,1,2012,Subway,Eating Out,5,486
18,1,2012,Cheam Service Station,,8,478
19,1,2012,Wild Bean Cafe,Eating Out,1,477
19,1,2012,The West Cornwall Pasty Company,Eating Out,4,473
19,1,2012,ATM Cash Withdrawal,General,20,453
20,1,2012,VIRGIN MEDIA PYMTS,Bills,36,417
20,1,2012,ASDA,Groceries,89,328
20,1,2012,Starbucks Coffee,Eating Out,1,327
20,1,2012,Greggs,Eating Out,6,321
20,1,2012,Heaven Club,Eating Out,12,309
20,1,2012,Heaven Club,Eating Out,12,297
20,1,2012,Heaven Club,Eating Out,8,289
20,1,2012,Restaurant Gordon RamsayPortland Restaurant,Eating Out,30,259
21,1,2012,ATM Cash Withdrawal,General,10,249
22,1,2012,ATM Cash Withdrawal,General,10,239
23,1,2012,South West Trains,Transport,27,212
23,1,2012,Paying back Julie,,4,208
24,1,2012,O2,Bills,30,178
25,1,2012,Starbucks Coffee,Eating Out,1,177
25,1,2012,ATM Cash Withdrawal,General,10,167
26,1,2012,Costa Coffee,Eating Out,1,166
26,1,2012,The West Cornwall Pasty Company,Eating Out,4,162
27,1,2012,Waitrose,Groceries,51,111
27,1,2012,Wild Bean Cafe,Eating Out,2,109
27,1,2012,The West Cornwall Pasty Company,Eating Out,5,104
27,1,2012,Anglo restaurant,Eating Out,41,63
29,1,2012,Dominos Pizza,Eating Out,31,32
29,1,2012,ATM Cash Withdrawal,General,10,22
29,1,2012,Red Shop,,9,13
30,1,2012,South West Trains,Transport,24,-11
30,1,2012,Costa Coffee,Eating Out,1,-12
30,1,2012,Pret A Manger,Eating Out,4,-16
30,1,2012,ATM Cash Withdrawal,General,20,-36
1,2,2012,Rhino Sports salary,General,1700,1664
1,2,2012,ATM Cash Withdrawal,General,20,1644
2,2,2012,Costa Coffee,Eating Out,2,1642
2,2,2012,The West Cornwall Pasty Company,Eating Out,5,1637
2,2,2012,Red Shop,,3,1634
3,2,2012,Tescos,Groceries,76,1558
3,2,2012,Costa Coffee,Eating Out,1,1557
3,2,2012,Anglo restaurant,Eating Out,45,1512
4,2,2012,Heaven Club,Eating Out,9,1503
4,2,2012,Heaven Club,Eating Out,6,1497
4,2,2012,Heaven Club,Eating Out,9,1488
4,2,2012,Heaven Club,Eating Out,11,1477
4,2,2012,Heaven Club,Eating Out,9,1468
4,2,2012,ATM Cash Withdrawal,General,10,1458
6,2,2012,South West Trains,Transport,27,1431
6,2,2012,ATM Cash Withdrawal,General,20,1411
7,2,2012,Cubit and West rent,Rent,550,861
7,2,2012,Caffe Nero,Eating Out,1,860
7,2,2012,ATM Cash Withdrawal,General,20,840
9,2,2012,Wild Bean Cafe,Eating Out,2,838
9,2,2012,McDonalds,Eating Out,4,834
9,2,2012,ATM Cash Withdrawal,General,10,824
10,2,2012,ASDA,Groceries,62,762
10,2,2012,Starbucks Coffee,Eating Out,1,761
10,2,2012,McDonalds,Eating Out,7,754
10,2,2012,Restaurant Gordon RamsayPortland Restaurant,Eating Out,37,717
11,2,2012,Pizza Express,Eating Out,32,685
12,2,2012,ATM Cash Withdrawal,General,20,665
12,2,2012,Tool Tec,,7,658
13,2,2012,South West Trains,Transport,36,622
13,2,2012,ATM Cash Withdrawal,General,20,602
13,2,2012,Paying back Julie,,1,601
14,2,2012,Wild Bean Cafe,Eating Out,2,599
14,2,2012,Chicken Cottage,Eating Out,8,591
15,2,2012,BRGAS-Electricity,Bills,42,549
15,2,2012,BRGAS-Gas,Bills,37,512
15,2,2012,Caffe Nero,Eating Out,2,510
16,2,2012,LBS Council Tax,Bills,50,460
16,2,2012,Starbucks Coffee,Eating Out,2,458
16,2,2012,The West Cornwall Pasty Company,Eating Out,6,452
17,2,2012,Morrisons,Groceries,60,392
17,2,2012,Pret A Manger,Eating Out,5,387
18,2,2012,ATM Cash Withdrawal,General,10,377
19,2,2012,Dominos Pizza,Eating Out,24,353
20,2,2012,VIRGIN MEDIA PYMTS,Bills,33,320
20,2,2012,South West Trains,Transport,35,285
20,2,2012,Wild Bean Cafe,Eating Out,2,283
21,2,2012,Costa Coffee,Eating Out,2,281
21,2,2012,Subway,Eating Out,4,277
21,2,2012,Cheam Service Station,,9,268
22,2,2012,Caffe Nero,Eating Out,2,266
22,2,2012,Pret A Manger,Eating Out,7,259
22,2,2012,ATM Cash Withdrawal,General,20,239
23,2,2012,Starbucks Coffee,Eating Out,2,237
24,2,2012,O2,Bills,30,207
24,2,2012,Morrisons,Groceries,64,143
24,2,2012,Chicken Cottage,Eating Out,7,136
25,2,2012,Paying back Julie,,3,133
27,2,2012,South West Trains,Transport,33,100
27,2,2012,Wild Bean Cafe,Eating Out,2,98
27,2,2012,Pret A Manger,Eating Out,5,93
28,2,2012,Caffe Nero,Eating Out,1,92
28,2,2012,The West Cornwall Pasty Company,Eating Out,8,84
29,2,2012,Pret A Manger,Eating Out,6,78
1,3,2012,Rhino Sports salary,General,1700,1778
1,3,2012,Wild Bean Cafe,Eating Out,2,1776
1,3,2012,Chicken Cottage,Eating Out,7,1769
2,3,2012,Morrisons,Groceries,79,1690
2,3,2012,Starbucks Coffee,Eating Out,1,1689
2,3,2012,Anglo restaurant,Eating Out,33,1656
5,3,2012,South West Trains,Transport,34,1622
5,3,2012,Caffe Nero,Eating Out,2,1620
6,3,2012,Wild Bean Cafe,Eating Out,1,1619
6,3,2012,Greggs,Eating Out,4,1615
6,3,2012,ATM Cash Withdrawal,General,20,1595
7,3,2012,Cubit and West rent,Rent,550,1045
7,3,2012,Starbucks Coffee,Eating Out,2,1043
7,3,2012,McDonalds,Eating Out,7,1036
8,3,2012,Paying back James,,9,1027
9,3,2012,Morrisons,Groceries,78,949
9,3,2012,Caffe Nero,Eating Out,1,948
9,3,2012,Chicken Cottage,Eating Out,5,943
10,3,2012,Heaven Club,Eating Out,10,933
10,3,2012,Heaven Club,Eating Out,11,922
10,3,2012,Scott's Restaurant,Eating Out,53,869
10,3,2012,ATM Cash Withdrawal,General,20,849
11,3,2012,Scott's Restaurant,Eating Out,43,806
11,3,2012,ATM Cash Withdrawal,General,20,786
12,3,2012,South West Trains,Transport,34,752
12,3,2012,Costa Coffee,Eating Out,2,750
12,3,2012,Greggs,Eating Out,6,744
13,3,2012,Starbucks Coffee,Eating Out,1,743
13,3,2012,The West Cornwall Pasty Company,Eating Out,6,737
13,3,2012,Paying back Julie,,2,735
14,3,2012,Caffe Nero,Eating Out,1,734
15,3,2012,BRGAS-Electricity,Bills,21,713
15,3,2012,BRGAS-Gas,Bills,26,687
15,3,2012,Costa Coffee,Eating Out,1,686
15,3,2012,Greggs,Eating Out,8,678
16,3,2012,LBS Council Tax,Bills,50,628
16,3,2012,Sainsburys,Groceries,80,548
16,3,2012,Wild Bean Cafe,Eating Out,1,547
16,3,2012,The West Cornwall Pasty Company,Eating Out,6,541
17,3,2012,Ministry of Sound ClubXOYO Club,Eating Out,10,531
17,3,2012,Ministry of Sound ClubXOYO Club,Eating Out,12,519
17,3,2012,Ministry of Sound ClubXOYO Club,Eating Out,9,510
17,3,2012,Anglo restaurant,Eating Out,52,458
18,3,2012,Dominos Pizza,Eating Out,27,431
18,3,2012,ATM Cash Withdrawal,General,10,421
19,3,2012,South West Trains,Transport,36,385
19,3,2012,Caffe Nero,Eating Out,2,383
19,3,2012,McDonalds,Eating Out,6,377
20,3,2012,VIRGIN MEDIA PYMTS,Bills,46,331
20,3,2012,Wild Bean Cafe,Eating Out,2,329
20,3,2012,ATM Cash Withdrawal,General,20,309
21,3,2012,Wild Bean Cafe,Eating Out,2,307
21,3,2012,ATM Cash Withdrawal,General,20,287
22,3,2012,Wild Bean Cafe,Eating Out,2,285
23,3,2012,ASDA,Groceries,60,225
23,3,2012,Costa Coffee,Eating Out,2,223
23,3,2012,Chicken Cottage,Eating Out,4,219
23,3,2012,Scott's Restaurant,Eating Out,45,174
24,3,2012,O2,Bills,38,136
24,3,2012,Restaurant Gordon RamsayPortland Restaurant,Eating Out,47,89
24,3,2012,ATM Cash Withdrawal,General,20,69
25,3,2012,Anglo restaurant,Eating Out,35,34
25,3,2012,ATM Cash Withdrawal,General,20,14
26,3,2012,South West Trains,Transport,32,-18
26,3,2012,Costa Coffee,Eating Out,2,-20
26,3,2012,McDonalds,Eating Out,6,-26
26,3,2012,ATM Cash Withdrawal,General,10,-36
27,3,2012,Caffe Nero,Eating Out,2,-38
28,3,2012,Costa Coffee,Eating Out,2,-40
28,3,2012,McDonalds,Eating Out,4,-44
28,3,2012,ATM Cash Withdrawal,General,10,-54
29,3,2012,Starbucks Coffee,Eating Out,2,-56
30,3,2012,Sainsburys,Groceries,70,-126
30,3,2012,Costa Coffee,Eating Out,1,-127
30,3,2012,Pret A Manger,Eating Out,7,-134
31,3,2012,Scott's Restaurant,Eating Out,54,-188
1,4,2012,Rhino Sports salary,General,1700,1512
2,4,2012,South West Trains,Transport,31,1481
2,4,2012,Wild Bean Cafe,Eating Out,1,1480
3,4,2012,Wild Bean Cafe,Eating Out,1,1479
3,4,2012,Greggs,Eating Out,6,1473
3,4,2012,Cheam Service Station,,4,1469
4,4,2012,ATM Cash Withdrawal,General,10,1459
4,4,2012,Cheam Service Station,,5,1454
5,4,2012,Caffe Nero,Eating Out,1,1453
5,4,2012,The West Cornwall Pasty Company,Eating Out,6,1447
6,4,2012,Waitrose,Groceries,82,1365
6,4,2012,Caffe Nero,Eating Out,2,1363
6,4,2012,Cheam Service Station,,1,1362
7,4,2012,Cubit and West rent,Rent,550,812
7,4,2012,Restaurant Gordon RamsayPortland Restaurant,Eating Out,47,765
8,4,2012,Pizza Express,Eating Out,51,714
8,4,2012,ATM Cash Withdrawal,General,10,704
9,4,2012,South West Trains,Transport,26,678
9,4,2012,Wild Bean Cafe,Eating Out,2,676
9,4,2012,Greggs,Eating Out,6,670
9,4,2012,Red Shop,,3,667
10,4,2012,Wild Bean Cafe,Eating Out,2,665
10,4,2012,Subway,Eating Out,7,658
11,4,2012,Caffe Nero,Eating Out,2,656
11,4,2012,Tool Tec,,1,655
12,4,2012,Subway,Eating Out,6,649
12,4,2012,ATM Cash Withdrawal,General,20,629
13,4,2012,Tescos,Groceries,77,552
13,4,2012,ATM Cash Withdrawal,General,10,542
14,4,2012,Heaven Club,Eating Out,16,526
14,4,2012,Heaven Club,Eating Out,14,512
14,4,2012,Heaven Club,Eating Out,13,499
14,4,2012,Heaven Club,Eating Out,13,486
14,4,2012,ATM Cash Withdrawal,General,10,476
15,4,2012,BRGAS-Electricity,Bills,43,433
15,4,2012,BRGAS-Gas,Bills,24,409
16,4,2012,LBS Council Tax,Bills,50,359
16,4,2012,South West Trains,Transport,31,328
16,4,2012,Caffe Nero,Eating Out,2,326
16,4,2012,ATM Cash Withdrawal,General,20,306
17,4,2012,Costa Coffee,Eating Out,2,304
17,4,2012,McDonalds,Eating Out,5,299
17,4,2012,ATM Cash Withdrawal,General,20,279
18,4,2012,Costa Coffee,Eating Out,1,278
18,4,2012,Greggs,Eating Out,8,270
18,4,2012,Paying back Julie,,8,262
19,4,2012,Caffe Nero,Eating Out,2,260
19,4,2012,Greggs,Eating Out,4,256
20,4,2012,VIRGIN MEDIA PYMTS,Bills,42,214
20,4,2012,Waitrose,Groceries,62,152
20,4,2012,Costa Coffee,Eating Out,2,150
20,4,2012,The West Cornwall Pasty Company,Eating Out,4,146
20,4,2012,Anglo restaurant,Eating Out,44,102
20,4,2012,ATM Cash Withdrawal,General,10,92
20,4,2012,Tool Tec,,5,87
21,4,2012,ATM Cash Withdrawal,General,10,77
22,4,2012,ATM Cash Withdrawal,General,20,57
23,4,2012,South West Trains,Transport,26,31
23,4,2012,Starbucks Coffee,Eating Out,2,29
23,4,2012,Cheam Service Station,,6,23
24,4,2012,O2,Bills,38,-15
24,4,2012,Wild Bean Cafe,Eating Out,2,-17
24,4,2012,The West Cornwall Pasty Company,Eating Out,7,-24
24,4,2012,Tool Tec,,6,-30
25,4,2012,Caffe Nero,Eating Out,2,-32
25,4,2012,Pret A Manger,Eating Out,5,-37
25,4,2012,ATM Cash Withdrawal,General,20,-57
26,4,2012,Wild Bean Cafe,Eating Out,1,-58
26,4,2012,Tool Tec,,8,-66
27,4,2012,Morrisons,Groceries,84,-150
27,4,2012,Starbucks Coffee,Eating Out,2,-152
27,4,2012,Chicken Cottage,Eating Out,4,-156
27,4,2012,ATM Cash Withdrawal,General,20,-176
28,4,2012,Pizza Express,Eating Out,35,-211
30,4,2012,South West Trains,Transport,27,-238
30,4,2012,Wild Bean Cafe,Eating Out,2,-240
30,4,2012,Subway,Eating Out,5,-245
1,5,2012,Rhino Sports salary,General,1700,1455
1,5,2012,Starbucks Coffee,Eating Out,2,1453
1,5,2012,Chicken Cottage,Eating Out,5,1448
2,5,2012,Starbucks Coffee,Eating Out,1,1447
2,5,2012,McDonalds,Eating Out,5,1442
2,5,2012,ATM Cash Withdrawal,General,20,1422
3,5,2012,Costa Coffee,Eating Out,1,1421
3,5,2012,ATM Cash Withdrawal,General,20,1401
3,5,2012,Paying back James,,5,1396
4,5,2012,Tescos,Groceries,72,1324
4,5,2012,Wild Bean Cafe,Eating Out,1,1323
4,5,2012,ATM Cash Withdrawal,General,20,1303
5,5,2012,ATM Cash Withdrawal,General,20,1283
6,5,2012,ATM Cash Withdrawal,General,20,1263
7,5,2012,Cubit and West rent,Rent,550,713
7,5,2012,South West Trains,Transport,38,675
7,5,2012,Starbucks Coffee,Eating Out,1,674
7,5,2012,The West Cornwall Pasty Company,Eating Out,4,670
7,5,2012,ATM Cash Withdrawal,General,10,660
8,5,2012,Costa Coffee,Eating Out,2,658
8,5,2012,Subway,Eating Out,6,652
10,5,2012,Caffe Nero,Eating Out,2,650
10,5,2012,Paying back James,,4,646
11,5,2012,Tescos,Groceries,76,570
11,5,2012,Caffe Nero,Eating Out,1,569
11,5,2012,The West Cornwall Pasty Company,Eating Out,8,561
12,5,2012,Anglo restaurant,Eating Out,48,513
13,5,2012,ATM Cash Withdrawal,General,10,503
14,5,2012,South West Trains,Transport,25,478
14,5,2012,McDonalds,Eating Out,7,471
15,5,2012,BRGAS-Electricity,Bills,24,447
15,5,2012,BRGAS-Gas,Bills,25,422
15,5,2012,Costa Coffee,Eating Out,1,421
15,5,2012,Subway,Eating Out,7,414
16,5,2012,LBS Council Tax,Bills,50,364
16,5,2012,Wild Bean Cafe,Eating Out,2,362
16,5,2012,Civic Shop,,4,358
17,5,2012,ATM Cash Withdrawal,General,20,338
17,5,2012,Cheam Service Station,,5,333
18,5,2012,Morrisons,Groceries,74,259
18,5,2012,Wild Bean Cafe,Eating Out,1,258
18,5,2012,McDonalds,Eating Out,8,250
18,5,2012,Restaurant Gordon RamsayPortland Restaurant,Eating Out,37,213
19,5,2012,ATM Cash Withdrawal,General,10,203
20,5,2012,VIRGIN MEDIA PYMTS,Bills,48,155
20,5,2012,Anglo restaurant,Eating Out,39,116
20,5,2012,Red Shop,,3,113
21,5,2012,South West Trains,Transport,27,86
21,5,2012,Starbucks Coffee,Eating Out,1,85
22,5,2012,Wild Bean Cafe,Eating Out,2,83
22,5,2012,The West Cornwall Pasty Company,Eating Out,5,78
22,5,2012,ATM Cash Withdrawal,General,10,68
23,5,2012,Wild Bean Cafe,Eating Out,1,67
23,5,2012,McDonalds,Eating Out,8,59
23,5,2012,ATM Cash Withdrawal,General,20,39
24,5,2012,O2,Bills,33,6
24,5,2012,Wild Bean Cafe,Eating Out,2,4
24,5,2012,ATM Cash Withdrawal,General,10,-6
25,5,2012,Sainsburys,Groceries,79,-85
25,5,2012,Costa Coffee,Eating Out,1,-86
26,5,2012,Scott's Restaurant,Eating Out,37,-123
26,5,2012,ATM Cash Withdrawal,General,20,-143
28,5,2012,South West Trains,Transport,36,-179
28,5,2012,Wild Bean Cafe,Eating Out,2,-181
29,5,2012,Costa Coffee,Eating Out,2,-183
30,5,2012,ATM Cash Withdrawal,General,10,-193
31,5,2012,Caffe Nero,Eating Out,2,-195
31,5,2012,Greggs,Eating Out,5,-200
1,6,2012,Rhino Sports salary,General,1700,1500
1,6,2012,Sainsburys,Groceries,46,1454
1,6,2012,Starbucks Coffee,Eating Out,1,1453
1,6,2012,Chicken Cottage,Eating Out,4,1449
1,6,2012,The Grand Pub,Eating Out,13,1436
1,6,2012,ATM Cash Withdrawal,General,20,1416
2,6,2012,Heaven Club,Eating Out,13,1403
2,6,2012,Heaven Club,Eating Out,16,1387
2,6,2012,Paying back Julie,,1,1386
4,6,2012,South West Trains,Transport,35,1351
4,6,2012,Pret A Manger,Eating Out,7,1344
6,6,2012,Greggs,Eating Out,7,1337
7,6,2012,Cubit and West rent,Rent,550,787
7,6,2012,The West Cornwall Pasty Company,Eating Out,4,783
8,6,2012,Waitrose,Groceries,67,716
8,6,2012,McDonalds,Eating Out,4,712
9,6,2012,Tool Shop,,6,706
11,6,2012,South West Trains,Transport,27,679
11,6,2012,Caffe Nero,Eating Out,1,678
11,6,2012,Subway,Eating Out,7,671
12,6,2012,McDonalds,Eating Out,7,664
13,6,2012,Chicken Cottage,Eating Out,8,656
13,6,2012,ATM Cash Withdrawal,General,10,646
14,6,2012,Starbucks Coffee,Eating Out,2,644
15,6,2012,BRGAS-Electricity,Bills,41,603
15,6,2012,BRGAS-Gas,Bills,41,562
15,6,2012,Tescos,Groceries,48,514
15,6,2012,Caffe Nero,Eating Out,1,513
15,6,2012,ATM Cash Withdrawal,General,20,493
16,6,2012,LBS Council Tax,Bills,50,443
18,6,2012,South West Trains,Transport,32,411
18,6,2012,Costa Coffee,Eating Out,2,409
18,6,2012,McDonalds,Eating Out,5,404
19,6,2012,Starbucks Coffee,Eating Out,2,402
19,6,2012,Greggs,Eating Out,8,394
20,6,2012,VIRGIN MEDIA PYMTS,Bills,28,366
20,6,2012,Wild Bean Cafe,Eating Out,2,364
20,6,2012,Greggs,Eating Out,5,359
21,6,2012,ATM Cash Withdrawal,General,10,349
22,6,2012,Morrisons,Groceries,62,287
22,6,2012,Caffe Nero,Eating Out,1,286
22,6,2012,Subway,Eating Out,6,280
22,6,2012,Ministry of Sound ClubXOYO Club,Eating Out,13,267
22,6,2012,Ministry of Sound ClubXOYO Club,Eating Out,10,257
22,6,2012,Ministry of Sound ClubXOYO Club,Eating Out,6,251
22,6,2012,Ministry of Sound ClubXOYO Club,Eating Out,14,237
23,6,2012,The Grand Pub,Eating Out,15,222
24,6,2012,O2,Bills,38,184
24,6,2012,Scott's Restaurant,Eating Out,36,148
25,6,2012,South West Trains,Transport,35,113
25,6,2012,Wild Bean Cafe,Eating Out,2,111
25,6,2012,Greggs,Eating Out,4,107
26,6,2012,Starbucks Coffee,Eating Out,2,105
26,6,2012,Chicken Cottage,Eating Out,8,97
26,6,2012,ATM Cash Withdrawal,General,10,87
28,6,2012,The West Cornwall Pasty Company,Eating Out,4,83
29,6,2012,Tescos,Groceries,69,14
29,6,2012,Wild Bean Cafe,Eating Out,2,12
29,6,2012,The Grand Pub,Eating Out,15,-3
29,6,2012,The Grand Pub,Eating Out,6,-9
29,6,2012,The Grand Pub,Eating Out,9,-18
29,6,2012,ATM Cash Withdrawal,General,10,-28
30,6,2012,Restaurant Gordon RamsayPortland Restaurant,Eating Out,43,-71
30,6,2012,Civic Shop,,4,-75
1,7,2012,Rhino Sports salary,General,1700,1625
1,7,2012,Dominos Pizza,Eating Out,52,1573
2,7,2012,South West Trains,Transport,32,1541
2,7,2012,Costa Coffee,Eating Out,2,1539
2,7,2012,Paying back James,,2,1537
3,7,2012,Wild Bean Cafe,Eating Out,1,1536
3,7,2012,The West Cornwall Pasty Company,Eating Out,8,1528
4,7,2012,Costa Coffee,Eating Out,1,1527
5,7,2012,Costa Coffee,Eating Out,2,1525
5,7,2012,The West Cornwall Pasty Company,Eating Out,5,1520
6,7,2012,Waitrose,Groceries,86,1434
6,7,2012,The West Cornwall Pasty Company,Eating Out,7,1427
7,7,2012,Cubit and West rent,Rent,550,877
7,7,2012,Scott's Restaurant,Eating Out,50,827
7,7,2012,ATM Cash Withdrawal,General,10,817
8,7,2012,Anglo restaurant,Eating Out,35,782
9,7,2012,South West Trains,Transport,26,756
9,7,2012,Caffe Nero,Eating Out,2,754
9,7,2012,ATM Cash Withdrawal,General,20,734
10,7,2012,Wild Bean Cafe,Eating Out,2,732
11,7,2012,Starbucks Coffee,Eating Out,2,730
11,7,2012,Pret A Manger,Eating Out,7,723
11,7,2012,ATM Cash Withdrawal,General,20,703
12,7,2012,Caffe Nero,Eating Out,2,701
13,7,2012,Waitrose,Groceries,60,641
13,7,2012,Caffe Nero,Eating Out,2,639
14,7,2012,ATM Cash Withdrawal,General,10,629
15,7,2012,BRGAS-Electricity,Bills,43,586
15,7,2012,BRGAS-Gas,Bills,26,560
15,7,2012,ATM Cash Withdrawal,General,10,550
16,7,2012,LBS Council Tax,Bills,50,500
16,7,2012,South West Trains,Transport,26,474
16,7,2012,Subway,Eating Out,7,467
16,7,2012,Paying back James,,2,465
17,7,2012,Chicken Cottage,Eating Out,5,460
17,7,2012,ATM Cash Withdrawal,General,20,440
19,7,2012,Starbucks Coffee,Eating Out,2,438
19,7,2012,Chicken Cottage,Eating Out,6,432
19,7,2012,ATM Cash Withdrawal,General,10,422
20,7,2012,VIRGIN MEDIA PYMTS,Bills,40,382
20,7,2012,Tescos,Groceries,74,308
20,7,2012,Caffe Nero,Eating Out,2,306
20,7,2012,ATM Cash Withdrawal,General,20,286
22,7,2012,Anglo restaurant,Eating Out,55,231
22,7,2012,Tool Shop,,3,228
23,7,2012,South West Trains,Transport,36,192
24,7,2012,O2,Bills,34,158
24,7,2012,Caffe Nero,Eating Out,1,157
25,7,2012,Starbucks Coffee,Eating Out,2,155
25,7,2012,The West Cornwall Pasty Company,Eating Out,4,151
26,7,2012,Chicken Cottage,Eating Out,5,146
27,7,2012,Waitrose,Groceries,54,92
27,7,2012,Starbucks Coffee,Eating Out,2,90
27,7,2012,Red Shop,,6,84
28,7,2012,Heaven Club,Eating Out,7,77
28,7,2012,Heaven Club,Eating Out,5,72
28,7,2012,Heaven Club,Eating Out,11,61
28,7,2012,Heaven Club,Eating Out,12,49
28,7,2012,Restaurant Gordon RamsayPortland Restaurant,Eating Out,35,14
30,7,2012,South West Trains,Transport,32,-18
30,7,2012,Caffe Nero,Eating Out,1,-19
30,7,2012,ATM Cash Withdrawal,General,20,-39
31,7,2012,Starbucks Coffee,Eating Out,1,-40
31,7,2012,Pret A Manger,Eating Out,7,-47
1,8,2012,Rhino Sports salary,General,1700,1653
2,8,2012,Wild Bean Cafe,Eating Out,2,1651
2,8,2012,ATM Cash Withdrawal,General,10,1641
3,8,2012,Waitrose,Groceries,54,1587
3,8,2012,Costa Coffee,Eating Out,2,1585
3,8,2012,Chicken Cottage,Eating Out,6,1579
4,8,2012,ATM Cash Withdrawal,General,10,1569
6,8,2012,South West Trains,Transport,24,1545
6,8,2012,Wild Bean Cafe,Eating Out,1,1544
7,8,2012,Cubit and West rent,Rent,550,994
7,8,2012,Costa Coffee,Eating Out,2,992
7,8,2012,Pret A Manger,Eating Out,7,985
8,8,2012,Costa Coffee,Eating Out,2,983
8,8,2012,Chicken Cottage,Eating Out,4,979
9,8,2012,Costa Coffee,Eating Out,2,977
9,8,2012,Pret A Manger,Eating Out,4,973
10,8,2012,Waitrose,Groceries,64,909
10,8,2012,Caffe Nero,Eating Out,1,908
10,8,2012,ATM Cash Withdrawal,General,20,888
12,8,2012,ATM Cash Withdrawal,General,20,868
12,8,2012,Tool Tec,,2,866
13,8,2012,South West Trains,Transport,29,837
13,8,2012,Costa Coffee,Eating Out,2,835
13,8,2012,Greggs,Eating Out,7,828
13,8,2012,ATM Cash Withdrawal,General,10,818
14,8,2012,Starbucks Coffee,Eating Out,1,817
14,8,2012,Greggs,Eating Out,8,809
15,8,2012,BRGAS-Electricity,Bills,41,768
15,8,2012,BRGAS-Gas,Bills,32,736
15,8,2012,Starbucks Coffee,Eating Out,2,734
15,8,2012,Greggs,Eating Out,7,727
16,8,2012,LBS Council Tax,Bills,50,677
16,8,2012,Starbucks Coffee,Eating Out,2,675
16,8,2012,ATM Cash Withdrawal,General,20,655
17,8,2012,Tescos,Groceries,62,593
18,8,2012,ATM Cash Withdrawal,General,20,573
18,8,2012,Paying back James,,7,566
19,8,2012,Restaurant Gordon RamsayPortland Restaurant,Eating Out,31,535
20,8,2012,VIRGIN MEDIA PYMTS,Bills,59,476
20,8,2012,South West Trains,Transport,30,446
20,8,2012,Starbucks Coffee,Eating Out,1,445
20,8,2012,McDonalds,Eating Out,4,441
21,8,2012,McDonalds,Eating Out,8,433
22,8,2012,Starbucks Coffee,Eating Out,2,431
22,8,2012,Greggs,Eating Out,6,425
23,8,2012,The West Cornwall Pasty Company,Eating Out,5,420
23,8,2012,ATM Cash Withdrawal,General,10,410
24,8,2012,O2,Bills,33,377
24,8,2012,Sainsburys,Groceries,80,297
24,8,2012,Caffe Nero,Eating Out,2,295
24,8,2012,Restaurant Gordon RamsayPortland Restaurant,Eating Out,47,248
25,8,2012,Dominos Pizza,Eating Out,59,189
27,8,2012,South West Trains,Transport,29,160
27,8,2012,Pret A Manger,Eating Out,8,152
28,8,2012,Pret A Manger,Eating Out,8,144
29,8,2012,Caffe Nero,Eating Out,1,143
29,8,2012,ATM Cash Withdrawal,General,10,133
30,8,2012,Costa Coffee,Eating Out,1,132
31,8,2012,Waitrose,Groceries,85,47
31,8,2012,Starbucks Coffee,Eating Out,1,46
1,9,2012,Rhino Sports salary,General,1700,1746
3,9,2012,South West Trains,Transport,35,1711
3,9,2012,Wild Bean Cafe,Eating Out,1,1710
3,9,2012,Chicken Cottage,Eating Out,7,1703
4,9,2012,Greggs,Eating Out,7,1696
5,9,2012,Caffe Nero,Eating Out,2,1694
6,9,2012,Wild Bean Cafe,Eating Out,2,1692
6,9,2012,Pret A Manger,Eating Out,5,1687
7,9,2012,Cubit and West rent,Rent,550,1137
7,9,2012,Tescos,Groceries,48,1089
7,9,2012,Starbucks Coffee,Eating Out,2,1087
7,9,2012,Scott's Restaurant,Eating Out,48,1039
7,9,2012,Cheam Service Station,,2,1037
10,9,2012,South West Trains,Transport,38,999
10,9,2012,Costa Coffee,Eating Out,2,997
10,9,2012,McDonalds,Eating Out,7,990
10,9,2012,ATM Cash Withdrawal,General,20,970
10,9,2012,Red Shop,,1,969
11,9,2012,Wild Bean Cafe,Eating Out,2,967
11,9,2012,The West Cornwall Pasty Company,Eating Out,4,963
11,9,2012,ATM Cash Withdrawal,General,10,953
12,9,2012,Costa Coffee,Eating Out,1,952
12,9,2012,Pret A Manger,Eating Out,7,945
14,9,2012,Sainsburys,Groceries,85,860
14,9,2012,Costa Coffee,Eating Out,1,859
14,9,2012,Pret A Manger,Eating Out,7,852
14,9,2012,Ministry of Sound ClubXOYO Club,Eating Out,14,838
14,9,2012,Ministry of Sound ClubXOYO Club,Eating Out,11,827
14,9,2012,Ministry of Sound ClubXOYO Club,Eating Out,5,822
14,9,2012,Ministry of Sound ClubXOYO Club,Eating Out,6,816
15,9,2012,BRGAS-Electricity,Bills,23,793
15,9,2012,BRGAS-Gas,Bills,29,764
15,9,2012,ATM Cash Withdrawal,General,20,744
16,9,2012,LBS Council Tax,Bills,50,694
16,9,2012,ATM Cash Withdrawal,General,20,674
17,9,2012,South West Trains,Transport,25,649
17,9,2012,Caffe Nero,Eating Out,2,647
17,9,2012,The West Cornwall Pasty Company,Eating Out,8,639
18,9,2012,Wild Bean Cafe,Eating Out,2,637
18,9,2012,Pret A Manger,Eating Out,7,630
19,9,2012,The West Cornwall Pasty Company,Eating Out,7,623
19,9,2012,ATM Cash Withdrawal,General,10,613
20,9,2012,VIRGIN MEDIA PYMTS,Bills,30,583
21,9,2012,ASDA,Groceries,76,507
21,9,2012,Costa Coffee,Eating Out,2,505
21,9,2012,Greggs,Eating Out,5,500
22,9,2012,Scott's Restaurant,Eating Out,25,475
23,9,2012,Scott's Restaurant,Eating Out,32,443
24,9,2012,O2,Bills,38,405
24,9,2012,South West Trains,Transport,26,379
24,9,2012,Caffe Nero,Eating Out,2,377
25,9,2012,Starbucks Coffee,Eating Out,2,375
25,9,2012,ATM Cash Withdrawal,General,10,365
25,9,2012,Civic Shop,,7,358
26,9,2012,Starbucks Coffee,Eating Out,2,356
27,9,2012,Starbucks Coffee,Eating Out,2,354
27,9,2012,ATM Cash Withdrawal,General,10,344
28,9,2012,Morrisons,Groceries,53,291
28,9,2012,Costa Coffee,Eating Out,2,289
28,9,2012,Subway,Eating Out,8,281
28,9,2012,Ministry of Sound ClubXOYO Club,Eating Out,9,272
28,9,2012,Ministry of Sound ClubXOYO Club,Eating Out,15,257
28,9,2012,Ministry of Sound ClubXOYO Club,Eating Out,5,252
28,9,2012,Ministry of Sound ClubXOYO Club,Eating Out,13,239
28,9,2012,Ministry of Sound ClubXOYO Club,Eating Out,12,227
29,9,2012,The Grand Pub,Eating Out,12,215
29,9,2012,The Grand Pub,Eating Out,7,208
29,9,2012,The Grand Pub,Eating Out,15,193
29,9,2012,The Grand Pub,Eating Out,7,186
29,9,2012,The Grand Pub,Eating Out,7,179
1,10,2012,Rhino Sports salary,General,1700,1879
1,10,2012,South West Trains,Transport,34,1845
1,10,2012,Costa Coffee,Eating Out,1,1844
1,10,2012,The West Cornwall Pasty Company,Eating Out,5,1839
2,10,2012,Costa Coffee,Eating Out,2,1837
2,10,2012,Greggs,Eating Out,6,1831
3,10,2012,Pret A Manger,Eating Out,7,1824
4,10,2012,Wild Bean Cafe,Eating Out,2,1822
4,10,2012,Greggs,Eating Out,4,1818
5,10,2012,Waitrose,Groceries,65,1753
5,10,2012,Costa Coffee,Eating Out,1,1752
5,10,2012,Subway,Eating Out,4,1748
5,10,2012,ATM Cash Withdrawal,General,20,1728
6,10,2012,Red Shop,,3,1725
7,10,2012,Cubit and West rent,Rent,550,1175
8,10,2012,South West Trains,Transport,37,1138
8,10,2012,The West Cornwall Pasty Company,Eating Out,5,1133
8,10,2012,ATM Cash Withdrawal,General,10,1123
9,10,2012,Wild Bean Cafe,Eating Out,2,1121
9,10,2012,Pret A Manger,Eating Out,4,1117
10,10,2012,Wild Bean Cafe,Eating Out,2,1115
11,10,2012,Starbucks Coffee,Eating Out,1,1114
12,10,2012,Tescos,Groceries,66,1048
12,10,2012,ATM Cash Withdrawal,General,10,1038
13,10,2012,Paying back James,,4,1034
15,10,2012,BRGAS-Electricity,Bills,43,991
15,10,2012,BRGAS-Gas,Bills,31,960
15,10,2012,South West Trains,Transport,28,932
15,10,2012,Wild Bean Cafe,Eating Out,1,931
15,10,2012,ATM Cash Withdrawal,General,20,911
16,10,2012,LBS Council Tax,Bills,50,861
16,10,2012,Wild Bean Cafe,Eating Out,1,860
16,10,2012,Greggs,Eating Out,8,852
16,10,2012,ATM Cash Withdrawal,General,10,842
16,10,2012,Red Shop,,3,839
17,10,2012,Caffe Nero,Eating Out,2,837
17,10,2012,Paying back Julie,,6,831
18,10,2012,Chicken Cottage,Eating Out,7,824
18,10,2012,ATM Cash Withdrawal,General,20,804
19,10,2012,Tescos,Groceries,42,762
19,10,2012,Starbucks Coffee,Eating Out,2,760
19,10,2012,Chicken Cottage,Eating Out,6,754
19,10,2012,Paying back Julie,,7,747
20,10,2012,VIRGIN MEDIA PYMTS,Bills,51,696
21,10,2012,Anglo restaurant,Eating Out,28,668
21,10,2012,ATM Cash Withdrawal,General,10,658
22,10,2012,South West Trains,Transport,27,631
22,10,2012,Wild Bean Cafe,Eating Out,2,629
23,10,2012,Costa Coffee,Eating Out,2,627
23,10,2012,McDonalds,Eating Out,7,620
23,10,2012,ATM Cash Withdrawal,General,10,610
24,10,2012,O2,Bills,37,573
24,10,2012,ATM Cash Withdrawal,General,20,553
25,10,2012,Caffe Nero,Eating Out,1,552
25,10,2012,Chicken Cottage,Eating Out,6,546
25,10,2012,Tool Tec,,4,542
26,10,2012,ASDA,Groceries,78,464
26,10,2012,Wild Bean Cafe,Eating Out,2,462
27,10,2012,Restaurant Gordon RamsayPortland Restaurant,Eating Out,38,424
29,10,2012,South West Trains,Transport,31,393
29,10,2012,Costa Coffee,Eating Out,1,392
29,10,2012,Subway,Eating Out,5,387
29,10,2012,ATM Cash Withdrawal,General,10,377
30,10,2012,Wild Bean Cafe,Eating Out,1,376
30,10,2012,Pret A Manger,Eating Out,8,368
31,10,2012,Starbucks Coffee,Eating Out,2,366
31,10,2012,The West Cornwall Pasty Company,Eating Out,7,359
1,11,2012,Rhino Sports salary,General,1700,2059
1,11,2012,Starbucks Coffee,Eating Out,2,2057
1,11,2012,Subway,Eating Out,6,2051
2,11,2012,Waitrose,Groceries,70,1981
3,11,2012,Pizza Express,Eating Out,41,1940
5,11,2012,South West Trains,Transport,33,1907
6,11,2012,Chicken Cottage,Eating Out,7,1900
7,11,2012,Cubit and West rent,Rent,550,1350
7,11,2012,Starbucks Coffee,Eating Out,2,1348
8,11,2012,Costa Coffee,Eating Out,2,1346
8,11,2012,Greggs,Eating Out,8,1338
9,11,2012,ASDA,Groceries,81,1257
9,11,2012,Starbucks Coffee,Eating Out,2,1255
10,11,2012,Dominos Pizza,Eating Out,53,1202
10,11,2012,ATM Cash Withdrawal,General,10,1192
12,11,2012,South West Trains,Transport,33,1159
12,11,2012,Caffe Nero,Eating Out,2,1157
13,11,2012,Caffe Nero,Eating Out,2,1155
13,11,2012,Subway,Eating Out,8,1147
14,11,2012,Caffe Nero,Eating Out,2,1145
14,11,2012,Chicken Cottage,Eating Out,6,1139
15,11,2012,BRGAS-Electricity,Bills,56,1083
15,11,2012,BRGAS-Gas,Bills,79,1004
15,11,2012,Starbucks Coffee,Eating Out,1,1003
15,11,2012,The West Cornwall Pasty Company,Eating Out,6,997
16,11,2012,LBS Council Tax,Bills,50,947
16,11,2012,Waitrose,Groceries,61,886
16,11,2012,Greggs,Eating Out,7,879
17,11,2012,Restaurant Gordon RamsayPortland Restaurant,Eating Out,46,833
18,11,2012,Anglo restaurant,Eating Out,36,797
19,11,2012,South West Trains,Transport,33,764
19,11,2012,Pret A Manger,Eating Out,7,757
19,11,2012,ATM Cash Withdrawal,General,10,747
20,11,2012,VIRGIN MEDIA PYMTS,Bills,55,692
20,11,2012,Caffe Nero,Eating Out,2,690
20,11,2012,McDonalds,Eating Out,6,684
21,11,2012,Costa Coffee,Eating Out,1,683
21,11,2012,ATM Cash Withdrawal,General,20,663
21,11,2012,Cheam Service Station,,3,660
22,11,2012,Chicken Cottage,Eating Out,8,652
23,11,2012,Tescos,Groceries,66,586
23,11,2012,Caffe Nero,Eating Out,2,584
23,11,2012,Ministry of Sound ClubXOYO Club,Eating Out,7,577
23,11,2012,Ministry of Sound ClubXOYO Club,Eating Out,13,564
23,11,2012,Ministry of Sound ClubXOYO Club,Eating Out,7,557
24,11,2012,O2,Bills,35,522
24,11,2012,Ministry of Sound ClubXOYO Club,Eating Out,15,507
24,11,2012,ATM Cash Withdrawal,General,20,487
26,11,2012,South West Trains,Transport,38,449
26,11,2012,Starbucks Coffee,Eating Out,2,447
26,11,2012,Pret A Manger,Eating Out,6,441
27,11,2012,Wild Bean Cafe,Eating Out,2,439
27,11,2012,The West Cornwall Pasty Company,Eating Out,5,434
27,11,2012,ATM Cash Withdrawal,General,20,414
27,11,2012,Cheam Service Station,,6,408
28,11,2012,Subway,Eating Out,8,400
29,11,2012,Caffe Nero,Eating Out,2,398
29,11,2012,Greggs,Eating Out,5,393
29,11,2012,ATM Cash Withdrawal,General,20,373
30,11,2012,Morrisons,Groceries,67,306
30,11,2012,The West Cornwall Pasty Company,Eating Out,6,300
30,11,2012,Pizza Express,Eating Out,34,266
1,12,2012,Rhino Sports salary,General,1700,1966
1,12,2012,The Grand Pub,Eating Out,9,1957
1,12,2012,Pizza Express,Eating Out,53,1904
2,12,2012,Restaurant Gordon RamsayPortland Restaurant,Eating Out,49,1855
3,12,2012,South West Trains,Transport,35,1820
3,12,2012,Wild Bean Cafe,Eating Out,1,1819
3,12,2012,Subway,Eating Out,8,1811
4,12,2012,Costa Coffee,Eating Out,2,1809
4,12,2012,Subway,Eating Out,7,1802
5,12,2012,Starbucks Coffee,Eating Out,1,1801
5,12,2012,ATM Cash Withdrawal,General,20,1781
6,12,2012,Chicken Cottage,Eating Out,6,1775
7,12,2012,Cubit and West rent,Rent,550,1225
7,12,2012,ASDA,Groceries,70,1155
7,12,2012,Wild Bean Cafe,Eating Out,1,1154
8,12,2012,Dominos Pizza,Eating Out,30,1124
9,12,2012,ATM Cash Withdrawal,General,10,1114
10,12,2012,South West Trains,Transport,28,1086
10,12,2012,McDonalds,Eating Out,5,1081
11,12,2012,Caffe Nero,Eating Out,2,1079
11,12,2012,Chicken Cottage,Eating Out,4,1075
11,12,2012,ATM Cash Withdrawal,General,10,1065
12,12,2012,Pret A Manger,Eating Out,8,1057
12,12,2012,ATM Cash Withdrawal,General,10,1047
13,12,2012,Costa Coffee,Eating Out,2,1045
13,12,2012,Chicken Cottage,Eating Out,5,1040
13,12,2012,ATM Cash Withdrawal,General,10,1030
14,12,2012,Tescos,Groceries,75,955
14,12,2012,Chicken Cottage,Eating Out,5,950
15,12,2012,BRGAS-Electricity,Bills,36,914
15,12,2012,BRGAS-Gas,Bills,37,877
16,12,2012,LBS Council Tax,Bills,50,827
17,12,2012,South West Trains,Transport,37,790
17,12,2012,ATM Cash Withdrawal,General,20,770
18,12,2012,Starbucks Coffee,Eating Out,2,768
18,12,2012,Chicken Cottage,Eating Out,6,762
18,12,2012,ATM Cash Withdrawal,General,10,752
20,12,2012,VIRGIN MEDIA PYMTS,Bills,53,699
20,12,2012,Greggs,Eating Out,8,691
21,12,2012,Morrisons,Groceries,87,604
21,12,2012,Caffe Nero,Eating Out,2,602
21,12,2012,Pizza Express,Eating Out,26,576
23,12,2012,Pizza Express,Eating Out,24,552
23,12,2012,ATM Cash Withdrawal,General,20,532
24,12,2012,O2,Bills,30,502
24,12,2012,South West Trains,Transport,25,477
24,12,2012,Wild Bean Cafe,Eating Out,1,476
25,12,2012,Starbucks Coffee,Eating Out,1,475
26,12,2012,Costa Coffee,Eating Out,1,474
26,12,2012,McDonalds,Eating Out,7,467
27,12,2012,Costa Coffee,Eating Out,2,465
27,12,2012,Subway,Eating Out,7,458
28,12,2012,ASDA,Groceries,84,374
28,12,2012,Costa Coffee,Eating Out,2,372
28,12,2012,Pret A Manger,Eating Out,6,366
28,12,2012,Scott's Restaurant,Eating Out,46,320
29,12,2012,Restaurant Gordon RamsayPortland Restaurant,Eating Out,30,290
29,12,2012,Tool Shop,,9,281
31,12,2012,South West Trains,Transport,32,249
31,12,2012,Caffe Nero,Eating Out,2,247
31,12,2012,Paying back James,,1,246
1,1,2013,Rhino Sports salary,General,1700,1946
1,1,2013,Caffe Nero,Eating Out,2,1944
2,1,2013,Costa Coffee,Eating Out,1,1943
2,1,2013,McDonalds,Eating Out,8,1935
3,1,2013,Wild Bean Cafe,Eating Out,2,1933
3,1,2013,Greggs,Eating Out,8,1925
3,1,2013,ATM Cash Withdrawal,General,20,1905
4,1,2013,Morrisons,Groceries,74,1831
4,1,2013,Costa Coffee,Eating Out,2,1829
4,1,2013,Pret A Manger,Eating Out,8,1821
4,1,2013,Heaven Club,Eating Out,12,1809
4,1,2013,Heaven Club,Eating Out,8,1801
4,1,2013,Heaven Club,Eating Out,10,1791
4,1,2013,ATM Cash Withdrawal,General,20,1771
5,1,2013,Restaurant Gordon RamsayPortland Restaurant,Eating Out,36,1735
6,1,2013,Dominos Pizza,Eating Out,33,1702
7,1,2013,Cubit and West rent,Rent,550,1152
7,1,2013,South West Trains,Transport,38,1114
7,1,2013,Wild Bean Cafe,Eating Out,2,1112
7,1,2013,Pret A Manger,Eating Out,8,1104
8,1,2013,Starbucks Coffee,Eating Out,1,1103
9,1,2013,Costa Coffee,Eating Out,1,1102
9,1,2013,Chicken Cottage,Eating Out,6,1096
10,1,2013,Starbucks Coffee,Eating Out,2,1094
10,1,2013,Chicken Cottage,Eating Out,5,1089
11,1,2013,ASDA,Groceries,72,1017
11,1,2013,Caffe Nero,Eating Out,1,1016
11,1,2013,Pizza Express,Eating Out,34,982
11,1,2013,Paying back James,,4,978
12,1,2013,ATM Cash Withdrawal,General,20,958
14,1,2013,South West Trains,Transport,35,923
14,1,2013,Costa Coffee,Eating Out,1,922
15,1,2013,BRGAS-Electricity,Bills,38,884
15,1,2013,BRGAS-Gas,Bills,80,804
15,1,2013,Starbucks Coffee,Eating Out,1,803
15,1,2013,Paying back James,,2,801
16,1,2013,LBS Council Tax,Bills,50,751
16,1,2013,Wild Bean Cafe,Eating Out,2,749
16,1,2013,Greggs,Eating Out,6,743
17,1,2013,Costa Coffee,Eating Out,1,742
18,1,2013,Sainsburys,Groceries,54,688
18,1,2013,Chicken Cottage,Eating Out,6,682
18,1,2013,Anglo restaurant,Eating Out,56,626
20,1,2013,VIRGIN MEDIA PYMTS,Bills,48,578
20,1,2013,Anglo restaurant,Eating Out,50,528
21,1,2013,South West Trains,Transport,36,492
21,1,2013,Starbucks Coffee,Eating Out,1,491
21,1,2013,Subway,Eating Out,6,485
21,1,2013,Tool Shop,,9,476
22,1,2013,Caffe Nero,Eating Out,1,475
23,1,2013,McDonalds,Eating Out,8,467
23,1,2013,ATM Cash Withdrawal,General,10,457
24,1,2013,O2,Bills,38,419
24,1,2013,Starbucks Coffee,Eating Out,1,418
24,1,2013,Greggs,Eating Out,4,414
24,1,2013,ATM Cash Withdrawal,General,20,394
25,1,2013,Waitrose,Groceries,88,306
25,1,2013,Dominos Pizza,Eating Out,42,264
26,1,2013,ATM Cash Withdrawal,General,10,254
27,1,2013,ATM Cash Withdrawal,General,10,244
27,1,2013,Red Shop,,8,236
28,1,2013,South West Trains,Transport,35,201
28,1,2013,Wild Bean Cafe,Eating Out,1,200
28,1,2013,Greggs,Eating Out,8,192
29,1,2013,Wild Bean Cafe,Eating Out,1,191
30,1,2013,Costa Coffee,Eating Out,2,189
31,1,2013,Wild Bean Cafe,Eating Out,2,187
31,1,2013,Subway,Eating Out,6,181
1,2,2013,Rhino Sports salary,General,1700,1881
1,2,2013,Morrisons,Groceries,73,1808
1,2,2013,ATM Cash Withdrawal,General,10,1798
3,2,2013,ATM Cash Withdrawal,General,10,1788
4,2,2013,South West Trains,Transport,37,1751
4,2,2013,Costa Coffee,Eating Out,2,1749
4,2,2013,ATM Cash Withdrawal,General,10,1739
5,2,2013,Costa Coffee,Eating Out,2,1737
5,2,2013,McDonalds,Eating Out,6,1731
6,2,2013,Civic Shop,,1,1730
7,2,2013,Cubit and West rent,Rent,550,1180
7,2,2013,Costa Coffee,Eating Out,2,1178
7,2,2013,Pret A Manger,Eating Out,8,1170
8,2,2013,Tescos,Groceries,77,1093
8,2,2013,Scott's Restaurant,Eating Out,56,1037
8,2,2013,Red Shop,,7,1030
9,2,2013,Scott's Restaurant,Eating Out,58,972
9,2,2013,ATM Cash Withdrawal,General,10,962
11,2,2013,South West Trains,Transport,36,926
11,2,2013,Costa Coffee,Eating Out,2,924
11,2,2013,McDonalds,Eating Out,6,918
13,2,2013,Wild Bean Cafe,Eating Out,1,917
13,2,2013,Chicken Cottage,Eating Out,8,909
14,2,2013,Starbucks Coffee,Eating Out,2,907
15,2,2013,BRGAS-Electricity,Bills,30,877
15,2,2013,BRGAS-Gas,Bills,32,845
15,2,2013,Morrisons,Groceries,56,789
15,2,2013,Wild Bean Cafe,Eating Out,2,787
15,2,2013,Chicken Cottage,Eating Out,7,780
15,2,2013,Dominos Pizza,Eating Out,54,726
16,2,2013,LBS Council Tax,Bills,50,676
17,2,2013,Pizza Express,Eating Out,36,640
18,2,2013,South West Trains,Transport,27,613
18,2,2013,Wild Bean Cafe,Eating Out,1,612
19,2,2013,Costa Coffee,Eating Out,2,610
19,2,2013,ATM Cash Withdrawal,General,20,590
19,2,2013,Tool Shop,,2,588
20,2,2013,VIRGIN MEDIA PYMTS,Bills,58,530
20,2,2013,Caffe Nero,Eating Out,2,528
21,2,2013,Starbucks Coffee,Eating Out,2,526
21,2,2013,Chicken Cottage,Eating Out,8,518
22,2,2013,Morrisons,Groceries,57,461
22,2,2013,Wild Bean Cafe,Eating Out,1,460
24,2,2013,O2,Bills,37,423
25,2,2013,South West Trains,Transport,27,396
25,2,2013,Costa Coffee,Eating Out,2,394
25,2,2013,McDonalds,Eating Out,7,387
25,2,2013,ATM Cash Withdrawal,General,10,377
26,2,2013,Subway,Eating Out,5,372
27,2,2013,Caffe Nero,Eating Out,2,370
28,2,2013,Pret A Manger,Eating Out,4,366
28,2,2013,ATM Cash Withdrawal,General,20,346
28,2,2013,Cheam Service Station,,4,342
1,3,2013,Rhino Sports salary,General,1700,2042
1,3,2013,ASDA,Groceries,75,1967
1,3,2013,Tool Tec,,1,1966
4,3,2013,South West Trains,Transport,29,1937
4,3,2013,Costa Coffee,Eating Out,2,1935
5,3,2013,Starbucks Coffee,Eating Out,2,1933
5,3,2013,McDonalds,Eating Out,5,1928
5,3,2013,ATM Cash Withdrawal,General,10,1918
5,3,2013,Tool Shop,,4,1914
6,3,2013,Caffe Nero,Eating Out,1,1913
6,3,2013,Subway,Eating Out,8,1905
6,3,2013,ATM Cash Withdrawal,General,10,1895
7,3,2013,Cubit and West rent,Rent,550,1345
7,3,2013,Caffe Nero,Eating Out,2,1343
7,3,2013,McDonalds,Eating Out,4,1339
8,3,2013,Waitrose,Groceries,76,1263
8,3,2013,Starbucks Coffee,Eating Out,2,1261
8,3,2013,Scott's Restaurant,Eating Out,27,1234
9,3,2013,Civic Shop,,7,1227
10,3,2013,Anglo restaurant,Eating Out,58,1169
10,3,2013,Paying back James,,7,1162
11,3,2013,South West Trains,Transport,29,1133
11,3,2013,Costa Coffee,Eating Out,1,1132
11,3,2013,Pret A Manger,Eating Out,4,1128
12,3,2013,Costa Coffee,Eating Out,2,1126
12,3,2013,Pret A Manger,Eating Out,7,1119
12,3,2013,ATM Cash Withdrawal,General,20,1099
13,3,2013,Wild Bean Cafe,Eating Out,2,1097
13,3,2013,Greggs,Eating Out,5,1092
13,3,2013,ATM Cash Withdrawal,General,20,1072
14,3,2013,Costa Coffee,Eating Out,2,1070
14,3,2013,Greggs,Eating Out,4,1066
14,3,2013,Red Shop,,1,1065
15,3,2013,BRGAS-Electricity,Bills,42,1023
15,3,2013,BRGAS-Gas,Bills,23,1000
15,3,2013,Waitrose,Groceries,87,913
15,3,2013,Starbucks Coffee,Eating Out,2,911
15,3,2013,Greggs,Eating Out,5,906
15,3,2013,ATM Cash Withdrawal,General,10,896
16,3,2013,LBS Council Tax,Bills,50,846
16,3,2013,Fabric Club,Eating Out,16,830
16,3,2013,Fabric Club,Eating Out,13,817
16,3,2013,Fabric Club,Eating Out,8,809
16,3,2013,Fabric Club,Eating Out,10,799
16,3,2013,Fabric Club,Eating Out,8,791
18,3,2013,South West Trains,Transport,28,763
18,3,2013,Costa Coffee,Eating Out,2,761
18,3,2013,Greggs,Eating Out,4,757
19,3,2013,Costa Coffee,Eating Out,2,755
19,3,2013,ATM Cash Withdrawal,General,20,735
20,3,2013,VIRGIN MEDIA PYMTS,Bills,43,692
20,3,2013,Starbucks Coffee,Eating Out,2,690
20,3,2013,McDonalds,Eating Out,6,684
21,3,2013,Starbucks Coffee,Eating Out,1,683
21,3,2013,Chicken Cottage,Eating Out,8,675
22,3,2013,ASDA,Groceries,88,587
22,3,2013,Starbucks Coffee,Eating Out,2,585
22,3,2013,Chicken Cottage,Eating Out,5,580
22,3,2013,Scott's Restaurant,Eating Out,55,525
23,3,2013,ATM Cash Withdrawal,General,10,515
24,3,2013,O2,Bills,32,483
24,3,2013,Restaurant Gordon RamsayPortland Restaurant,Eating Out,49,434
25,3,2013,South West Trains,Transport,27,407
25,3,2013,Starbucks Coffee,Eating Out,2,405
25,3,2013,Greggs,Eating Out,4,401
25,3,2013,ATM Cash Withdrawal,General,10,391
26,3,2013,Costa Coffee,Eating Out,2,389
26,3,2013,Chicken Cottage,Eating Out,5,384
26,3,2013,ATM Cash Withdrawal,General,10,374
27,3,2013,Starbucks Coffee,Eating Out,2,372
27,3,2013,Pret A Manger,Eating Out,8,364
27,3,2013,ATM Cash Withdrawal,General,10,354
28,3,2013,Wild Bean Cafe,Eating Out,2,352
28,3,2013,Tool Tec,,9,343
29,3,2013,Morrisons,Groceries,85,258
29,3,2013,Wild Bean Cafe,Eating Out,1,257
29,3,2013,Greggs,Eating Out,6,251
29,3,2013,Anglo restaurant,Eating Out,24,227
30,3,2013,The Grand Pub,Eating Out,11,216
30,3,2013,The Grand Pub,Eating Out,7,209
30,3,2013,The Grand Pub,Eating Out,14,195
30,3,2013,The Grand Pub,Eating Out,10,185
30,3,2013,The Grand Pub,Eating Out,16,169
30,3,2013,The Grand Pub,Eating Out,13,156
31,3,2013,Dominos Pizza,Eating Out,33,123
31,3,2013,ATM Cash Withdrawal,General,10,113
1,4,2013,Rhino Sports salary,General,1700,1813
1,4,2013,South West Trains,Transport,31,1782
1,4,2013,Caffe Nero,Eating Out,2,1780
1,4,2013,Chicken Cottage,Eating Out,8,1772
2,4,2013,McDonalds,Eating Out,7,1765
3,4,2013,Chicken Cottage,Eating Out,6,1759
4,4,2013,Caffe Nero,Eating Out,2,1757
5,4,2013,Sainsburys,Groceries,79,1678
5,4,2013,Caffe Nero,Eating Out,2,1676
7,4,2013,Cubit and West rent,Rent,550,1126
8,4,2013,South West Trains,Transport,24,1102
8,4,2013,Caffe Nero,Eating Out,2,1100
8,4,2013,Pret A Manger,Eating Out,7,1093
9,4,2013,Chicken Cottage,Eating Out,4,1089
10,4,2013,Costa Coffee,Eating Out,2,1087
10,4,2013,Pret A Manger,Eating Out,6,1081
10,4,2013,ATM Cash Withdrawal,General,20,1061
11,4,2013,ATM Cash Withdrawal,General,20,1041
12,4,2013,Waitrose,Groceries,71,970
12,4,2013,Caffe Nero,Eating Out,2,968
12,4,2013,McDonalds,Eating Out,5,963
14,4,2013,Pizza Express,Eating Out,45,918
14,4,2013,ATM Cash Withdrawal,General,20,898
15,4,2013,BRGAS-Electricity,Bills,31,867
15,4,2013,BRGAS-Gas,Bills,42,825
15,4,2013,South West Trains,Transport,31,794
15,4,2013,Costa Coffee,Eating Out,2,792
15,4,2013,Chicken Cottage,Eating Out,8,784
16,4,2013,LBS Council Tax,Bills,50,734
16,4,2013,Starbucks Coffee,Eating Out,2,732
16,4,2013,Chicken Cottage,Eating Out,5,727
17,4,2013,Caffe Nero,Eating Out,2,725
18,4,2013,Costa Coffee,Eating Out,2,723
18,4,2013,The West Cornwall Pasty Company,Eating Out,7,716
18,4,2013,ATM Cash Withdrawal,General,20,696
19,4,2013,Tescos,Groceries,68,628
19,4,2013,Costa Coffee,Eating Out,2,626
19,4,2013,McDonalds,Eating Out,7,619
19,4,2013,ATM Cash Withdrawal,General,10,609
20,4,2013,VIRGIN MEDIA PYMTS,Bills,42,567
20,4,2013,Scott's Restaurant,Eating Out,37,530
21,4,2013,ATM Cash Withdrawal,General,20,510
22,4,2013,South West Trains,Transport,25,485
22,4,2013,Caffe Nero,Eating Out,2,483
23,4,2013,Wild Bean Cafe,Eating Out,1,482
23,4,2013,Greggs,Eating Out,6,476
23,4,2013,Tool Shop,,3,473
24,4,2013,O2,Bills,33,440
24,4,2013,Wild Bean Cafe,Eating Out,1,439
24,4,2013,Pret A Manger,Eating Out,4,435
25,4,2013,The West Cornwall Pasty Company,Eating Out,5,430
26,4,2013,Morrisons,Groceries,60,370
26,4,2013,Costa Coffee,Eating Out,1,369
26,4,2013,The West Cornwall Pasty Company,Eating Out,5,364
26,4,2013,Dominos Pizza,Eating Out,57,307
26,4,2013,ATM Cash Withdrawal,General,20,287
26,4,2013,Red Shop,,4,283
27,4,2013,Ministry of Sound ClubXOYO Club,Eating Out,9,274
27,4,2013,Anglo restaurant,Eating Out,37,237
29,4,2013,South West Trains,Transport,24,213
29,4,2013,ATM Cash Withdrawal,General,20,193
30,4,2013,The West Cornwall Pasty Company,Eating Out,4,189
30,4,2013,ATM Cash Withdrawal,General,20,169
30,4,2013,Red Shop,,5,164
1,5,2013,Rhino Sports salary,General,1700,1864
1,5,2013,Subway,Eating Out,5,1859
1,5,2013,ATM Cash Withdrawal,General,10,1849
2,5,2013,Wild Bean Cafe,Eating Out,2,1847
2,5,2013,McDonalds,Eating Out,7,1840
3,5,2013,Waitrose,Groceries,69,1771
6,5,2013,South West Trains,Transport,29,1742
6,5,2013,Starbucks Coffee,Eating Out,2,1740
6,5,2013,McDonalds,Eating Out,6,1734
7,5,2013,Cubit and West rent,Rent,550,1184
7,5,2013,Wild Bean Cafe,Eating Out,2,1182
7,5,2013,ATM Cash Withdrawal,General,10,1172
8,5,2013,Wild Bean Cafe,Eating Out,1,1171
8,5,2013,Greggs,Eating Out,5,1166
9,5,2013,The West Cornwall Pasty Company,Eating Out,4,1162
9,5,2013,ATM Cash Withdrawal,General,20,1142
10,5,2013,ASDA,Groceries,51,1091
10,5,2013,Pret A Manger,Eating Out,6,1085
10,5,2013,The Grand Pub,Eating Out,8,1077
10,5,2013,The Grand Pub,Eating Out,5,1072
10,5,2013,The Grand Pub,Eating Out,7,1065
10,5,2013,ATM Cash Withdrawal,General,10,1055
11,5,2013,Dominos Pizza,Eating Out,52,1003
13,5,2013,South West Trains,Transport,32,971
13,5,2013,Costa Coffee,Eating Out,1,970
13,5,2013,Civic Shop,,8,962
15,5,2013,BRGAS-Electricity,Bills,40,922
15,5,2013,BRGAS-Gas,Bills,40,882
15,5,2013,Costa Coffee,Eating Out,2,880
15,5,2013,McDonalds,Eating Out,7,873
16,5,2013,LBS Council Tax,Bills,50,823
16,5,2013,Wild Bean Cafe,Eating Out,2,821
16,5,2013,The West Cornwall Pasty Company,Eating Out,8,813
16,5,2013,ATM Cash Withdrawal,General,20,793
17,5,2013,Morrisons,Groceries,74,719
17,5,2013,The West Cornwall Pasty Company,Eating Out,8,711
17,5,2013,ATM Cash Withdrawal,General,10,701
17,5,2013,Paying back Julie,,4,697
19,5,2013,ATM Cash Withdrawal,General,20,677
20,5,2013,VIRGIN MEDIA PYMTS,Bills,41,636
20,5,2013,South West Trains,Transport,28,608
20,5,2013,Caffe Nero,Eating Out,1,607
20,5,2013,McDonalds,Eating Out,6,601
20,5,2013,ATM Cash Withdrawal,General,20,581
20,5,2013,Cheam Service Station,,8,573
21,5,2013,Caffe Nero,Eating Out,2,571
21,5,2013,McDonalds,Eating Out,6,565
21,5,2013,Tool Shop,,9,556
23,5,2013,Starbucks Coffee,Eating Out,2,554
23,5,2013,Pret A Manger,Eating Out,6,548
23,5,2013,ATM Cash Withdrawal,General,20,528
24,5,2013,O2,Bills,36,492
24,5,2013,Waitrose,Groceries,88,404
24,5,2013,Wild Bean Cafe,Eating Out,2,402
24,5,2013,Anglo restaurant,Eating Out,48,354
26,5,2013,ATM Cash Withdrawal,General,10,344
26,5,2013,Tool Shop,,4,340
27,5,2013,South West Trains,Transport,37,303
27,5,2013,Caffe Nero,Eating Out,1,302
27,5,2013,Greggs,Eating Out,4,298
28,5,2013,Costa Coffee,Eating Out,2,296
28,5,2013,Cheam Service Station,,9,287
29,5,2013,Starbucks Coffee,Eating Out,1,286
29,5,2013,McDonalds,Eating Out,5,281
30,5,2013,Costa Coffee,Eating Out,2,279
30,5,2013,Civic Shop,,8,271
31,5,2013,Sainsburys,Groceries,89,182
31,5,2013,Wild Bean Cafe,Eating Out,1,181
1,6,2013,Rhino Sports salary,General,1700,1881
1,6,2013,ATM Cash Withdrawal,General,10,1871
3,6,2013,South West Trains,Transport,25,1846
3,6,2013,Wild Bean Cafe,Eating Out,2,1844
3,6,2013,Chicken Cottage,Eating Out,5,1839
4,6,2013,Wild Bean Cafe,Eating Out,2,1837
4,6,2013,The West Cornwall Pasty Company,Eating Out,4,1833
5,6,2013,Costa Coffee,Eating Out,2,1831
5,6,2013,Paying back James,,8,1823
6,6,2013,ATM Cash Withdrawal,General,10,1813
6,6,2013,Tool Shop,,3,1810
7,6,2013,Cubit and West rent,Rent,550,1260
7,6,2013,Waitrose,Groceries,69,1191
7,6,2013,Caffe Nero,Eating Out,2,1189
7,6,2013,Chicken Cottage,Eating Out,8,1181
7,6,2013,Restaurant Gordon RamsayPortland Restaurant,Eating Out,47,1134
9,6,2013,Pizza Express,Eating Out,48,1086
10,6,2013,South West Trains,Transport,30,1056
10,6,2013,Costa Coffee,Eating Out,1,1055
10,6,2013,Pret A Manger,Eating Out,4,1051
10,6,2013,ATM Cash Withdrawal,General,20,1031
11,6,2013,Starbucks Coffee,Eating Out,2,1029
11,6,2013,ATM Cash Withdrawal,General,20,1009
12,6,2013,Wild Bean Cafe,Eating Out,2,1007
12,6,2013,ATM Cash Withdrawal,General,10,997
14,6,2013,Morrisons,Groceries,68,929
14,6,2013,Wild Bean Cafe,Eating Out,1,928
14,6,2013,Subway,Eating Out,7,921
15,6,2013,BRGAS-Electricity,Bills,40,881
15,6,2013,BRGAS-Gas,Bills,31,850
16,6,2013,LBS Council Tax,Bills,50,800
17,6,2013,South West Trains,Transport,37,763
17,6,2013,Costa Coffee,Eating Out,2,761
17,6,2013,Chicken Cottage,Eating Out,4,757
17,6,2013,ATM Cash Withdrawal,General,20,737
18,6,2013,Starbucks Coffee,Eating Out,2,735
18,6,2013,Tool Tec,,5,730
19,6,2013,Costa Coffee,Eating Out,1,729
20,6,2013,VIRGIN MEDIA PYMTS,Bills,56,673
20,6,2013,Chicken Cottage,Eating Out,8,665
21,6,2013,Waitrose,Groceries,70,595
21,6,2013,Wild Bean Cafe,Eating Out,2,593
21,6,2013,Greggs,Eating Out,6,587
21,6,2013,Anglo restaurant,Eating Out,49,538
22,6,2013,Anglo restaurant,Eating Out,59,479
24,6,2013,O2,Bills,37,442
24,6,2013,South West Trains,Transport,35,407
24,6,2013,McDonalds,Eating Out,6,401
25,6,2013,Caffe Nero,Eating Out,2,399
25,6,2013,ATM Cash Withdrawal,General,20,379
26,6,2013,Costa Coffee,Eating Out,2,377
26,6,2013,McDonalds,Eating Out,4,373
28,6,2013,Sainsburys,Groceries,69,304
28,6,2013,Anglo restaurant,Eating Out,52,252
30,6,2013,ATM Cash Withdrawal,General,20,232
1,7,2013,Rhino Sports salary,General,1700,1932
1,7,2013,South West Trains,Transport,32,1900
1,7,2013,Wild Bean Cafe,Eating Out,1,1899
2,7,2013,Greggs,Eating Out,5,1894
3,7,2013,Starbucks Coffee,Eating Out,2,1892
3,7,2013,McDonalds,Eating Out,7,1885
3,7,2013,ATM Cash Withdrawal,General,20,1865
4,7,2013,Starbucks Coffee,Eating Out,2,1863
4,7,2013,Pret A Manger,Eating Out,7,1856
5,7,2013,ASDA,Groceries,73,1783
5,7,2013,Costa Coffee,Eating Out,1,1782
5,7,2013,Pret A Manger,Eating Out,8,1774
5,7,2013,Pizza Express,Eating Out,41,1733
6,7,2013,Fabric Club,Eating Out,6,1727
7,7,2013,Cubit and West rent,Rent,550,1177
8,7,2013,South West Trains,Transport,33,1144
8,7,2013,Chicken Cottage,Eating Out,7,1137
9,7,2013,Starbucks Coffee,Eating Out,2,1135
9,7,2013,Subway,Eating Out,5,1130
9,7,2013,ATM Cash Withdrawal,General,20,1110
10,7,2013,Wild Bean Cafe,Eating Out,2,1108
10,7,2013,Pret A Manger,Eating Out,7,1101
11,7,2013,Starbucks Coffee,Eating Out,2,1099
11,7,2013,Chicken Cottage,Eating Out,6,1093
11,7,2013,ATM Cash Withdrawal,General,10,1083
12,7,2013,Morrisons,Groceries,69,1014
12,7,2013,Wild Bean Cafe,Eating Out,2,1012
12,7,2013,Chicken Cottage,Eating Out,4,1008
13,7,2013,Fabric Club,Eating Out,13,995
14,7,2013,Scott's Restaurant,Eating Out,32,963
14,7,2013,ATM Cash Withdrawal,General,10,953
15,7,2013,BRGAS-Electricity,Bills,36,917
15,7,2013,BRGAS-Gas,Bills,26,891
15,7,2013,South West Trains,Transport,31,860
15,7,2013,Costa Coffee,Eating Out,2,858
15,7,2013,McDonalds,Eating Out,4,854
15,7,2013,ATM Cash Withdrawal,General,20,834
16,7,2013,LBS Council Tax,Bills,50,784
16,7,2013,Costa Coffee,Eating Out,1,783
16,7,2013,Subway,Eating Out,4,779
17,7,2013,Caffe Nero,Eating Out,1,778
18,7,2013,Starbucks Coffee,Eating Out,2,776
19,7,2013,Tescos,Groceries,55,721
19,7,2013,Subway,Eating Out,8,713
19,7,2013,Scott's Restaurant,Eating Out,47,666
20,7,2013,VIRGIN MEDIA PYMTS,Bills,37,629
22,7,2013,South West Trains,Transport,27,602
22,7,2013,Starbucks Coffee,Eating Out,2,600
22,7,2013,Pret A Manger,Eating Out,8,592
23,7,2013,Costa Coffee,Eating Out,2,590
23,7,2013,McDonalds,Eating Out,7,583
24,7,2013,O2,Bills,36,547
24,7,2013,Wild Bean Cafe,Eating Out,2,545
24,7,2013,ATM Cash Withdrawal,General,20,525
25,7,2013,Wild Bean Cafe,Eating Out,2,523
25,7,2013,Pret A Manger,Eating Out,4,519
25,7,2013,ATM Cash Withdrawal,General,20,499
26,7,2013,Sainsburys,Groceries,65,434
26,7,2013,Starbucks Coffee,Eating Out,1,433
27,7,2013,The Grand Pub,Eating Out,13,420
27,7,2013,The Grand Pub,Eating Out,8,412
27,7,2013,The Grand Pub,Eating Out,11,401
27,7,2013,The Grand Pub,Eating Out,9,392
27,7,2013,The Grand Pub,Eating Out,10,382
27,7,2013,The Grand Pub,Eating Out,13,369
27,7,2013,Dominos Pizza,Eating Out,25,344
28,7,2013,Dominos Pizza,Eating Out,43,301
29,7,2013,South West Trains,Transport,29,272
29,7,2013,Caffe Nero,Eating Out,2,270
29,7,2013,Subway,Eating Out,8,262
30,7,2013,Starbucks Coffee,Eating Out,2,260
30,7,2013,McDonalds,Eating Out,4,256
31,7,2013,Caffe Nero,Eating Out,1,255
31,7,2013,Subway,Eating Out,6,249
31,7,2013,Red Shop,,9,240
1,8,2013,Rhino Sports salary,General,1700,1940
1,8,2013,Wild Bean Cafe,Eating Out,2,1938
1,8,2013,Paying back James,,4,1934
2,8,2013,ASDA,Groceries,48,1886
2,8,2013,Starbucks Coffee,Eating Out,1,1885
3,8,2013,Restaurant Gordon RamsayPortland Restaurant,Eating Out,26,1859
5,8,2013,South West Trains,Transport,36,1823
5,8,2013,Starbucks Coffee,Eating Out,1,1822
5,8,2013,Greggs,Eating Out,4,1818
6,8,2013,Starbucks Coffee,Eating Out,1,1817
6,8,2013,Chicken Cottage,Eating Out,7,1810
6,8,2013,ATM Cash Withdrawal,General,20,1790
6,8,2013,Tool Tec,,5,1785
7,8,2013,Cubit and West rent,Rent,550,1235
7,8,2013,Starbucks Coffee,Eating Out,1,1234
7,8,2013,Pret A Manger,Eating Out,8,1226
8,8,2013,Caffe Nero,Eating Out,2,1224
8,8,2013,Chicken Cottage,Eating Out,7,1217
8,8,2013,Tool Tec,,1,1216
9,8,2013,Sainsburys,Groceries,42,1174
9,8,2013,Costa Coffee,Eating Out,1,1173
9,8,2013,The West Cornwall Pasty Company,Eating Out,4,1169
9,8,2013,Restaurant Gordon RamsayPortland Restaurant,Eating Out,32,1137
11,8,2013,ATM Cash Withdrawal,General,10,1127
11,8,2013,Tool Tec,,2,1125
12,8,2013,South West Trains,Transport,26,1099
12,8,2013,Starbucks Coffee,Eating Out,2,1097
12,8,2013,ATM Cash Withdrawal,General,10,1087
13,8,2013,Costa Coffee,Eating Out,1,1086
13,8,2013,Chicken Cottage,Eating Out,5,1081
13,8,2013,ATM Cash Withdrawal,General,10,1071
14,8,2013,Starbucks Coffee,Eating Out,2,1069
14,8,2013,Pret A Manger,Eating Out,6,1063
14,8,2013,ATM Cash Withdrawal,General,20,1043
15,8,2013,BRGAS-Electricity,Bills,23,1020
15,8,2013,BRGAS-Gas,Bills,30,990
15,8,2013,Starbucks Coffee,Eating Out,2,988
15,8,2013,The West Cornwall Pasty Company,Eating Out,7,981
15,8,2013,ATM Cash Withdrawal,General,20,961
16,8,2013,LBS Council Tax,Bills,50,911
16,8,2013,Waitrose,Groceries,80,831
16,8,2013,Costa Coffee,Eating Out,2,829
16,8,2013,Greggs,Eating Out,5,824
16,8,2013,Dominos Pizza,Eating Out,32,792
18,8,2013,Pizza Express,Eating Out,57,735
18,8,2013,ATM Cash Withdrawal,General,20,715
19,8,2013,South West Trains,Transport,28,687
19,8,2013,Costa Coffee,Eating Out,2,685
19,8,2013,Subway,Eating Out,6,679
20,8,2013,VIRGIN MEDIA PYMTS,Bills,37,642
20,8,2013,Starbucks Coffee,Eating Out,2,640
21,8,2013,Caffe Nero,Eating Out,2,638
21,8,2013,McDonalds,Eating Out,5,633
21,8,2013,Red Shop,,9,624
22,8,2013,Costa Coffee,Eating Out,1,623
22,8,2013,The West Cornwall Pasty Company,Eating Out,7,616
22,8,2013,Red Shop,,2,614
23,8,2013,Sainsburys,Groceries,76,538
23,8,2013,Costa Coffee,Eating Out,2,536
23,8,2013,McDonalds,Eating Out,7,529
23,8,2013,Restaurant Gordon RamsayPortland Restaurant,Eating Out,49,480
24,8,2013,O2,Bills,32,448
25,8,2013,Dominos Pizza,Eating Out,24,424
26,8,2013,South West Trains,Transport,32,392
26,8,2013,Caffe Nero,Eating Out,1,391
26,8,2013,McDonalds,Eating Out,6,385
26,8,2013,Civic Shop,,9,376
27,8,2013,Wild Bean Cafe,Eating Out,2,374
27,8,2013,Subway,Eating Out,8,366
28,8,2013,Caffe Nero,Eating Out,1,365
30,8,2013,ASDA,Groceries,45,320
30,8,2013,Pret A Manger,Eating Out,4,316
31,8,2013,Dominos Pizza,Eating Out,36,280
1,9,2013,Rhino Sports salary,General,1700,1980
1,9,2013,Dominos Pizza,Eating Out,56,1924
2,9,2013,South West Trains,Transport,28,1896
2,9,2013,Costa Coffee,Eating Out,2,1894
2,9,2013,Pret A Manger,Eating Out,8,1886
3,9,2013,The West Cornwall Pasty Company,Eating Out,4,1882
4,9,2013,Caffe Nero,Eating Out,2,1880
5,9,2013,Caffe Nero,Eating Out,2,1878
6,9,2013,Waitrose,Groceries,64,1814
6,9,2013,Starbucks Coffee,Eating Out,2,1812
6,9,2013,Chicken Cottage,Eating Out,6,1806
6,9,2013,ATM Cash Withdrawal,General,20,1786
7,9,2013,Cubit and West rent,Rent,550,1236
9,9,2013,South West Trains,Transport,34,1202
9,9,2013,Costa Coffee,Eating Out,2,1200
9,9,2013,Greggs,Eating Out,4,1196
10,9,2013,Costa Coffee,Eating Out,2,1194
11,9,2013,Wild Bean Cafe,Eating Out,2,1192
11,9,2013,The West Cornwall Pasty Company,Eating Out,8,1184
12,9,2013,ATM Cash Withdrawal,General,20,1164
13,9,2013,Tescos,Groceries,42,1122
13,9,2013,McDonalds,Eating Out,5,1117
13,9,2013,Red Shop,,1,1116
15,9,2013,BRGAS-Electricity,Bills,23,1093
15,9,2013,BRGAS-Gas,Bills,22,1071
15,9,2013,Scott's Restaurant,Eating Out,29,1042
16,9,2013,LBS Council Tax,Bills,50,992
16,9,2013,South West Trains,Transport,25,967
16,9,2013,Costa Coffee,Eating Out,2,965
16,9,2013,Subway,Eating Out,8,957
17,9,2013,Costa Coffee,Eating Out,2,955
17,9,2013,Chicken Cottage,Eating Out,8,947
18,9,2013,Costa Coffee,Eating Out,2,945
18,9,2013,Paying back James,,6,939
19,9,2013,Wild Bean Cafe,Eating Out,1,938
20,9,2013,VIRGIN MEDIA PYMTS,Bills,43,895
20,9,2013,Sainsburys,Groceries,68,827
20,9,2013,McDonalds,Eating Out,6,821
20,9,2013,Fabric Club,Eating Out,12,809
20,9,2013,Fabric Club,Eating Out,14,795
20,9,2013,Fabric Club,Eating Out,16,779
20,9,2013,Fabric Club,Eating Out,12,767
20,9,2013,Fabric Club,Eating Out,16,751
21,9,2013,Dominos Pizza,Eating Out,53,698
21,9,2013,ATM Cash Withdrawal,General,20,678
23,9,2013,South West Trains,Transport,31,647
23,9,2013,McDonalds,Eating Out,4,643
23,9,2013,ATM Cash Withdrawal,General,20,623
24,9,2013,O2,Bills,37,586
24,9,2013,Costa Coffee,Eating Out,2,584
24,9,2013,Subway,Eating Out,7,577
25,9,2013,Wild Bean Cafe,Eating Out,2,575
25,9,2013,Greggs,Eating Out,4,571
25,9,2013,ATM Cash Withdrawal,General,10,561
26,9,2013,Caffe Nero,Eating Out,1,560
27,9,2013,ASDA,Groceries,42,518
27,9,2013,Costa Coffee,Eating Out,1,517
27,9,2013,Chicken Cottage,Eating Out,4,513
28,9,2013,Fabric Club,Eating Out,10,503
28,9,2013,Fabric Club,Eating Out,15,488
28,9,2013,Fabric Club,Eating Out,16,472
28,9,2013,Fabric Club,Eating Out,7,465
28,9,2013,Fabric Club,Eating Out,10,455
28,9,2013,Fabric Club,Eating Out,13,442
28,9,2013,Anglo restaurant,Eating Out,58,384
30,9,2013,South West Trains,Transport,35,349
30,9,2013,Caffe Nero,Eating Out,1,348
1,10,2013,Rhino Sports salary,General,1700,2048
1,10,2013,ATM Cash Withdrawal,General,20,2028
2,10,2013,The West Cornwall Pasty Company,Eating Out,4,2024
3,10,2013,Caffe Nero,Eating Out,1,2023
3,10,2013,The West Cornwall Pasty Company,Eating Out,7,2016
4,10,2013,Morrisons,Groceries,72,1944
4,10,2013,Wild Bean Cafe,Eating Out,1,1943
4,10,2013,The West Cornwall Pasty Company,Eating Out,7,1936
4,10,2013,Dominos Pizza,Eating Out,41,1895
4,10,2013,ATM Cash Withdrawal,General,20,1875
4,10,2013,Red Shop,,5,1870
7,10,2013,Cubit and West rent,Rent,550,1320
7,10,2013,South West Trains,Transport,32,1288
7,10,2013,Costa Coffee,Eating Out,1,1287
7,10,2013,McDonalds,Eating Out,5,1282
8,10,2013,Caffe Nero,Eating Out,1,1281
9,10,2013,Chicken Cottage,Eating Out,6,1275
10,10,2013,ATM Cash Withdrawal,General,20,1255
11,10,2013,Tescos,Groceries,75,1180
11,10,2013,Wild Bean Cafe,Eating Out,1,1179
11,10,2013,Subway,Eating Out,5,1174
11,10,2013,Pizza Express,Eating Out,29,1145
11,10,2013,Tool Tec,,7,1138
12,10,2013,Scott's Restaurant,Eating Out,29,1109
13,10,2013,Dominos Pizza,Eating Out,40,1069
13,10,2013,ATM Cash Withdrawal,General,20,1049
14,10,2013,South West Trains,Transport,24,1025
14,10,2013,Starbucks Coffee,Eating Out,2,1023
14,10,2013,Subway,Eating Out,7,1016
15,10,2013,BRGAS-Electricity,Bills,31,985
15,10,2013,BRGAS-Gas,Bills,25,960
15,10,2013,Costa Coffee,Eating Out,2,958
15,10,2013,Greggs,Eating Out,8,950
15,10,2013,ATM Cash Withdrawal,General,10,940
16,10,2013,LBS Council Tax,Bills,50,890
16,10,2013,Starbucks Coffee,Eating Out,1,889
17,10,2013,Wild Bean Cafe,Eating Out,2,887
17,10,2013,Greggs,Eating Out,4,883
18,10,2013,Sainsburys,Groceries,49,834
18,10,2013,Wild Bean Cafe,Eating Out,2,832
18,10,2013,Chicken Cottage,Eating Out,5,827
19,10,2013,Restaurant Gordon RamsayPortland Restaurant,Eating Out,57,770
20,10,2013,VIRGIN MEDIA PYMTS,Bills,53,717
21,10,2013,South West Trains,Transport,29,688
21,10,2013,Caffe Nero,Eating Out,2,686
23,10,2013,Chicken Cottage,Eating Out,4,682
24,10,2013,O2,Bills,31,651
24,10,2013,Caffe Nero,Eating Out,2,649
25,10,2013,Sainsburys,Groceries,72,577
25,10,2013,Wild Bean Cafe,Eating Out,1,576
25,10,2013,Scott's Restaurant,Eating Out,34,542
25,10,2013,ATM Cash Withdrawal,General,20,522
26,10,2013,Pizza Express,Eating Out,40,482
27,10,2013,Tool Shop,,3,479
28,10,2013,South West Trains,Transport,28,451
28,10,2013,Greggs,Eating Out,7,444
29,10,2013,Caffe Nero,Eating Out,1,443
29,10,2013,Pret A Manger,Eating Out,5,438
30,10,2013,Starbucks Coffee,Eating Out,2,436
30,10,2013,Chicken Cottage,Eating Out,8,428
30,10,2013,ATM Cash Withdrawal,General,20,408
31,10,2013,Costa Coffee,Eating Out,2,406
31,10,2013,Chicken Cottage,Eating Out,7,399
1,11,2013,Rhino Sports salary,General,1700,2099
1,11,2013,Morrisons,Groceries,83,2016
1,11,2013,Starbucks Coffee,Eating Out,2,2014
1,11,2013,The West Cornwall Pasty Company,Eating Out,6,2008
1,11,2013,Fabric Club,Eating Out,6,2002
1,11,2013,Fabric Club,Eating Out,14,1988
1,11,2013,Fabric Club,Eating Out,5,1983
1,11,2013,Dominos Pizza,Eating Out,28,1955
1,11,2013,ATM Cash Withdrawal,General,10,1945
2,11,2013,Scott's Restaurant,Eating Out,50,1895
3,11,2013,ATM Cash Withdrawal,General,10,1885
4,11,2013,South West Trains,Transport,27,1858
4,11,2013,McDonalds,Eating Out,5,1853
5,11,2013,Wild Bean Cafe,Eating Out,1,1852
5,11,2013,Chicken Cottage,Eating Out,4,1848
6,11,2013,Wild Bean Cafe,Eating Out,2,1846
6,11,2013,ATM Cash Withdrawal,General,10,1836
7,11,2013,Cubit and West rent,Rent,550,1286
7,11,2013,Wild Bean Cafe,Eating Out,2,1284
7,11,2013,Pret A Manger,Eating Out,8,1276
8,11,2013,Sainsburys,Groceries,42,1234
8,11,2013,Pret A Manger,Eating Out,5,1229
8,11,2013,ATM Cash Withdrawal,General,20,1209
9,11,2013,Pizza Express,Eating Out,53,1156
10,11,2013,Restaurant Gordon RamsayPortland Restaurant,Eating Out,40,1116
10,11,2013,Paying back James,,2,1114
11,11,2013,South West Trains,Transport,27,1087
11,11,2013,Caffe Nero,Eating Out,2,1085
11,11,2013,ATM Cash Withdrawal,General,10,1075
12,11,2013,Costa Coffee,Eating Out,1,1074
12,11,2013,Pret A Manger,Eating Out,6,1068
13,11,2013,Wild Bean Cafe,Eating Out,2,1066
13,11,2013,Subway,Eating Out,4,1062
14,11,2013,Greggs,Eating Out,8,1054
14,11,2013,ATM Cash Withdrawal,General,20,1034
14,11,2013,Civic Shop,,9,1025
15,11,2013,BRGAS-Electricity,Bills,38,987
15,11,2013,BRGAS-Gas,Bills,79,908
15,11,2013,Waitrose,Groceries,80,828
15,11,2013,Wild Bean Cafe,Eating Out,1,827
15,11,2013,McDonalds,Eating Out,6,821
16,11,2013,LBS Council Tax,Bills,50,771
16,11,2013,Scott's Restaurant,Eating Out,50,721
16,11,2013,ATM Cash Withdrawal,General,20,701
17,11,2013,ATM Cash Withdrawal,General,10,691
18,11,2013,South West Trains,Transport,34,657
18,11,2013,Costa Coffee,Eating Out,1,656
18,11,2013,McDonalds,Eating Out,4,652
19,11,2013,Costa Coffee,Eating Out,2,650
19,11,2013,Chicken Cottage,Eating Out,4,646
19,11,2013,ATM Cash Withdrawal,General,10,636
20,11,2013,VIRGIN MEDIA PYMTS,Bills,46,590
20,11,2013,Wild Bean Cafe,Eating Out,2,588
21,11,2013,Starbucks Coffee,Eating Out,1,587
22,11,2013,Tescos,Groceries,81,506
23,11,2013,Fabric Club,Eating Out,16,490
23,11,2013,Fabric Club,Eating Out,6,484
24,11,2013,O2,Bills,35,449
24,11,2013,Dominos Pizza,Eating Out,31,418
25,11,2013,South West Trains,Transport,31,387
25,11,2013,Wild Bean Cafe,Eating Out,2,385
25,11,2013,Paying back James,,6,379
26,11,2013,Starbucks Coffee,Eating Out,2,377
27,11,2013,Caffe Nero,Eating Out,2,375
27,11,2013,Greggs,Eating Out,8,367
27,11,2013,ATM Cash Withdrawal,General,10,357
28,11,2013,Greggs,Eating Out,5,352
29,11,2013,Waitrose,Groceries,70,282
29,11,2013,Wild Bean Cafe,Eating Out,2,280
29,11,2013,Subway,Eating Out,4,276
1,12,2013,Rhino Sports salary,General,1700,1976
1,12,2013,Restaurant Gordon RamsayPortland Restaurant,Eating Out,46,1930
2,12,2013,South West Trains,Transport,25,1905
2,12,2013,Caffe Nero,Eating Out,1,1904
3,12,2013,Subway,Eating Out,4,1900
4,12,2013,Caffe Nero,Eating Out,2,1898
4,12,2013,Chicken Cottage,Eating Out,8,1890
4,12,2013,ATM Cash Withdrawal,General,10,1880
5,12,2013,Starbucks Coffee,Eating Out,1,1879
5,12,2013,Pret A Manger,Eating Out,4,1875
6,12,2013,Morrisons,Groceries,59,1816
6,12,2013,Caffe Nero,Eating Out,1,1815
6,12,2013,Chicken Cottage,Eating Out,5,1810
7,12,2013,Cubit and West rent,Rent,550,1260
9,12,2013,South West Trains,Transport,37,1223
9,12,2013,Caffe Nero,Eating Out,2,1221
9,12,2013,ATM Cash Withdrawal,General,10,1211
10,12,2013,Costa Coffee,Eating Out,1,1210
10,12,2013,The West Cornwall Pasty Company,Eating Out,6,1204
11,12,2013,Starbucks Coffee,Eating Out,2,1202
11,12,2013,Subway,Eating Out,7,1195
12,12,2013,Costa Coffee,Eating Out,1,1194
13,12,2013,ASDA,Groceries,64,1130
13,12,2013,Wild Bean Cafe,Eating Out,2,1128
13,12,2013,The West Cornwall Pasty Company,Eating Out,6,1122
13,12,2013,Dominos Pizza,Eating Out,46,1076
13,12,2013,ATM Cash Withdrawal,General,10,1066
14,12,2013,ATM Cash Withdrawal,General,20,1046
15,12,2013,BRGAS-Electricity,Bills,34,1012
15,12,2013,BRGAS-Gas,Bills,40,972
15,12,2013,Scott's Restaurant,Eating Out,39,933
16,12,2013,LBS Council Tax,Bills,50,883
16,12,2013,South West Trains,Transport,34,849
16,12,2013,Starbucks Coffee,Eating Out,1,848
16,12,2013,Pret A Manger,Eating Out,8,840
17,12,2013,Starbucks Coffee,Eating Out,2,838
17,12,2013,Chicken Cottage,Eating Out,7,831
18,12,2013,Caffe Nero,Eating Out,2,829
18,12,2013,Pret A Manger,Eating Out,6,823
18,12,2013,Paying back Julie,,4,819
19,12,2013,Wild Bean Cafe,Eating Out,2,817
20,12,2013,VIRGIN MEDIA PYMTS,Bills,36,781
20,12,2013,Sainsburys,Groceries,70,711
20,12,2013,Wild Bean Cafe,Eating Out,2,709
20,12,2013,Chicken Cottage,Eating Out,8,701
20,12,2013,Ministry of Sound ClubXOYO Club,Eating Out,14,687
20,12,2013,Ministry of Sound ClubXOYO Club,Eating Out,10,677
20,12,2013,Ministry of Sound ClubXOYO Club,Eating Out,15,662
20,12,2013,Ministry of Sound ClubXOYO Club,Eating Out,8,654
20,12,2013,Ministry of Sound ClubXOYO Club,Eating Out,5,649
20,12,2013,Ministry of Sound ClubXOYO Club,Eating Out,12,637
21,12,2013,Scott's Restaurant,Eating Out,29,608
21,12,2013,Paying back Julie,,1,607
23,12,2013,South West Trains,Transport,24,583
23,12,2013,Wild Bean Cafe,Eating Out,2,581
23,12,2013,Greggs,Eating Out,7,574
24,12,2013,O2,Bills,35,539
24,12,2013,Pret A Manger,Eating Out,5,534
24,12,2013,ATM Cash Withdrawal,General,20,514
25,12,2013,Wild Bean Cafe,Eating Out,1,513
26,12,2013,Costa Coffee,Eating Out,1,512
26,12,2013,The West Cornwall Pasty Company,Eating Out,4,508
27,12,2013,Morrisons,Groceries,71,437
27,12,2013,Caffe Nero,Eating Out,2,435
27,12,2013,Anglo restaurant,Eating Out,56,379
27,12,2013,ATM Cash Withdrawal,General,20,359
29,12,2013,Dominos Pizza,Eating Out,54,305
29,12,2013,ATM Cash Withdrawal,General,10,295
29,12,2013,Cheam Service Station,,8,287
30,12,2013,South West Trains,Transport,28,259
30,12,2013,Subway,Eating Out,5,254
30,12,2013,ATM Cash Withdrawal,General,10,244
31,12,2013,Caffe Nero,Eating Out,2,242
31,12,2013,Subway,Eating Out,5,237
1,1,2014,Rhino Sports salary,General,1700,1937
1,1,2014,Wild Bean Cafe,Eating Out,2,1935
2,1,2014,Caffe Nero,Eating Out,1,1934
2,1,2014,Greggs,Eating Out,6,1928
3,1,2014,Waitrose,Groceries,73,1855
3,1,2014,Caffe Nero,Eating Out,1,1854
3,1,2014,Greggs,Eating Out,4,1850
4,1,2014,ATM Cash Withdrawal,General,20,1830
5,1,2014,Dominos Pizza,Eating Out,57,1773
6,1,2014,South West Trains,Transport,27,1746
6,1,2014,Pret A Manger,Eating Out,5,1741
7,1,2014,Cubit and West rent,Rent,550,1191
7,1,2014,Starbucks Coffee,Eating Out,1,1190
7,1,2014,McDonalds,Eating Out,8,1182
8,1,2014,Caffe Nero,Eating Out,1,1181
8,1,2014,Pret A Manger,Eating Out,7,1174
8,1,2014,Tool Shop,,3,1171
9,1,2014,Caffe Nero,Eating Out,2,1169
9,1,2014,Subway,Eating Out,6,1163
10,1,2014,ASDA,Groceries,53,1110
10,1,2014,Caffe Nero,Eating Out,2,1108
10,1,2014,Subway,Eating Out,5,1103
10,1,2014,Restaurant Gordon RamsayPortland Restaurant,Eating Out,33,1070
12,1,2014,Cheam Service Station,,1,1069
13,1,2014,South West Trains,Transport,24,1045
13,1,2014,Wild Bean Cafe,Eating Out,2,1043
13,1,2014,ATM Cash Withdrawal,General,20,1023
14,1,2014,Caffe Nero,Eating Out,2,1021
15,1,2014,BRGAS-Electricity,Bills,53,968
15,1,2014,BRGAS-Gas,Bills,36,932
15,1,2014,Costa Coffee,Eating Out,1,931
15,1,2014,Subway,Eating Out,6,925
15,1,2014,Red Shop,,3,922
16,1,2014,LBS Council Tax,Bills,50,872
16,1,2014,Starbucks Coffee,Eating Out,1,871
16,1,2014,The West Cornwall Pasty Company,Eating Out,8,863
17,1,2014,ASDA,Groceries,84,779
17,1,2014,Pret A Manger,Eating Out,7,772
19,1,2014,Pizza Express,Eating Out,29,743
20,1,2014,VIRGIN MEDIA PYMTS,Bills,30,713
20,1,2014,South West Trains,Transport,28,685
20,1,2014,Starbucks Coffee,Eating Out,2,683
21,1,2014,Caffe Nero,Eating Out,2,681
21,1,2014,McDonalds,Eating Out,5,676
22,1,2014,Pret A Manger,Eating Out,6,670
22,1,2014,ATM Cash Withdrawal,General,10,660
23,1,2014,Starbucks Coffee,Eating Out,2,658
23,1,2014,The West Cornwall Pasty Company,Eating Out,5,653
24,1,2014,O2,Bills,30,623
24,1,2014,Tescos,Groceries,86,537
24,1,2014,Caffe Nero,Eating Out,1,536
24,1,2014,Restaurant Gordon RamsayPortland Restaurant,Eating Out,55,481
24,1,2014,ATM Cash Withdrawal,General,10,471
25,1,2014,Restaurant Gordon RamsayPortland Restaurant,Eating Out,24,447
27,1,2014,South West Trains,Transport,24,423
27,1,2014,Starbucks Coffee,Eating Out,2,421
28,1,2014,Starbucks Coffee,Eating Out,1,420
28,1,2014,Pret A Manger,Eating Out,7,413
28,1,2014,ATM Cash Withdrawal,General,10,403
29,1,2014,Wild Bean Cafe,Eating Out,1,402
29,1,2014,Pret A Manger,Eating Out,4,398
30,1,2014,The West Cornwall Pasty Company,Eating Out,7,391
31,1,2014,Morrisons,Groceries,70,321
1,2,2014,Rhino Sports salary,General,1700,2021
1,2,2014,Pizza Express,Eating Out,44,1977
1,2,2014,ATM Cash Withdrawal,General,20,1957
1,2,2014,Cheam Service Station,,5,1952
2,2,2014,Pizza Express,Eating Out,36,1916
2,2,2014,ATM Cash Withdrawal,General,10,1906
3,2,2014,South West Trains,Transport,35,1871
3,2,2014,Starbucks Coffee,Eating Out,2,1869
3,2,2014,Subway,Eating Out,5,1864
3,2,2014,ATM Cash Withdrawal,General,10,1854
4,2,2014,Costa Coffee,Eating Out,1,1853
4,2,2014,McDonalds,Eating Out,8,1845
4,2,2014,Cheam Service Station,,6,1839
5,2,2014,Caffe Nero,Eating Out,2,1837
5,2,2014,Subway,Eating Out,6,1831
6,2,2014,Wild Bean Cafe,Eating Out,2,1829
6,2,2014,Pret A Manger,Eating Out,7,1822
7,2,2014,Cubit and West rent,Rent,550,1272
7,2,2014,Tescos,Groceries,64,1208
7,2,2014,Caffe Nero,Eating Out,2,1206
7,2,2014,The West Cornwall Pasty Company,Eating Out,5,1201
7,2,2014,Scott's Restaurant,Eating Out,56,1145
7,2,2014,Paying back James,,1,1144
8,2,2014,Pizza Express,Eating Out,38,1106
8,2,2014,ATM Cash Withdrawal,General,20,1086
10,2,2014,South West Trains,Transport,33,1053
10,2,2014,Caffe Nero,Eating Out,2,1051
10,2,2014,Chicken Cottage,Eating Out,7,1044
11,2,2014,Costa Coffee,Eating Out,2,1042
11,2,2014,Greggs,Eating Out,5,1037
11,2,2014,Paying back Julie,,1,1036
12,2,2014,Caffe Nero,Eating Out,1,1035
12,2,2014,Pret A Manger,Eating Out,8,1027
13,2,2014,Costa Coffee,Eating Out,2,1025
13,2,2014,Greggs,Eating Out,4,1021
13,2,2014,ATM Cash Withdrawal,General,10,1011
14,2,2014,Waitrose,Groceries,76,935
14,2,2014,Costa Coffee,Eating Out,1,934
14,2,2014,The West Cornwall Pasty Company,Eating Out,7,927
15,2,2014,BRGAS-Electricity,Bills,42,885
15,2,2014,BRGAS-Gas,Bills,37,848
16,2,2014,LBS Council Tax,Bills,50,798
16,2,2014,Restaurant Gordon RamsayPortland Restaurant,Eating Out,47,751
17,2,2014,South West Trains,Transport,37,714
17,2,2014,Costa Coffee,Eating Out,2,712
17,2,2014,The West Cornwall Pasty Company,Eating Out,4,708
18,2,2014,ATM Cash Withdrawal,General,10,698
18,2,2014,Civic Shop,,4,694
19,2,2014,Caffe Nero,Eating Out,2,692
19,2,2014,The West Cornwall Pasty Company,Eating Out,7,685
19,2,2014,ATM Cash Withdrawal,General,20,665
20,2,2014,VIRGIN MEDIA PYMTS,Bills,54,611
20,2,2014,Starbucks Coffee,Eating Out,1,610
20,2,2014,The West Cornwall Pasty Company,Eating Out,5,605
21,2,2014,Morrisons,Groceries,43,562
23,2,2014,Pizza Express,Eating Out,46,516
24,2,2014,O2,Bills,30,486
24,2,2014,South West Trains,Transport,28,458
24,2,2014,Wild Bean Cafe,Eating Out,2,456
25,2,2014,ATM Cash Withdrawal,General,20,436
26,2,2014,Caffe Nero,Eating Out,2,434
26,2,2014,McDonalds,Eating Out,4,430
27,2,2014,Wild Bean Cafe,Eating Out,2,428
27,2,2014,ATM Cash Withdrawal,General,20,408
27,2,2014,Cheam Service Station,,2,406
28,2,2014,Morrisons,Groceries,60,346
28,2,2014,Costa Coffee,Eating Out,2,344
28,2,2014,Chicken Cottage,Eating Out,5,339
28,2,2014,Restaurant Gordon RamsayPortland Restaurant,Eating Out,31,308
28,2,2014,ATM Cash Withdrawal,General,10,298
1,3,2014,Rhino Sports salary,General,1700,1998
1,3,2014,Anglo restaurant,Eating Out,55,1943
2,3,2014,Pizza Express,Eating Out,35,1908
3,3,2014,South West Trains,Transport,32,1876
3,3,2014,Caffe Nero,Eating Out,2,1874
3,3,2014,Chicken Cottage,Eating Out,7,1867
4,3,2014,Wild Bean Cafe,Eating Out,1,1866
4,3,2014,Pret A Manger,Eating Out,8,1858
4,3,2014,ATM Cash Withdrawal,General,10,1848
5,3,2014,Wild Bean Cafe,Eating Out,2,1846
5,3,2014,ATM Cash Withdrawal,General,20,1826
6,3,2014,Starbucks Coffee,Eating Out,2,1824
7,3,2014,Cubit and West rent,Rent,550,1274
7,3,2014,Morrisons,Groceries,89,1185
7,3,2014,Costa Coffee,Eating Out,2,1183
7,3,2014,Pret A Manger,Eating Out,8,1175
8,3,2014,Red Shop,,3,1172
9,3,2014,Pizza Express,Eating Out,25,1147
9,3,2014,ATM Cash Withdrawal,General,10,1137
10,3,2014,South West Trains,Transport,34,1103
10,3,2014,Costa Coffee,Eating Out,2,1101
10,3,2014,Subway,Eating Out,8,1093
11,3,2014,Starbucks Coffee,Eating Out,2,1091
11,3,2014,The West Cornwall Pasty Company,Eating Out,8,1083
12,3,2014,Costa Coffee,Eating Out,2,1081
12,3,2014,McDonalds,Eating Out,7,1074
12,3,2014,Tool Tec,,2,1072
13,3,2014,The West Cornwall Pasty Company,Eating Out,6,1066
14,3,2014,Morrisons,Groceries,44,1022
14,3,2014,Costa Coffee,Eating Out,2,1020
14,3,2014,Pret A Manger,Eating Out,5,1015
14,3,2014,ATM Cash Withdrawal,General,10,1005
14,3,2014,Tool Tec,,9,996
15,3,2014,BRGAS-Electricity,Bills,23,973
15,3,2014,BRGAS-Gas,Bills,42,931
16,3,2014,LBS Council Tax,Bills,50,881
17,3,2014,South West Trains,Transport,34,847
17,3,2014,Starbucks Coffee,Eating Out,2,845
17,3,2014,Pret A Manger,Eating Out,7,838
18,3,2014,Starbucks Coffee,Eating Out,2,836
19,3,2014,Wild Bean Cafe,Eating Out,2,834
20,3,2014,VIRGIN MEDIA PYMTS,Bills,58,776
20,3,2014,Caffe Nero,Eating Out,2,774
20,3,2014,ATM Cash Withdrawal,General,10,764
21,3,2014,ASDA,Groceries,74,690
21,3,2014,Subway,Eating Out,8,682
21,3,2014,Tool Tec,,8,674
24,3,2014,O2,Bills,37,637
24,3,2014,South West Trains,Transport,25,612
24,3,2014,Caffe Nero,Eating Out,2,610
25,3,2014,Starbucks Coffee,Eating Out,1,609
25,3,2014,Pret A Manger,Eating Out,8,601
26,3,2014,Wild Bean Cafe,Eating Out,2,599
26,3,2014,ATM Cash Withdrawal,General,20,579
27,3,2014,ATM Cash Withdrawal,General,20,559
28,3,2014,ASDA,Groceries,49,510
28,3,2014,Caffe Nero,Eating Out,2,508
28,3,2014,Greggs,Eating Out,8,500
29,3,2014,ATM Cash Withdrawal,General,20,480
30,3,2014,Dominos Pizza,Eating Out,46,434
30,3,2014,Tool Tec,,2,432
31,3,2014,South West Trains,Transport,27,405
31,3,2014,Starbucks Coffee,Eating Out,2,403
31,3,2014,The West Cornwall Pasty Company,Eating Out,7,396
1,4,2014,Rhino Sports salary,General,1700,2096
1,4,2014,Caffe Nero,Eating Out,2,2094
1,4,2014,Greggs,Eating Out,5,2089
2,4,2014,Wild Bean Cafe,Eating Out,2,2087
2,4,2014,Greggs,Eating Out,4,2083
2,4,2014,ATM Cash Withdrawal,General,20,2063
2,4,2014,Paying back James,,6,2057
3,4,2014,Caffe Nero,Eating Out,2,2055
3,4,2014,Pret A Manger,Eating Out,4,2051
4,4,2014,Sainsburys,Groceries,42,2009
4,4,2014,Starbucks Coffee,Eating Out,2,2007
4,4,2014,Pret A Manger,Eating Out,5,2002
5,4,2014,ATM Cash Withdrawal,General,20,1982
6,4,2014,Anglo restaurant,Eating Out,46,1936
6,4,2014,Paying back Julie,,7,1929
7,4,2014,Cubit and West rent,Rent,550,1379
7,4,2014,South West Trains,Transport,30,1349
7,4,2014,Wild Bean Cafe,Eating Out,1,1348
8,4,2014,Pret A Manger,Eating Out,7,1341
8,4,2014,ATM Cash Withdrawal,General,10,1331
9,4,2014,Starbucks Coffee,Eating Out,2,1329
9,4,2014,ATM Cash Withdrawal,General,10,1319
11,4,2014,Sainsburys,Groceries,43,1276
11,4,2014,Costa Coffee,Eating Out,1,1275
11,4,2014,Greggs,Eating Out,6,1269
14,4,2014,South West Trains,Transport,37,1232
14,4,2014,Wild Bean Cafe,Eating Out,2,1230
14,4,2014,McDonalds,Eating Out,5,1225
14,4,2014,ATM Cash Withdrawal,General,20,1205
15,4,2014,BRGAS-Electricity,Bills,40,1165
15,4,2014,BRGAS-Gas,Bills,39,1126
15,4,2014,Wild Bean Cafe,Eating Out,1,1125
15,4,2014,Chicken Cottage,Eating Out,5,1120
16,4,2014,LBS Council Tax,Bills,50,1070
16,4,2014,Costa Coffee,Eating Out,2,1068
16,4,2014,McDonalds,Eating Out,5,1063
16,4,2014,ATM Cash Withdrawal,General,10,1053
17,4,2014,Costa Coffee,Eating Out,1,1052
18,4,2014,ASDA,Groceries,64,988
18,4,2014,Wild Bean Cafe,Eating Out,2,986
18,4,2014,Greggs,Eating Out,6,980
18,4,2014,Restaurant Gordon RamsayPortland Restaurant,Eating Out,52,928
19,4,2014,Scott's Restaurant,Eating Out,57,871
19,4,2014,Tool Tec,,6,865
20,4,2014,VIRGIN MEDIA PYMTS,Bills,34,831
20,4,2014,Scott's Restaurant,Eating Out,30,801
21,4,2014,South West Trains,Transport,33,768
21,4,2014,Caffe Nero,Eating Out,1,767
21,4,2014,The West Cornwall Pasty Company,Eating Out,5,762
21,4,2014,ATM Cash Withdrawal,General,20,742
22,4,2014,Caffe Nero,Eating Out,1,741
22,4,2014,Chicken Cottage,Eating Out,5,736
23,4,2014,Starbucks Coffee,Eating Out,2,734
23,4,2014,Chicken Cottage,Eating Out,5,729
24,4,2014,O2,Bills,30,699
24,4,2014,Caffe Nero,Eating Out,1,698
24,4,2014,Chicken Cottage,Eating Out,6,692
25,4,2014,Morrisons,Groceries,89,603
25,4,2014,McDonalds,Eating Out,6,597
26,4,2014,Restaurant Gordon RamsayPortland Restaurant,Eating Out,44,553
28,4,2014,South West Trains,Transport,28,525
29,4,2014,Caffe Nero,Eating Out,2,523
29,4,2014,Pret A Manger,Eating Out,8,515
30,4,2014,ATM Cash Withdrawal,General,10,505
1,5,2014,Rhino Sports salary,General,1700,2205
2,5,2014,ASDA,Groceries,44,2161
2,5,2014,McDonalds,Eating Out,5,2156
4,5,2014,Pizza Express,Eating Out,28,2128
5,5,2014,South West Trains,Transport,35,2093
5,5,2014,Caffe Nero,Eating Out,1,2092
6,5,2014,Wild Bean Cafe,Eating Out,2,2090
6,5,2014,Greggs,Eating Out,4,2086
7,5,2014,Cubit and West rent,Rent,550,1536
8,5,2014,Wild Bean Cafe,Eating Out,2,1534
8,5,2014,Pret A Manger,Eating Out,7,1527
9,5,2014,Sainsburys,Groceries,80,1447
9,5,2014,Costa Coffee,Eating Out,2,1445
11,5,2014,ATM Cash Withdrawal,General,10,1435
12,5,2014,South West Trains,Transport,29,1406
12,5,2014,Costa Coffee,Eating Out,1,1405
12,5,2014,Chicken Cottage,Eating Out,7,1398
12,5,2014,ATM Cash Withdrawal,General,10,1388
13,5,2014,Starbucks Coffee,Eating Out,2,1386
13,5,2014,Chicken Cottage,Eating Out,6,1380
14,5,2014,Starbucks Coffee,Eating Out,1,1379
15,5,2014,BRGAS-Electricity,Bills,39,1340
15,5,2014,BRGAS-Gas,Bills,27,1313
15,5,2014,Chicken Cottage,Eating Out,7,1306
16,5,2014,LBS Council Tax,Bills,50,1256
16,5,2014,ASDA,Groceries,45,1211
16,5,2014,Wild Bean Cafe,Eating Out,2,1209
16,5,2014,The West Cornwall Pasty Company,Eating Out,4,1205
16,5,2014,Heaven Club,Eating Out,14,1191
16,5,2014,Heaven Club,Eating Out,7,1184
16,5,2014,Heaven Club,Eating Out,14,1170
16,5,2014,Scott's Restaurant,Eating Out,54,1116
17,5,2014,Pizza Express,Eating Out,29,1087
18,5,2014,Dominos Pizza,Eating Out,44,1043
19,5,2014,South West Trains,Transport,25,1018
19,5,2014,Costa Coffee,Eating Out,2,1016
20,5,2014,VIRGIN MEDIA PYMTS,Bills,47,969
20,5,2014,Caffe Nero,Eating Out,1,968
20,5,2014,ATM Cash Withdrawal,General,20,948
21,5,2014,Costa Coffee,Eating Out,1,947
21,5,2014,Pret A Manger,Eating Out,6,941
22,5,2014,Wild Bean Cafe,Eating Out,1,940
22,5,2014,Pret A Manger,Eating Out,6,934
23,5,2014,Sainsburys,Groceries,89,845
23,5,2014,Wild Bean Cafe,Eating Out,2,843
23,5,2014,ATM Cash Withdrawal,General,20,823
24,5,2014,O2,Bills,32,791
24,5,2014,Dominos Pizza,Eating Out,40,751
26,5,2014,South West Trains,Transport,31,720
26,5,2014,Costa Coffee,Eating Out,2,718
26,5,2014,The West Cornwall Pasty Company,Eating Out,5,713
26,5,2014,ATM Cash Withdrawal,General,10,703
27,5,2014,Wild Bean Cafe,Eating Out,2,701
28,5,2014,Costa Coffee,Eating Out,1,700
28,5,2014,Subway,Eating Out,4,696
29,5,2014,Wild Bean Cafe,Eating Out,2,694
29,5,2014,ATM Cash Withdrawal,General,10,684
29,5,2014,Paying back Julie,,4,680
30,5,2014,Sainsburys,Groceries,54,626
30,5,2014,The West Cornwall Pasty Company,Eating Out,6,620
31,5,2014,ATM Cash Withdrawal,General,20,600
1,6,2014,Rhino Sports salary,General,1700,2300
1,6,2014,ATM Cash Withdrawal,General,20,2280
2,6,2014,South West Trains,Transport,25,2255
2,6,2014,Wild Bean Cafe,Eating Out,1,2254
2,6,2014,Pret A Manger,Eating Out,4,2250
2,6,2014,ATM Cash Withdrawal,General,20,2230
3,6,2014,Subway,Eating Out,5,2225
3,6,2014,ATM Cash Withdrawal,General,20,2205
5,6,2014,ATM Cash Withdrawal,General,20,2185
6,6,2014,Morrisons,Groceries,55,2130
6,6,2014,Starbucks Coffee,Eating Out,2,2128
6,6,2014,Greggs,Eating Out,4,2124
6,6,2014,ATM Cash Withdrawal,General,20,2104
7,6,2014,Cubit and West rent,Rent,550,1554
8,6,2014,Pizza Express,Eating Out,41,1513
9,6,2014,South West Trains,Transport,26,1487
9,6,2014,Caffe Nero,Eating Out,2,1485
9,6,2014,Cheam Service Station,,9,1476
10,6,2014,Wild Bean Cafe,Eating Out,1,1475
10,6,2014,ATM Cash Withdrawal,General,10,1465
11,6,2014,Starbucks Coffee,Eating Out,1,1464
12,6,2014,Costa Coffee,Eating Out,1,1463
12,6,2014,Paying back Julie,,6,1457
13,6,2014,Tescos,Groceries,69,1388
13,6,2014,Costa Coffee,Eating Out,2,1386
13,6,2014,The West Cornwall Pasty Company,Eating Out,5,1381
13,6,2014,Restaurant Gordon RamsayPortland Restaurant,Eating Out,42,1339
13,6,2014,Tool Shop,,6,1333
15,6,2014,BRGAS-Electricity,Bills,39,1294
15,6,2014,BRGAS-Gas,Bills,44,1250
15,6,2014,Dominos Pizza,Eating Out,53,1197
15,6,2014,Tool Tec,,1,1196
16,6,2014,LBS Council Tax,Bills,50,1146
16,6,2014,South West Trains,Transport,37,1109
16,6,2014,Starbucks Coffee,Eating Out,2,1107
16,6,2014,Pret A Manger,Eating Out,8,1099
17,6,2014,Wild Bean Cafe,Eating Out,1,1098
17,6,2014,Pret A Manger,Eating Out,5,1093
18,6,2014,Wild Bean Cafe,Eating Out,1,1092
18,6,2014,The West Cornwall Pasty Company,Eating Out,5,1087
19,6,2014,Caffe Nero,Eating Out,2,1085
19,6,2014,Pret A Manger,Eating Out,6,1079
19,6,2014,ATM Cash Withdrawal,General,10,1069
20,6,2014,VIRGIN MEDIA PYMTS,Bills,43,1026
20,6,2014,ASDA,Groceries,54,972
20,6,2014,Chicken Cottage,Eating Out,8,964
22,6,2014,Scott's Restaurant,Eating Out,53,911
23,6,2014,South West Trains,Transport,33,878
23,6,2014,Wild Bean Cafe,Eating Out,1,877
23,6,2014,Subway,Eating Out,4,873
24,6,2014,O2,Bills,37,836
24,6,2014,Starbucks Coffee,Eating Out,1,835
24,6,2014,McDonalds,Eating Out,5,830
24,6,2014,Paying back Julie,,2,828
25,6,2014,Wild Bean Cafe,Eating Out,2,826
25,6,2014,Chicken Cottage,Eating Out,4,822
25,6,2014,ATM Cash Withdrawal,General,20,802
26,6,2014,Starbucks Coffee,Eating Out,1,801
26,6,2014,McDonalds,Eating Out,8,793
26,6,2014,Red Shop,,8,785
27,6,2014,Tescos,Groceries,71,714
27,6,2014,Caffe Nero,Eating Out,1,713
27,6,2014,Pret A Manger,Eating Out,6,707
27,6,2014,ATM Cash Withdrawal,General,10,697
28,6,2014,Anglo restaurant,Eating Out,53,644
30,6,2014,South West Trains,Transport,28,616
30,6,2014,Costa Coffee,Eating Out,2,614
30,6,2014,Chicken Cottage,Eating Out,7,607
30,6,2014,ATM Cash Withdrawal,General,20,587
1,7,2014,Rhino Sports salary,General,1700,2287
2,7,2014,Caffe Nero,Eating Out,1,2286
4,7,2014,Waitrose,Groceries,44,2242
4,7,2014,Wild Bean Cafe,Eating Out,2,2240
4,7,2014,Chicken Cottage,Eating Out,8,2232
4,7,2014,Dominos Pizza,Eating Out,40,2192
6,7,2014,Pizza Express,Eating Out,29,2163
7,7,2014,Cubit and West rent,Rent,550,1613
7,7,2014,South West Trains,Transport,24,1589
7,7,2014,Starbucks Coffee,Eating Out,2,1587
7,7,2014,The West Cornwall Pasty Company,Eating Out,7,1580
7,7,2014,Cheam Service Station,,4,1576
8,7,2014,Caffe Nero,Eating Out,2,1574
8,7,2014,The West Cornwall Pasty Company,Eating Out,4,1570
9,7,2014,Starbucks Coffee,Eating Out,1,1569
10,7,2014,Costa Coffee,Eating Out,2,1567
10,7,2014,Pret A Manger,Eating Out,6,1561
10,7,2014,Paying back James,,5,1556
11,7,2014,Morrisons,Groceries,81,1475
11,7,2014,Starbucks Coffee,Eating Out,2,1473
11,7,2014,Dominos Pizza,Eating Out,52,1421
11,7,2014,ATM Cash Withdrawal,General,20,1401
14,7,2014,South West Trains,Transport,25,1376
14,7,2014,Costa Coffee,Eating Out,1,1375
14,7,2014,Subway,Eating Out,4,1371
15,7,2014,BRGAS-Electricity,Bills,32,1339
15,7,2014,BRGAS-Gas,Bills,32,1307
15,7,2014,Costa Coffee,Eating Out,2,1305
16,7,2014,LBS Council Tax,Bills,50,1255
16,7,2014,Caffe Nero,Eating Out,2,1253
16,7,2014,ATM Cash Withdrawal,General,20,1233
17,7,2014,Wild Bean Cafe,Eating Out,2,1231
17,7,2014,Subway,Eating Out,8,1223
18,7,2014,Sainsburys,Groceries,52,1171
18,7,2014,Starbucks Coffee,Eating Out,2,1169
18,7,2014,Greggs,Eating Out,7,1162
18,7,2014,Heaven Club,Eating Out,15,1147
18,7,2014,Heaven Club,Eating Out,6,1141
18,7,2014,Heaven Club,Eating Out,9,1132
18,7,2014,Heaven Club,Eating Out,16,1116
19,7,2014,Ministry of Sound ClubXOYO Club,Eating Out,7,1109
19,7,2014,Ministry of Sound ClubXOYO Club,Eating Out,15,1094
19,7,2014,Ministry of Sound ClubXOYO Club,Eating Out,5,1089
19,7,2014,Ministry of Sound ClubXOYO Club,Eating Out,5,1084
20,7,2014,VIRGIN MEDIA PYMTS,Bills,54,1030
21,7,2014,South West Trains,Transport,37,993
21,7,2014,Starbucks Coffee,Eating Out,2,991
21,7,2014,Paying back James,,5,986
22,7,2014,Costa Coffee,Eating Out,2,984
22,7,2014,Greggs,Eating Out,8,976
23,7,2014,Starbucks Coffee,Eating Out,1,975
23,7,2014,ATM Cash Withdrawal,General,20,955
24,7,2014,O2,Bills,38,917
24,7,2014,Greggs,Eating Out,8,909
24,7,2014,ATM Cash Withdrawal,General,20,889
25,7,2014,Morrisons,Groceries,65,824
25,7,2014,Starbucks Coffee,Eating Out,1,823
25,7,2014,Subway,Eating Out,7,816
25,7,2014,Scott's Restaurant,Eating Out,35,781
26,7,2014,Dominos Pizza,Eating Out,58,723
26,7,2014,ATM Cash Withdrawal,General,10,713
26,7,2014,Paying back Julie,,2,711
27,7,2014,Restaurant Gordon RamsayPortland Restaurant,Eating Out,42,669
27,7,2014,Paying back James,,6,663
28,7,2014,South West Trains,Transport,26,637
28,7,2014,Wild Bean Cafe,Eating Out,2,635
28,7,2014,Chicken Cottage,Eating Out,5,630
28,7,2014,ATM Cash Withdrawal,General,10,620
29,7,2014,Starbucks Coffee,Eating Out,1,619
29,7,2014,McDonalds,Eating Out,8,611
29,7,2014,ATM Cash Withdrawal,General,20,591
29,7,2014,Paying back James,,7,584
30,7,2014,Starbucks Coffee,Eating Out,2,582
30,7,2014,McDonalds,Eating Out,6,576
31,7,2014,Caffe Nero,Eating Out,1,575
31,7,2014,The West Cornwall Pasty Company,Eating Out,6,569
1,8,2014,Rhino Sports salary,General,1700,2269
1,8,2014,Waitrose,Groceries,49,2220
1,8,2014,Wild Bean Cafe,Eating Out,1,2219
1,8,2014,Greggs,Eating Out,6,2213
1,8,2014,Heaven Club,Eating Out,12,2201
1,8,2014,Heaven Club,Eating Out,15,2186
1,8,2014,Heaven Club,Eating Out,7,2179
1,8,2014,Heaven Club,Eating Out,14,2165
2,8,2014,Scott's Restaurant,Eating Out,24,2141
2,8,2014,ATM Cash Withdrawal,General,20,2121
2,8,2014,Paying back Julie,,9,2112
3,8,2014,Restaurant Gordon RamsayPortland Restaurant,Eating Out,41,2071
4,8,2014,South West Trains,Transport,27,2044
4,8,2014,Wild Bean Cafe,Eating Out,2,2042
4,8,2014,Pret A Manger,Eating Out,8,2034
5,8,2014,Costa Coffee,Eating Out,2,2032
6,8,2014,Caffe Nero,Eating Out,1,2031
7,8,2014,Cubit and West rent,Rent,550,1481
7,8,2014,Caffe Nero,Eating Out,1,1480
7,8,2014,The West Cornwall Pasty Company,Eating Out,6,1474
8,8,2014,Sainsburys,Groceries,74,1400
8,8,2014,Greggs,Eating Out,7,1393
8,8,2014,Anglo restaurant,Eating Out,24,1369
11,8,2014,South West Trains,Transport,25,1344
11,8,2014,Caffe Nero,Eating Out,2,1342
11,8,2014,Subway,Eating Out,7,1335
12,8,2014,Wild Bean Cafe,Eating Out,2,1333
12,8,2014,Subway,Eating Out,7,1326
13,8,2014,Subway,Eating Out,7,1319
14,8,2014,Caffe Nero,Eating Out,2,1317
14,8,2014,ATM Cash Withdrawal,General,10,1307
15,8,2014,BRGAS-Electricity,Bills,25,1282
15,8,2014,BRGAS-Gas,Bills,23,1259
15,8,2014,Sainsburys,Groceries,83,1176
15,8,2014,Wild Bean Cafe,Eating Out,2,1174
15,8,2014,ATM Cash Withdrawal,General,10,1164
15,8,2014,Tool Shop,,1,1163
16,8,2014,LBS Council Tax,Bills,50,1113
17,8,2014,Dominos Pizza,Eating Out,44,1069
17,8,2014,ATM Cash Withdrawal,General,20,1049
18,8,2014,South West Trains,Transport,28,1021
18,8,2014,Costa Coffee,Eating Out,1,1020
18,8,2014,Greggs,Eating Out,8,1012
19,8,2014,Costa Coffee,Eating Out,2,1010
19,8,2014,Chicken Cottage,Eating Out,5,1005
19,8,2014,Paying back James,,7,998
20,8,2014,VIRGIN MEDIA PYMTS,Bills,43,955
20,8,2014,Wild Bean Cafe,Eating Out,2,953
21,8,2014,Wild Bean Cafe,Eating Out,2,951
21,8,2014,Pret A Manger,Eating Out,5,946
22,8,2014,ASDA,Groceries,71,875
22,8,2014,Costa Coffee,Eating Out,1,874
23,8,2014,ATM Cash Withdrawal,General,20,854
24,8,2014,O2,Bills,35,819
24,8,2014,Pizza Express,Eating Out,48,771
24,8,2014,ATM Cash Withdrawal,General,10,761
25,8,2014,South West Trains,Transport,34,727
25,8,2014,Caffe Nero,Eating Out,2,725
25,8,2014,McDonalds,Eating Out,7,718
26,8,2014,Caffe Nero,Eating Out,2,716
26,8,2014,Pret A Manger,Eating Out,7,709
27,8,2014,The West Cornwall Pasty Company,Eating Out,5,704
27,8,2014,ATM Cash Withdrawal,General,10,694
28,8,2014,Costa Coffee,Eating Out,1,693
28,8,2014,Pret A Manger,Eating Out,5,688
29,8,2014,Tescos,Groceries,42,646
29,8,2014,Caffe Nero,Eating Out,2,644
29,8,2014,Greggs,Eating Out,6,638
29,8,2014,Dominos Pizza,Eating Out,55,583
29,8,2014,ATM Cash Withdrawal,General,10,573
30,8,2014,Pizza Express,Eating Out,31,542
1,9,2014,Rhino Sports salary,General,1700,2242
1,9,2014,South West Trains,Transport,30,2212
1,9,2014,Pret A Manger,Eating Out,7,2205
2,9,2014,Caffe Nero,Eating Out,2,2203
2,9,2014,Pret A Manger,Eating Out,7,2196
4,9,2014,Wild Bean Cafe,Eating Out,2,2194
4,9,2014,Pret A Manger,Eating Out,7,2187
4,9,2014,Cheam Service Station,,2,2185
5,9,2014,Morrisons,Groceries,68,2117
5,9,2014,Costa Coffee,Eating Out,1,2116
5,9,2014,The West Cornwall Pasty Company,Eating Out,8,2108
6,9,2014,Ministry of Sound ClubXOYO Club,Eating Out,7,2101
6,9,2014,Ministry of Sound ClubXOYO Club,Eating Out,13,2088
6,9,2014,Ministry of Sound ClubXOYO Club,Eating Out,14,2074
6,9,2014,Ministry of Sound ClubXOYO Club,Eating Out,15,2059
6,9,2014,Ministry of Sound ClubXOYO Club,Eating Out,6,2053
6,9,2014,Ministry of Sound ClubXOYO Club,Eating Out,5,2048
7,9,2014,Cubit and West rent,Rent,550,1498
7,9,2014,Restaurant Gordon RamsayPortland Restaurant,Eating Out,38,1460
8,9,2014,South West Trains,Transport,31,1429
8,9,2014,Caffe Nero,Eating Out,2,1427
8,9,2014,Chicken Cottage,Eating Out,7,1420
8,9,2014,ATM Cash Withdrawal,General,20,1400
9,9,2014,Caffe Nero,Eating Out,1,1399
10,9,2014,Costa Coffee,Eating Out,1,1398
10,9,2014,Pret A Manger,Eating Out,7,1391
11,9,2014,Caffe Nero,Eating Out,2,1389
11,9,2014,Subway,Eating Out,6,1383
12,9,2014,ASDA,Groceries,53,1330
12,9,2014,Caffe Nero,Eating Out,2,1328
12,9,2014,Restaurant Gordon RamsayPortland Restaurant,Eating Out,28,1300
12,9,2014,ATM Cash Withdrawal,General,20,1280
13,9,2014,Ministry of Sound ClubXOYO Club,Eating Out,12,1268
13,9,2014,Anglo restaurant,Eating Out,55,1213
13,9,2014,ATM Cash Withdrawal,General,20,1193
14,9,2014,Scott's Restaurant,Eating Out,27,1166
14,9,2014,ATM Cash Withdrawal,General,10,1156
15,9,2014,BRGAS-Electricity,Bills,25,1131
15,9,2014,BRGAS-Gas,Bills,36,1095
15,9,2014,South West Trains,Transport,31,1064
15,9,2014,Starbucks Coffee,Eating Out,1,1063
15,9,2014,Greggs,Eating Out,6,1057
16,9,2014,LBS Council Tax,Bills,50,1007
16,9,2014,Subway,Eating Out,8,999
17,9,2014,Caffe Nero,Eating Out,2,997
17,9,2014,Subway,Eating Out,5,992
18,9,2014,Costa Coffee,Eating Out,2,990
18,9,2014,Chicken Cottage,Eating Out,7,983
19,9,2014,Tescos,Groceries,84,899
19,9,2014,Wild Bean Cafe,Eating Out,1,898
19,9,2014,Pizza Express,Eating Out,26,872
20,9,2014,VIRGIN MEDIA PYMTS,Bills,49,823
20,9,2014,The Grand Pub,Eating Out,11,812
20,9,2014,The Grand Pub,Eating Out,12,800
20,9,2014,Pizza Express,Eating Out,33,767
20,9,2014,Paying back James,,8,759
21,9,2014,ATM Cash Withdrawal,General,10,749
22,9,2014,South West Trains,Transport,24,725
22,9,2014,Caffe Nero,Eating Out,2,723
22,9,2014,Chicken Cottage,Eating Out,6,717
22,9,2014,ATM Cash Withdrawal,General,10,707
23,9,2014,Wild Bean Cafe,Eating Out,1,706
23,9,2014,McDonalds,Eating Out,8,698
24,9,2014,O2,Bills,33,665
24,9,2014,Caffe Nero,Eating Out,1,664
25,9,2014,McDonalds,Eating Out,8,656
26,9,2014,Sainsburys,Groceries,88,568
28,9,2014,Tool Tec,,7,561
29,9,2014,South West Trains,Transport,37,524
29,9,2014,Caffe Nero,Eating Out,2,522
29,9,2014,ATM Cash Withdrawal,General,20,502
30,9,2014,Caffe Nero,Eating Out,1,501
30,9,2014,Chicken Cottage,Eating Out,8,493
30,9,2014,Civic Shop,,1,492
1,10,2014,Rhino Sports salary,General,1700,2192
1,10,2014,Caffe Nero,Eating Out,2,2190
2,10,2014,Subway,Eating Out,6,2184
3,10,2014,Waitrose,Groceries,55,2129
3,10,2014,Wild Bean Cafe,Eating Out,2,2127
3,10,2014,Subway,Eating Out,6,2121
3,10,2014,Scott's Restaurant,Eating Out,42,2079
3,10,2014,ATM Cash Withdrawal,General,10,2069
6,10,2014,South West Trains,Transport,32,2037
6,10,2014,Caffe Nero,Eating Out,1,2036
6,10,2014,McDonalds,Eating Out,4,2032
6,10,2014,ATM Cash Withdrawal,General,20,2012
7,10,2014,Cubit and West rent,Rent,550,1462
7,10,2014,Starbucks Coffee,Eating Out,1,1461
7,10,2014,ATM Cash Withdrawal,General,10,1451
8,10,2014,ATM Cash Withdrawal,General,20,1431
9,10,2014,Wild Bean Cafe,Eating Out,2,1429
9,10,2014,McDonalds,Eating Out,7,1422
10,10,2014,Morrisons,Groceries,58,1364
10,10,2014,Caffe Nero,Eating Out,2,1362
11,10,2014,ATM Cash Withdrawal,General,20,1342
13,10,2014,South West Trains,Transport,36,1306
13,10,2014,Costa Coffee,Eating Out,2,1304
13,10,2014,ATM Cash Withdrawal,General,20,1284
14,10,2014,Costa Coffee,Eating Out,2,1282
15,10,2014,BRGAS-Electricity,Bills,29,1253
15,10,2014,BRGAS-Gas,Bills,38,1215
15,10,2014,McDonalds,Eating Out,8,1207
16,10,2014,LBS Council Tax,Bills,50,1157
16,10,2014,Caffe Nero,Eating Out,2,1155
16,10,2014,ATM Cash Withdrawal,General,20,1135
17,10,2014,Tescos,Groceries,86,1049
17,10,2014,Pret A Manger,Eating Out,7,1042
17,10,2014,ATM Cash Withdrawal,General,10,1032
20,10,2014,VIRGIN MEDIA PYMTS,Bills,52,980
20,10,2014,South West Trains,Transport,37,943
20,10,2014,Pret A Manger,Eating Out,5,938
21,10,2014,Wild Bean Cafe,Eating Out,2,936
22,10,2014,Wild Bean Cafe,Eating Out,2,934
22,10,2014,Subway,Eating Out,7,927
23,10,2014,Wild Bean Cafe,Eating Out,1,926
23,10,2014,The West Cornwall Pasty Company,Eating Out,5,921
24,10,2014,O2,Bills,34,887
24,10,2014,Tescos,Groceries,51,836
24,10,2014,Caffe Nero,Eating Out,1,835
25,10,2014,Restaurant Gordon RamsayPortland Restaurant,Eating Out,54,781
26,10,2014,Scott's Restaurant,Eating Out,55,726
27,10,2014,South West Trains,Transport,26,700
27,10,2014,Wild Bean Cafe,Eating Out,2,698
27,10,2014,Chicken Cottage,Eating Out,6,692
27,10,2014,ATM Cash Withdrawal,General,10,682
28,10,2014,Wild Bean Cafe,Eating Out,2,680
28,10,2014,Subway,Eating Out,6,674
29,10,2014,Wild Bean Cafe,Eating Out,2,672
30,10,2014,Wild Bean Cafe,Eating Out,1,671
30,10,2014,Greggs,Eating Out,5,666
30,10,2014,ATM Cash Withdrawal,General,10,656
31,10,2014,ASDA,Groceries,65,591
31,10,2014,Wild Bean Cafe,Eating Out,2,589
31,10,2014,Greggs,Eating Out,5,584
31,10,2014,Fabric Club,Eating Out,16,568
31,10,2014,Fabric Club,Eating Out,16,552
31,10,2014,Fabric Club,Eating Out,13,539
31,10,2014,Fabric Club,Eating Out,10,529
31,10,2014,Dominos Pizza,Eating Out,38,491
1,11,2014,Rhino Sports salary,General,1700,2191
3,11,2014,South West Trains,Transport,35,2156
3,11,2014,Wild Bean Cafe,Eating Out,2,2154
3,11,2014,Pret A Manger,Eating Out,7,2147
4,11,2014,Wild Bean Cafe,Eating Out,2,2145
4,11,2014,McDonalds,Eating Out,7,2138
4,11,2014,ATM Cash Withdrawal,General,20,2118
5,11,2014,Starbucks Coffee,Eating Out,2,2116
6,11,2014,Pret A Manger,Eating Out,6,2110
7,11,2014,Cubit and West rent,Rent,550,1560
7,11,2014,Tescos,Groceries,87,1473
7,11,2014,ATM Cash Withdrawal,General,20,1453
8,11,2014,ATM Cash Withdrawal,General,20,1433
8,11,2014,Tool Shop,,7,1426
9,11,2014,Restaurant Gordon RamsayPortland Restaurant,Eating Out,30,1396
10,11,2014,South West Trains,Transport,29,1367
10,11,2014,Starbucks Coffee,Eating Out,2,1365
10,11,2014,McDonalds,Eating Out,5,1360
11,11,2014,McDonalds,Eating Out,6,1354
11,11,2014,Red Shop,,1,1353
12,11,2014,Costa Coffee,Eating Out,1,1352
12,11,2014,Chicken Cottage,Eating Out,4,1348
13,11,2014,Caffe Nero,Eating Out,1,1347
14,11,2014,Tescos,Groceries,60,1287
14,11,2014,Wild Bean Cafe,Eating Out,2,1285
14,11,2014,Chicken Cottage,Eating Out,5,1280
14,11,2014,ATM Cash Withdrawal,General,10,1270
15,11,2014,BRGAS-Electricity,Bills,61,1209
15,11,2014,BRGAS-Gas,Bills,80,1129
15,11,2014,ATM Cash Withdrawal,General,20,1109
16,11,2014,LBS Council Tax,Bills,50,1059
17,11,2014,South West Trains,Transport,31,1028
17,11,2014,Starbucks Coffee,Eating Out,2,1026
18,11,2014,ATM Cash Withdrawal,General,10,1016
18,11,2014,Paying back Julie,,2,1014
19,11,2014,Costa Coffee,Eating Out,2,1012
20,11,2014,VIRGIN MEDIA PYMTS,Bills,52,960
21,11,2014,Sainsburys,Groceries,68,892
21,11,2014,Caffe Nero,Eating Out,2,890
21,11,2014,Scott's Restaurant,Eating Out,52,838
22,11,2014,Pizza Express,Eating Out,37,801
23,11,2014,Pizza Express,Eating Out,28,773
24,11,2014,O2,Bills,37,736
24,11,2014,South West Trains,Transport,35,701
24,11,2014,Caffe Nero,Eating Out,1,700
24,11,2014,Chicken Cottage,Eating Out,7,693
25,11,2014,Caffe Nero,Eating Out,2,691
25,11,2014,Pret A Manger,Eating Out,4,687
26,11,2014,ATM Cash Withdrawal,General,20,667
27,11,2014,Caffe Nero,Eating Out,2,665
27,11,2014,Pret A Manger,Eating Out,7,658
28,11,2014,Tescos,Groceries,74,584
28,11,2014,Costa Coffee,Eating Out,1,583
28,11,2014,Subway,Eating Out,8,575
28,11,2014,Dominos Pizza,Eating Out,51,524
29,11,2014,Anglo restaurant,Eating Out,51,473
30,11,2014,Restaurant Gordon RamsayPortland Restaurant,Eating Out,32,441
1,12,2014,Rhino Sports salary,General,1700,2141
1,12,2014,South West Trains,Transport,31,2110
1,12,2014,Costa Coffee,Eating Out,1,2109
2,12,2014,Wild Bean Cafe,Eating Out,2,2107
2,12,2014,McDonalds,Eating Out,4,2103
3,12,2014,Costa Coffee,Eating Out,2,2101
3,12,2014,ATM Cash Withdrawal,General,20,2081
4,12,2014,Pret A Manger,Eating Out,8,2073
4,12,2014,ATM Cash Withdrawal,General,10,2063
5,12,2014,Morrisons,Groceries,54,2009
5,12,2014,Costa Coffee,Eating Out,1,2008
5,12,2014,ATM Cash Withdrawal,General,20,1988
6,12,2014,ATM Cash Withdrawal,General,10,1978
7,12,2014,Cubit and West rent,Rent,550,1428
7,12,2014,Dominos Pizza,Eating Out,36,1392
8,12,2014,South West Trains,Transport,35,1357
8,12,2014,Caffe Nero,Eating Out,2,1355
8,12,2014,Greggs,Eating Out,7,1348
9,12,2014,Starbucks Coffee,Eating Out,1,1347
10,12,2014,Wild Bean Cafe,Eating Out,1,1346
11,12,2014,Costa Coffee,Eating Out,2,1344
11,12,2014,Subway,Eating Out,4,1340
12,12,2014,Sainsburys,Groceries,87,1253
12,12,2014,Costa Coffee,Eating Out,1,1252
12,12,2014,Pret A Manger,Eating Out,8,1244
12,12,2014,Anglo restaurant,Eating Out,49,1195
14,12,2014,ATM Cash Withdrawal,General,20,1175
14,12,2014,Tool Shop,,1,1174
15,12,2014,BRGAS-Electricity,Bills,33,1141
15,12,2014,BRGAS-Gas,Bills,44,1097
15,12,2014,South West Trains,Transport,29,1068
15,12,2014,Costa Coffee,Eating Out,1,1067
16,12,2014,LBS Council Tax,Bills,50,1017
16,12,2014,Costa Coffee,Eating Out,1,1016
16,12,2014,Chicken Cottage,Eating Out,6,1010
17,12,2014,Wild Bean Cafe,Eating Out,2,1008
19,12,2014,Tescos,Groceries,51,957
19,12,2014,Starbucks Coffee,Eating Out,1,956
19,12,2014,ATM Cash Withdrawal,General,10,946
20,12,2014,VIRGIN MEDIA PYMTS,Bills,51,895
20,12,2014,Restaurant Gordon RamsayPortland Restaurant,Eating Out,59,836
22,12,2014,South West Trains,Transport,36,800
22,12,2014,Caffe Nero,Eating Out,2,798
22,12,2014,Pret A Manger,Eating Out,5,793
22,12,2014,Tool Tec,,4,789
23,12,2014,Costa Coffee,Eating Out,2,787
23,12,2014,McDonalds,Eating Out,6,781
24,12,2014,O2,Bills,37,744
24,12,2014,Costa Coffee,Eating Out,2,742
25,12,2014,Wild Bean Cafe,Eating Out,1,741
25,12,2014,ATM Cash Withdrawal,General,10,731
26,12,2014,Waitrose,Groceries,74,657
26,12,2014,Costa Coffee,Eating Out,2,655
26,12,2014,Subway,Eating Out,5,650
26,12,2014,Fabric Club,Eating Out,15,635
26,12,2014,Fabric Club,Eating Out,9,626
26,12,2014,Fabric Club,Eating Out,12,614
26,12,2014,Fabric Club,Eating Out,16,598
26,12,2014,Fabric Club,Eating Out,9,589
26,12,2014,Fabric Club,Eating Out,11,578
26,12,2014,ATM Cash Withdrawal,General,20,558
28,12,2014,ATM Cash Withdrawal,General,10,548
29,12,2014,South West Trains,Transport,38,510
29,12,2014,Wild Bean Cafe,Eating Out,2,508
30,12,2014,Costa Coffee,Eating Out,1,507
30,12,2014,Chicken Cottage,Eating Out,8,499
31,12,2014,Caffe Nero,Eating Out,2,497
1,1,2015,Rhino Sports salary,General,1700,2197
1,1,2015,Wild Bean Cafe,Eating Out,1,2196
1,1,2015,The West Cornwall Pasty Company,Eating Out,5,2191
2,1,2015,Morrisons,Groceries,66,2125
2,1,2015,Starbucks Coffee,Eating Out,2,2123
3,1,2015,Pizza Express,Eating Out,45,2078
4,1,2015,Pizza Express,Eating Out,47,2031
4,1,2015,ATM Cash Withdrawal,General,10,2021
5,1,2015,South West Trains,Transport,30,1991
5,1,2015,Starbucks Coffee,Eating Out,2,1989
5,1,2015,Chicken Cottage,Eating Out,5,1984
6,1,2015,Caffe Nero,Eating Out,1,1983
6,1,2015,The West Cornwall Pasty Company,Eating Out,5,1978
6,1,2015,ATM Cash Withdrawal,General,10,1968
7,1,2015,Cubit and West rent,Rent,550,1418
7,1,2015,Wild Bean Cafe,Eating Out,2,1416
8,1,2015,Costa Coffee,Eating Out,2,1414
9,1,2015,Tescos,Groceries,64,1350
9,1,2015,Costa Coffee,Eating Out,1,1349
9,1,2015,Chicken Cottage,Eating Out,5,1344
10,1,2015,Dominos Pizza,Eating Out,44,1300
10,1,2015,ATM Cash Withdrawal,General,10,1290
12,1,2015,South West Trains,Transport,36,1254
12,1,2015,Pret A Manger,Eating Out,7,1247
13,1,2015,Costa Coffee,Eating Out,2,1245
13,1,2015,Chicken Cottage,Eating Out,7,1238
14,1,2015,Caffe Nero,Eating Out,2,1236
14,1,2015,Pret A Manger,Eating Out,5,1231
15,1,2015,BRGAS-Electricity,Bills,34,1197
15,1,2015,BRGAS-Gas,Bills,57,1140
15,1,2015,Caffe Nero,Eating Out,2,1138
15,1,2015,The West Cornwall Pasty Company,Eating Out,7,1131
16,1,2015,LBS Council Tax,Bills,50,1081
16,1,2015,Waitrose,Groceries,44,1037
16,1,2015,Chicken Cottage,Eating Out,6,1031
16,1,2015,Ministry of Sound ClubXOYO Club,Eating Out,9,1022
16,1,2015,Ministry of Sound ClubXOYO Club,Eating Out,11,1011
16,1,2015,Ministry of Sound ClubXOYO Club,Eating Out,13,998
16,1,2015,Ministry of Sound ClubXOYO Club,Eating Out,14,984
16,1,2015,Scott's Restaurant,Eating Out,47,937
19,1,2015,South West Trains,Transport,38,899
19,1,2015,Starbucks Coffee,Eating Out,2,897
19,1,2015,Subway,Eating Out,8,889
19,1,2015,ATM Cash Withdrawal,General,10,879
19,1,2015,Paying back James,,8,871
20,1,2015,VIRGIN MEDIA PYMTS,Bills,32,839
21,1,2015,Caffe Nero,Eating Out,1,838
22,1,2015,Starbucks Coffee,Eating Out,2,836
22,1,2015,Subway,Eating Out,8,828
22,1,2015,ATM Cash Withdrawal,General,10,818
23,1,2015,Morrisons,Groceries,52,766
23,1,2015,Starbucks Coffee,Eating Out,1,765
23,1,2015,Subway,Eating Out,6,759
23,1,2015,Paying back Julie,,8,751
24,1,2015,O2,Bills,31,720
24,1,2015,Dominos Pizza,Eating Out,27,693
25,1,2015,Tool Tec,,7,686
26,1,2015,South West Trains,Transport,30,656
26,1,2015,Subway,Eating Out,5,651
26,1,2015,Paying back James,,6,645
27,1,2015,Caffe Nero,Eating Out,2,643
27,1,2015,Pret A Manger,Eating Out,8,635
28,1,2015,Starbucks Coffee,Eating Out,2,633
28,1,2015,Chicken Cottage,Eating Out,5,628
29,1,2015,Costa Coffee,Eating Out,2,626
29,1,2015,Subway,Eating Out,6,620
30,1,2015,ASDA,Groceries,88,532
31,1,2015,Heaven Club,Eating Out,9,523
31,1,2015,ATM Cash Withdrawal,General,10,513
1,2,2015,Rhino Sports salary,General,1700,2213
1,2,2015,ATM Cash Withdrawal,General,10,2203
2,2,2015,South West Trains,Transport,27,2176
2,2,2015,Starbucks Coffee,Eating Out,2,2174
2,2,2015,Subway,Eating Out,6,2168
2,2,2015,ATM Cash Withdrawal,General,10,2158
4,2,2015,Costa Coffee,Eating Out,2,2156
5,2,2015,Starbucks Coffee,Eating Out,1,2155
5,2,2015,Red Shop,,8,2147
6,2,2015,Tescos,Groceries,60,2087
6,2,2015,Caffe Nero,Eating Out,1,2086
6,2,2015,The West Cornwall Pasty Company,Eating Out,8,2078
6,2,2015,ATM Cash Withdrawal,General,10,2068
6,2,2015,Red Shop,,2,2066
7,2,2015,Cubit and West rent,Rent,550,1516
7,2,2015,Dominos Pizza,Eating Out,48,1468
8,2,2015,Anglo restaurant,Eating Out,46,1422
8,2,2015,ATM Cash Withdrawal,General,20,1402
9,2,2015,South West Trains,Transport,27,1375
9,2,2015,Pret A Manger,Eating Out,7,1368
10,2,2015,Costa Coffee,Eating Out,1,1367
11,2,2015,Pret A Manger,Eating Out,8,1359
11,2,2015,ATM Cash Withdrawal,General,10,1349
13,2,2015,Sainsburys,Groceries,71,1278
14,2,2015,Scott's Restaurant,Eating Out,28,1250
15,2,2015,BRGAS-Electricity,Bills,34,1216
15,2,2015,BRGAS-Gas,Bills,37,1179
15,2,2015,Restaurant Gordon RamsayPortland Restaurant,Eating Out,55,1124
16,2,2015,LBS Council Tax,Bills,50,1074
16,2,2015,South West Trains,Transport,35,1039
16,2,2015,Costa Coffee,Eating Out,2,1037
16,2,2015,The West Cornwall Pasty Company,Eating Out,4,1033
16,2,2015,ATM Cash Withdrawal,General,10,1023
16,2,2015,Civic Shop,,7,1016
17,2,2015,ATM Cash Withdrawal,General,20,996
18,2,2015,Caffe Nero,Eating Out,2,994
19,2,2015,McDonalds,Eating Out,4,990
20,2,2015,VIRGIN MEDIA PYMTS,Bills,51,939
20,2,2015,Tescos,Groceries,80,859
20,2,2015,Caffe Nero,Eating Out,2,857
20,2,2015,Subway,Eating Out,8,849
20,2,2015,Anglo restaurant,Eating Out,42,807
20,2,2015,ATM Cash Withdrawal,General,10,797
21,2,2015,Heaven Club,Eating Out,16,781
21,2,2015,Heaven Club,Eating Out,9,772
21,2,2015,Heaven Club,Eating Out,15,757
21,2,2015,Pizza Express,Eating Out,45,712
23,2,2015,South West Trains,Transport,37,675
23,2,2015,Costa Coffee,Eating Out,1,674
23,2,2015,ATM Cash Withdrawal,General,20,654
24,2,2015,O2,Bills,30,624
24,2,2015,Wild Bean Cafe,Eating Out,1,623
25,2,2015,The West Cornwall Pasty Company,Eating Out,4,619
25,2,2015,ATM Cash Withdrawal,General,20,599
26,2,2015,Caffe Nero,Eating Out,2,597
26,2,2015,Subway,Eating Out,8,589
26,2,2015,Tool Tec,,1,588
27,2,2015,Sainsburys,Groceries,42,546
27,2,2015,Starbucks Coffee,Eating Out,2,544
27,2,2015,Pret A Manger,Eating Out,7,537
27,2,2015,Pizza Express,Eating Out,45,492
28,2,2015,Civic Shop,,2,490
1,3,2015,Rhino Sports salary,General,1700,2190
2,3,2015,South West Trains,Transport,25,2165
2,3,2015,McDonalds,Eating Out,6,2159
3,3,2015,Costa Coffee,Eating Out,2,2157
3,3,2015,Chicken Cottage,Eating Out,5,2152
4,3,2015,Caffe Nero,Eating Out,1,2151
4,3,2015,The West Cornwall Pasty Company,Eating Out,6,2145
5,3,2015,Starbucks Coffee,Eating Out,2,2143
5,3,2015,The West Cornwall Pasty Company,Eating Out,5,2138
5,3,2015,ATM Cash Withdrawal,General,20,2118
6,3,2015,Sainsburys,Groceries,61,2057
6,3,2015,Caffe Nero,Eating Out,1,2056
6,3,2015,ATM Cash Withdrawal,General,10,2046
7,3,2015,Cubit and West rent,Rent,550,1496
7,3,2015,Dominos Pizza,Eating Out,26,1470
8,3,2015,Dominos Pizza,Eating Out,46,1424
9,3,2015,South West Trains,Transport,35,1389
9,3,2015,Starbucks Coffee,Eating Out,2,1387
9,3,2015,McDonalds,Eating Out,4,1383
9,3,2015,Civic Shop,,6,1377
10,3,2015,McDonalds,Eating Out,4,1373
10,3,2015,ATM Cash Withdrawal,General,10,1363
11,3,2015,Starbucks Coffee,Eating Out,1,1362
11,3,2015,Chicken Cottage,Eating Out,5,1357
11,3,2015,ATM Cash Withdrawal,General,20,1337
12,3,2015,Starbucks Coffee,Eating Out,1,1336
12,3,2015,Tool Shop,,3,1333
13,3,2015,ASDA,Groceries,78,1255
13,3,2015,Caffe Nero,Eating Out,2,1253
14,3,2015,Restaurant Gordon RamsayPortland Restaurant,Eating Out,58,1195
14,3,2015,ATM Cash Withdrawal,General,20,1175
15,3,2015,BRGAS-Electricity,Bills,30,1145
15,3,2015,BRGAS-Gas,Bills,32,1113
15,3,2015,Pizza Express,Eating Out,29,1084
16,3,2015,LBS Council Tax,Bills,50,1034
16,3,2015,South West Trains,Transport,35,999
16,3,2015,Wild Bean Cafe,Eating Out,1,998
16,3,2015,McDonalds,Eating Out,6,992
16,3,2015,ATM Cash Withdrawal,General,10,982
16,3,2015,Paying back James,,8,974
17,3,2015,Costa Coffee,Eating Out,1,973
17,3,2015,Subway,Eating Out,7,966
18,3,2015,Wild Bean Cafe,Eating Out,2,964
18,3,2015,Chicken Cottage,Eating Out,5,959
18,3,2015,Red Shop,,6,953
19,3,2015,Starbucks Coffee,Eating Out,1,952
19,3,2015,McDonalds,Eating Out,6,946
20,3,2015,VIRGIN MEDIA PYMTS,Bills,40,906
20,3,2015,Tescos,Groceries,76,830
20,3,2015,Starbucks Coffee,Eating Out,2,828
20,3,2015,Anglo restaurant,Eating Out,38,790
20,3,2015,Tool Shop,,9,781
21,3,2015,Cheam Service Station,,3,778
23,3,2015,South West Trains,Transport,26,752
23,3,2015,Pret A Manger,Eating Out,4,748
24,3,2015,O2,Bills,38,710
24,3,2015,Caffe Nero,Eating Out,1,709
24,3,2015,Greggs,Eating Out,7,702
25,3,2015,Wild Bean Cafe,Eating Out,2,700
25,3,2015,Greggs,Eating Out,5,695
25,3,2015,ATM Cash Withdrawal,General,10,685
26,3,2015,Starbucks Coffee,Eating Out,1,684
26,3,2015,Subway,Eating Out,6,678
27,3,2015,Morrisons,Groceries,70,608
27,3,2015,Pret A Manger,Eating Out,5,603
27,3,2015,Fabric Club,Eating Out,14,589
27,3,2015,Fabric Club,Eating Out,15,574
30,3,2015,South West Trains,Transport,32,542
30,3,2015,Costa Coffee,Eating Out,1,541
30,3,2015,Greggs,Eating Out,6,535
30,3,2015,ATM Cash Withdrawal,General,10,525
31,3,2015,Pret A Manger,Eating Out,7,518
31,3,2015,ATM Cash Withdrawal,General,10,508
1,4,2015,Rhino Sports salary,General,1700,2208
1,4,2015,Costa Coffee,Eating Out,2,2206
1,4,2015,McDonalds,Eating Out,4,2202
2,4,2015,Caffe Nero,Eating Out,1,2201
2,4,2015,Subway,Eating Out,4,2197
3,4,2015,Tescos,Groceries,62,2135
3,4,2015,Chicken Cottage,Eating Out,6,2129
3,4,2015,ATM Cash Withdrawal,General,10,2119
3,4,2015,Tool Shop,,9,2110
5,4,2015,Anglo restaurant,Eating Out,49,2061
6,4,2015,South West Trains,Transport,31,2030
7,4,2015,Cubit and West rent,Rent,550,1480
7,4,2015,Starbucks Coffee,Eating Out,1,1479
7,4,2015,ATM Cash Withdrawal,General,20,1459
8,4,2015,Costa Coffee,Eating Out,2,1457
9,4,2015,Starbucks Coffee,Eating Out,2,1455
9,4,2015,The West Cornwall Pasty Company,Eating Out,4,1451
10,4,2015,Morrisons,Groceries,65,1386
10,4,2015,Wild Bean Cafe,Eating Out,1,1385
10,4,2015,Chicken Cottage,Eating Out,4,1381
11,4,2015,Paying back Julie,,1,1380
13,4,2015,South West Trains,Transport,31,1349
13,4,2015,Caffe Nero,Eating Out,2,1347
13,4,2015,Pret A Manger,Eating Out,6,1341
14,4,2015,Chicken Cottage,Eating Out,5,1336
14,4,2015,ATM Cash Withdrawal,General,10,1326
15,4,2015,BRGAS-Electricity,Bills,32,1294
15,4,2015,BRGAS-Gas,Bills,33,1261
15,4,2015,The West Cornwall Pasty Company,Eating Out,7,1254
16,4,2015,LBS Council Tax,Bills,50,1204
16,4,2015,Starbucks Coffee,Eating Out,2,1202
16,4,2015,Pret A Manger,Eating Out,7,1195
17,4,2015,Morrisons,Groceries,64,1131
17,4,2015,Wild Bean Cafe,Eating Out,1,1130
17,4,2015,ATM Cash Withdrawal,General,10,1120
18,4,2015,The Grand Pub,Eating Out,9,1111
18,4,2015,The Grand Pub,Eating Out,14,1097
18,4,2015,The Grand Pub,Eating Out,16,1081
18,4,2015,Pizza Express,Eating Out,39,1042
18,4,2015,ATM Cash Withdrawal,General,20,1022
20,4,2015,VIRGIN MEDIA PYMTS,Bills,30,992
20,4,2015,South West Trains,Transport,24,968
20,4,2015,Caffe Nero,Eating Out,1,967
21,4,2015,Wild Bean Cafe,Eating Out,1,966
22,4,2015,Costa Coffee,Eating Out,2,964
22,4,2015,The West Cornwall Pasty Company,Eating Out,5,959
23,4,2015,Starbucks Coffee,Eating Out,2,957
24,4,2015,O2,Bills,34,923
24,4,2015,Morrisons,Groceries,52,871
24,4,2015,Costa Coffee,Eating Out,2,869
25,4,2015,Ministry of Sound ClubXOYO Club,Eating Out,9,860
25,4,2015,Ministry of Sound ClubXOYO Club,Eating Out,14,846
25,4,2015,Ministry of Sound ClubXOYO Club,Eating Out,11,835
25,4,2015,Scott's Restaurant,Eating Out,28,807
27,4,2015,South West Trains,Transport,35,772
27,4,2015,Costa Coffee,Eating Out,2,770
28,4,2015,Subway,Eating Out,6,764
29,4,2015,Starbucks Coffee,Eating Out,1,763
29,4,2015,McDonalds,Eating Out,7,756
30,4,2015,Costa Coffee,Eating Out,1,755
30,4,2015,The West Cornwall Pasty Company,Eating Out,4,751
1,5,2015,Rhino Sports salary,General,1700,2451
1,5,2015,ASDA,Groceries,53,2398
1,5,2015,Costa Coffee,Eating Out,2,2396
1,5,2015,McDonalds,Eating Out,8,2388
1,5,2015,Paying back Julie,,9,2379
2,5,2015,Scott's Restaurant,Eating Out,34,2345
3,5,2015,Scott's Restaurant,Eating Out,37,2308
4,5,2015,South West Trains,Transport,31,2277
4,5,2015,McDonalds,Eating Out,4,2273
5,5,2015,Wild Bean Cafe,Eating Out,2,2271
6,5,2015,Greggs,Eating Out,8,2263
7,5,2015,Cubit and West rent,Rent,550,1713
7,5,2015,Caffe Nero,Eating Out,1,1712
7,5,2015,ATM Cash Withdrawal,General,10,1702
8,5,2015,ASDA,Groceries,78,1624
8,5,2015,Costa Coffee,Eating Out,2,1622
8,5,2015,Restaurant Gordon RamsayPortland Restaurant,Eating Out,46,1576
9,5,2015,The Grand Pub,Eating Out,9,1567
9,5,2015,The Grand Pub,Eating Out,12,1555
9,5,2015,The Grand Pub,Eating Out,9,1546
10,5,2015,Scott's Restaurant,Eating Out,27,1519
11,5,2015,South West Trains,Transport,33,1486
11,5,2015,Starbucks Coffee,Eating Out,2,1484
11,5,2015,Greggs,Eating Out,5,1479
11,5,2015,Red Shop,,5,1474
12,5,2015,Costa Coffee,Eating Out,2,1472
12,5,2015,ATM Cash Withdrawal,General,10,1462
13,5,2015,Starbucks Coffee,Eating Out,2,1460
14,5,2015,Tool Tec,,2,1458
15,5,2015,BRGAS-Electricity,Bills,23,1435
15,5,2015,BRGAS-Gas,Bills,43,1392
15,5,2015,Morrisons,Groceries,64,1328
15,5,2015,Caffe Nero,Eating Out,2,1326
15,5,2015,Pret A Manger,Eating Out,6,1320
15,5,2015,Cheam Service Station,,5,1315
16,5,2015,LBS Council Tax,Bills,50,1265
16,5,2015,Dominos Pizza,Eating Out,47,1218
18,5,2015,South West Trains,Transport,38,1180
18,5,2015,Starbucks Coffee,Eating Out,2,1178
19,5,2015,Starbucks Coffee,Eating Out,2,1176
19,5,2015,Subway,Eating Out,7,1169
19,5,2015,ATM Cash Withdrawal,General,10,1159
20,5,2015,VIRGIN MEDIA PYMTS,Bills,35,1124
20,5,2015,Caffe Nero,Eating Out,1,1123
20,5,2015,ATM Cash Withdrawal,General,10,1113
21,5,2015,Starbucks Coffee,Eating Out,1,1112
21,5,2015,Subway,Eating Out,4,1108
22,5,2015,Morrisons,Groceries,44,1064
22,5,2015,Caffe Nero,Eating Out,2,1062
22,5,2015,Scott's Restaurant,Eating Out,43,1019
22,5,2015,ATM Cash Withdrawal,General,20,999
24,5,2015,O2,Bills,35,964
25,5,2015,South West Trains,Transport,26,938
25,5,2015,Greggs,Eating Out,6,932
25,5,2015,ATM Cash Withdrawal,General,10,922
27,5,2015,Wild Bean Cafe,Eating Out,2,920
27,5,2015,Pret A Manger,Eating Out,8,912
28,5,2015,Costa Coffee,Eating Out,2,910
28,5,2015,McDonalds,Eating Out,5,905
28,5,2015,ATM Cash Withdrawal,General,20,885
29,5,2015,ASDA,Groceries,49,836
29,5,2015,Starbucks Coffee,Eating Out,2,834
29,5,2015,Subway,Eating Out,7,827
29,5,2015,ATM Cash Withdrawal,General,20,807
30,5,2015,Restaurant Gordon RamsayPortland Restaurant,Eating Out,43,764
1,6,2015,Rhino Sports salary,General,1700,2464
1,6,2015,South West Trains,Transport,28,2436
1,6,2015,Caffe Nero,Eating Out,2,2434
1,6,2015,Subway,Eating Out,8,2426
1,6,2015,ATM Cash Withdrawal,General,20,2406
2,6,2015,Costa Coffee,Eating Out,2,2404
2,6,2015,Red Shop,,6,2398
3,6,2015,Caffe Nero,Eating Out,1,2397
3,6,2015,The West Cornwall Pasty Company,Eating Out,7,2390
4,6,2015,Greggs,Eating Out,7,2383
4,6,2015,ATM Cash Withdrawal,General,20,2363
5,6,2015,Waitrose,Groceries,83,2280
5,6,2015,Wild Bean Cafe,Eating Out,2,2278
5,6,2015,Greggs,Eating Out,8,2270
5,6,2015,Ministry of Sound ClubXOYO Club,Eating Out,11,2259
5,6,2015,Ministry of Sound ClubXOYO Club,Eating Out,9,2250
5,6,2015,Ministry of Sound ClubXOYO Club,Eating Out,11,2239
5,6,2015,Ministry of Sound ClubXOYO Club,Eating Out,15,2224
6,6,2015,Dominos Pizza,Eating Out,58,2166
6,6,2015,ATM Cash Withdrawal,General,20,2146
6,6,2015,Red Shop,,8,2138
7,6,2015,Cubit and West rent,Rent,550,1588
8,6,2015,South West Trains,Transport,26,1562
8,6,2015,Starbucks Coffee,Eating Out,2,1560
8,6,2015,McDonalds,Eating Out,7,1553
9,6,2015,Subway,Eating Out,4,1549
9,6,2015,ATM Cash Withdrawal,General,20,1529
10,6,2015,Starbucks Coffee,Eating Out,2,1527
10,6,2015,The West Cornwall Pasty Company,Eating Out,6,1521
10,6,2015,ATM Cash Withdrawal,General,10,1511
10,6,2015,Cheam Service Station,,6,1505
11,6,2015,Starbucks Coffee,Eating Out,2,1503
11,6,2015,Pret A Manger,Eating Out,7,1496
12,6,2015,Morrisons,Groceries,46,1450
12,6,2015,Wild Bean Cafe,Eating Out,2,1448
13,6,2015,ATM Cash Withdrawal,General,10,1438
13,6,2015,Tool Tec,,7,1431
15,6,2015,BRGAS-Electricity,Bills,30,1401
15,6,2015,BRGAS-Gas,Bills,21,1380
15,6,2015,South West Trains,Transport,29,1351
15,6,2015,Costa Coffee,Eating Out,1,1350
15,6,2015,Tool Shop,,5,1345
16,6,2015,LBS Council Tax,Bills,50,1295
17,6,2015,Costa Coffee,Eating Out,2,1293
18,6,2015,Costa Coffee,Eating Out,2,1291
18,6,2015,McDonalds,Eating Out,7,1284
19,6,2015,Sainsburys,Groceries,73,1211
19,6,2015,Caffe Nero,Eating Out,2,1209
19,6,2015,Dominos Pizza,Eating Out,51,1158
20,6,2015,VIRGIN MEDIA PYMTS,Bills,33,1125
22,6,2015,South West Trains,Transport,31,1094
23,6,2015,Caffe Nero,Eating Out,2,1092
23,6,2015,ATM Cash Withdrawal,General,10,1082
24,6,2015,O2,Bills,32,1050
24,6,2015,Wild Bean Cafe,Eating Out,2,1048
25,6,2015,Wild Bean Cafe,Eating Out,1,1047
25,6,2015,The West Cornwall Pasty Company,Eating Out,5,1042
26,6,2015,Morrisons,Groceries,61,981
26,6,2015,Wild Bean Cafe,Eating Out,1,980
26,6,2015,Greggs,Eating Out,7,973
26,6,2015,Anglo restaurant,Eating Out,32,941
26,6,2015,ATM Cash Withdrawal,General,10,931
28,6,2015,Scott's Restaurant,Eating Out,51,880
28,6,2015,ATM Cash Withdrawal,General,20,860
29,6,2015,South West Trains,Transport,38,822
29,6,2015,Wild Bean Cafe,Eating Out,2,820
30,6,2015,Wild Bean Cafe,Eating Out,1,819
30,6,2015,Subway,Eating Out,5,814
1,7,2015,Rhino Sports salary,General,1700,2514
2,7,2015,Costa Coffee,Eating Out,2,2512
2,7,2015,Greggs,Eating Out,8,2504
3,7,2015,ASDA,Groceries,73,2431
3,7,2015,Costa Coffee,Eating Out,1,2430
3,7,2015,Pizza Express,Eating Out,37,2393
6,7,2015,South West Trains,Transport,29,2364
6,7,2015,McDonalds,Eating Out,5,2359
7,7,2015,Cubit and West rent,Rent,550,1809
7,7,2015,Costa Coffee,Eating Out,1,1808
7,7,2015,Chicken Cottage,Eating Out,8,1800
8,7,2015,Starbucks Coffee,Eating Out,2,1798
9,7,2015,Caffe Nero,Eating Out,1,1797
10,7,2015,Morrisons,Groceries,76,1721
10,7,2015,Wild Bean Cafe,Eating Out,1,1720
10,7,2015,Chicken Cottage,Eating Out,8,1712
11,7,2015,Restaurant Gordon RamsayPortland Restaurant,Eating Out,29,1683
12,7,2015,Dominos Pizza,Eating Out,47,1636
13,7,2015,South West Trains,Transport,32,1604
14,7,2015,Costa Coffee,Eating Out,1,1603
14,7,2015,Greggs,Eating Out,4,1599
15,7,2015,BRGAS-Electricity,Bills,30,1569
15,7,2015,BRGAS-Gas,Bills,35,1534
15,7,2015,Costa Coffee,Eating Out,2,1532
15,7,2015,Greggs,Eating Out,4,1528
15,7,2015,ATM Cash Withdrawal,General,20,1508
15,7,2015,Paying back James,,5,1503
16,7,2015,LBS Council Tax,Bills,50,1453
16,7,2015,Starbucks Coffee,Eating Out,2,1451
16,7,2015,McDonalds,Eating Out,5,1446
16,7,2015,ATM Cash Withdrawal,General,20,1426
17,7,2015,Tescos,Groceries,58,1368
17,7,2015,Costa Coffee,Eating Out,2,1366
17,7,2015,Anglo restaurant,Eating Out,44,1322
19,7,2015,Pizza Express,Eating Out,54,1268
19,7,2015,ATM Cash Withdrawal,General,10,1258
20,7,2015,VIRGIN MEDIA PYMTS,Bills,38,1220
20,7,2015,South West Trains,Transport,34,1186
20,7,2015,Wild Bean Cafe,Eating Out,2,1184
20,7,2015,McDonalds,Eating Out,5,1179
20,7,2015,ATM Cash Withdrawal,General,20,1159
21,7,2015,Starbucks Coffee,Eating Out,1,1158
21,7,2015,Chicken Cottage,Eating Out,8,1150
21,7,2015,ATM Cash Withdrawal,General,20,1130
22,7,2015,Costa Coffee,Eating Out,1,1129
23,7,2015,Costa Coffee,Eating Out,2,1127
23,7,2015,Chicken Cottage,Eating Out,5,1122
24,7,2015,O2,Bills,31,1091
24,7,2015,Sainsburys,Groceries,46,1045
24,7,2015,Starbucks Coffee,Eating Out,2,1043
24,7,2015,Chicken Cottage,Eating Out,8,1035
27,7,2015,South West Trains,Transport,29,1006
28,7,2015,Starbucks Coffee,Eating Out,1,1005
28,7,2015,The West Cornwall Pasty Company,Eating Out,5,1000
30,7,2015,Costa Coffee,Eating Out,1,999
30,7,2015,McDonalds,Eating Out,8,991
30,7,2015,Red Shop,,5,986
31,7,2015,Morrisons,Groceries,70,916
31,7,2015,Wild Bean Cafe,Eating Out,2,914
31,7,2015,Dominos Pizza,Eating Out,59,855
1,8,2015,Rhino Sports salary,General,1700,2555
3,8,2015,South West Trains,Transport,34,2521
3,8,2015,Wild Bean Cafe,Eating Out,2,2519
3,8,2015,Greggs,Eating Out,6,2513
4,8,2015,Costa Coffee,Eating Out,1,2512
4,8,2015,McDonalds,Eating Out,8,2504
4,8,2015,ATM Cash Withdrawal,General,20,2484
5,8,2015,Starbucks Coffee,Eating Out,1,2483
5,8,2015,Greggs,Eating Out,8,2475
6,8,2015,Starbucks Coffee,Eating Out,1,2474
6,8,2015,Chicken Cottage,Eating Out,6,2468
7,8,2015,Cubit and West rent,Rent,550,1918
7,8,2015,ASDA,Groceries,61,1857
7,8,2015,Caffe Nero,Eating Out,1,1856
7,8,2015,Subway,Eating Out,6,1850
9,8,2015,ATM Cash Withdrawal,General,10,1840
10,8,2015,South West Trains,Transport,29,1811
10,8,2015,Subway,Eating Out,6,1805
11,8,2015,Chicken Cottage,Eating Out,8,1797
12,8,2015,The West Cornwall Pasty Company,Eating Out,8,1789
13,8,2015,Subway,Eating Out,6,1783
14,8,2015,ASDA,Groceries,54,1729
14,8,2015,Paying back James,,5,1724
15,8,2015,BRGAS-Electricity,Bills,30,1694
15,8,2015,BRGAS-Gas,Bills,26,1668
15,8,2015,Restaurant Gordon RamsayPortland Restaurant,Eating Out,38,1630
16,8,2015,LBS Council Tax,Bills,50,1580
16,8,2015,ATM Cash Withdrawal,General,20,1560
17,8,2015,South West Trains,Transport,31,1529
17,8,2015,Caffe Nero,Eating Out,1,1528
17,8,2015,McDonalds,Eating Out,8,1520
17,8,2015,Red Shop,,4,1516
18,8,2015,Costa Coffee,Eating Out,1,1515
18,8,2015,The West Cornwall Pasty Company,Eating Out,8,1507
19,8,2015,Caffe Nero,Eating Out,1,1506
19,8,2015,Chicken Cottage,Eating Out,6,1500
19,8,2015,ATM Cash Withdrawal,General,20,1480
20,8,2015,VIRGIN MEDIA PYMTS,Bills,52,1428
20,8,2015,Subway,Eating Out,5,1423
21,8,2015,Sainsburys,Groceries,80,1343
21,8,2015,Wild Bean Cafe,Eating Out,1,1342
21,8,2015,Civic Shop,,9,1333
22,8,2015,Scott's Restaurant,Eating Out,59,1274
23,8,2015,Anglo restaurant,Eating Out,47,1227
24,8,2015,O2,Bills,30,1197
24,8,2015,South West Trains,Transport,32,1165
24,8,2015,Costa Coffee,Eating Out,2,1163
25,8,2015,ATM Cash Withdrawal,General,10,1153
25,8,2015,Paying back James,,4,1149
26,8,2015,Costa Coffee,Eating Out,1,1148
27,8,2015,Caffe Nero,Eating Out,1,1147
27,8,2015,ATM Cash Withdrawal,General,20,1127
27,8,2015,Paying back Julie,,8,1119
28,8,2015,Waitrose,Groceries,52,1067
28,8,2015,Chicken Cottage,Eating Out,5,1062
28,8,2015,ATM Cash Withdrawal,General,20,1042
28,8,2015,Red Shop,,8,1034
29,8,2015,Ministry of Sound ClubXOYO Club,Eating Out,8,1026
29,8,2015,Ministry of Sound ClubXOYO Club,Eating Out,5,1021
29,8,2015,Ministry of Sound ClubXOYO Club,Eating Out,12,1009
30,8,2015,Restaurant Gordon RamsayPortland Restaurant,Eating Out,25,984
31,8,2015,South West Trains,Transport,31,953
31,8,2015,Costa Coffee,Eating Out,2,951
31,8,2015,McDonalds,Eating Out,4,947
31,8,2015,ATM Cash Withdrawal,General,20,927
1,9,2015,Rhino Sports salary,General,1700,2627
1,9,2015,Tool Tec,,5,2622
2,9,2015,The West Cornwall Pasty Company,Eating Out,8,2614
3,9,2015,Starbucks Coffee,Eating Out,2,2612
4,9,2015,Tescos,Groceries,83,2529
4,9,2015,Starbucks Coffee,Eating Out,1,2528
4,9,2015,ATM Cash Withdrawal,General,10,2518
5,9,2015,The Grand Pub,Eating Out,11,2507
5,9,2015,The Grand Pub,Eating Out,16,2491
5,9,2015,Scott's Restaurant,Eating Out,42,2449
7,9,2015,Cubit and West rent,Rent,550,1899
7,9,2015,South West Trains,Transport,33,1866
7,9,2015,Wild Bean Cafe,Eating Out,1,1865
7,9,2015,Greggs,Eating Out,7,1858
8,9,2015,The West Cornwall Pasty Company,Eating Out,5,1853
9,9,2015,Costa Coffee,Eating Out,2,1851
9,9,2015,McDonalds,Eating Out,8,1843
10,9,2015,Greggs,Eating Out,5,1838
11,9,2015,Tescos,Groceries,49,1789
11,9,2015,Wild Bean Cafe,Eating Out,1,1788
11,9,2015,Greggs,Eating Out,6,1782
12,9,2015,Heaven Club,Eating Out,6,1776
12,9,2015,Heaven Club,Eating Out,7,1769
12,9,2015,Heaven Club,Eating Out,10,1759
12,9,2015,Heaven Club,Eating Out,13,1746
12,9,2015,Heaven Club,Eating Out,16,1730
13,9,2015,Dominos Pizza,Eating Out,49,1681
13,9,2015,ATM Cash Withdrawal,General,20,1661
14,9,2015,South West Trains,Transport,30,1631
14,9,2015,Starbucks Coffee,Eating Out,1,1630
14,9,2015,Subway,Eating Out,8,1622
14,9,2015,ATM Cash Withdrawal,General,10,1612
15,9,2015,BRGAS-Electricity,Bills,21,1591
15,9,2015,BRGAS-Gas,Bills,24,1567
15,9,2015,Wild Bean Cafe,Eating Out,2,1565
15,9,2015,ATM Cash Withdrawal,General,20,1545
16,9,2015,LBS Council Tax,Bills,50,1495
16,9,2015,Pret A Manger,Eating Out,8,1487
17,9,2015,Wild Bean Cafe,Eating Out,2,1485
18,9,2015,Sainsburys,Groceries,58,1427
18,9,2015,Caffe Nero,Eating Out,2,1425
18,9,2015,McDonalds,Eating Out,8,1417
18,9,2015,Anglo restaurant,Eating Out,52,1365
19,9,2015,Restaurant Gordon RamsayPortland Restaurant,Eating Out,42,1323
19,9,2015,Tool Shop,,8,1315
20,9,2015,VIRGIN MEDIA PYMTS,Bills,28,1287
20,9,2015,Anglo restaurant,Eating Out,39,1248
20,9,2015,Tool Shop,,3,1245
21,9,2015,South West Trains,Transport,27,1218
21,9,2015,Costa Coffee,Eating Out,2,1216
21,9,2015,ATM Cash Withdrawal,General,10,1206
22,9,2015,Wild Bean Cafe,Eating Out,2,1204
22,9,2015,The West Cornwall Pasty Company,Eating Out,7,1197
23,9,2015,Wild Bean Cafe,Eating Out,2,1195
24,9,2015,O2,Bills,32,1163
24,9,2015,Caffe Nero,Eating Out,2,1161
24,9,2015,Subway,Eating Out,6,1155
24,9,2015,ATM Cash Withdrawal,General,10,1145
25,9,2015,Tescos,Groceries,47,1098
25,9,2015,Chicken Cottage,Eating Out,6,1092
25,9,2015,Restaurant Gordon RamsayPortland Restaurant,Eating Out,47,1045
25,9,2015,ATM Cash Withdrawal,General,10,1035
25,9,2015,Tool Tec,,2,1033
26,9,2015,ATM Cash Withdrawal,General,20,1013
26,9,2015,Cheam Service Station,,9,1004
27,9,2015,Cheam Service Station,,1,1003
28,9,2015,South West Trains,Transport,38,965
28,9,2015,Costa Coffee,Eating Out,2,963
28,9,2015,Subway,Eating Out,5,958
28,9,2015,ATM Cash Withdrawal,General,20,938
29,9,2015,Costa Coffee,Eating Out,1,937
29,9,2015,ATM Cash Withdrawal,General,20,917
30,9,2015,Costa Coffee,Eating Out,1,916
1,10,2015,Rhino Sports salary,General,1700,2616
1,10,2015,Greggs,Eating Out,5,2611
2,10,2015,Morrisons,Groceries,53,2558
2,10,2015,Wild Bean Cafe,Eating Out,1,2557
2,10,2015,The West Cornwall Pasty Company,Eating Out,7,2550
2,10,2015,Restaurant Gordon RamsayPortland Restaurant,Eating Out,26,2524
2,10,2015,ATM Cash Withdrawal,General,20,2504
3,10,2015,Anglo restaurant,Eating Out,31,2473
4,10,2015,Tool Tec,,8,2465
5,10,2015,South West Trains,Transport,26,2439
5,10,2015,The West Cornwall Pasty Company,Eating Out,7,2432
5,10,2015,Cheam Service Station,,5,2427
6,10,2015,Costa Coffee,Eating Out,2,2425
7,10,2015,Cubit and West rent,Rent,550,1875
7,10,2015,Starbucks Coffee,Eating Out,1,1874
8,10,2015,Starbucks Coffee,Eating Out,1,1873
8,10,2015,Pret A Manger,Eating Out,7,1866
8,10,2015,Tool Shop,,2,1864
9,10,2015,Sainsburys,Groceries,49,1815
9,10,2015,Starbucks Coffee,Eating Out,2,1813
9,10,2015,The West Cornwall Pasty Company,Eating Out,5,1808
9,10,2015,Fabric Club,Eating Out,6,1802
9,10,2015,Fabric Club,Eating Out,7,1795
9,10,2015,Fabric Club,Eating Out,11,1784
9,10,2015,Fabric Club,Eating Out,13,1771
9,10,2015,Fabric Club,Eating Out,8,1763
10,10,2015,Restaurant Gordon RamsayPortland Restaurant,Eating Out,42,1721
10,10,2015,ATM Cash Withdrawal,General,20,1701
12,10,2015,South West Trains,Transport,28,1673
12,10,2015,Costa Coffee,Eating Out,1,1672
12,10,2015,McDonalds,Eating Out,8,1664
13,10,2015,Greggs,Eating Out,6,1658
14,10,2015,Starbucks Coffee,Eating Out,2,1656
14,10,2015,McDonalds,Eating Out,6,1650
14,10,2015,ATM Cash Withdrawal,General,20,1630
15,10,2015,BRGAS-Electricity,Bills,36,1594
15,10,2015,BRGAS-Gas,Bills,28,1566
15,10,2015,Starbucks Coffee,Eating Out,2,1564
15,10,2015,The West Cornwall Pasty Company,Eating Out,6,1558
16,10,2015,LBS Council Tax,Bills,50,1508
16,10,2015,Sainsburys,Groceries,62,1446
16,10,2015,Starbucks Coffee,Eating Out,1,1445
16,10,2015,Subway,Eating Out,5,1440
16,10,2015,ATM Cash Withdrawal,General,10,1430
17,10,2015,ATM Cash Withdrawal,General,10,1420
18,10,2015,Scott's Restaurant,Eating Out,25,1395
19,10,2015,South West Trains,Transport,32,1363
19,10,2015,Caffe Nero,Eating Out,2,1361
19,10,2015,Chicken Cottage,Eating Out,6,1355
20,10,2015,VIRGIN MEDIA PYMTS,Bills,53,1302
20,10,2015,Starbucks Coffee,Eating Out,2,1300
20,10,2015,Subway,Eating Out,6,1294
20,10,2015,ATM Cash Withdrawal,General,10,1284
21,10,2015,Starbucks Coffee,Eating Out,2,1282
21,10,2015,The West Cornwall Pasty Company,Eating Out,5,1277
22,10,2015,Starbucks Coffee,Eating Out,2,1275
22,10,2015,Civic Shop,,7,1268
23,10,2015,Tescos,Groceries,86,1182
23,10,2015,Starbucks Coffee,Eating Out,1,1181
24,10,2015,O2,Bills,36,1145
24,10,2015,Heaven Club,Eating Out,14,1131
24,10,2015,Heaven Club,Eating Out,6,1125
24,10,2015,Heaven Club,Eating Out,14,1111
24,10,2015,Restaurant Gordon RamsayPortland Restaurant,Eating Out,29,1082
25,10,2015,Pizza Express,Eating Out,37,1045
26,10,2015,South West Trains,Transport,33,1012
26,10,2015,Costa Coffee,Eating Out,1,1011
26,10,2015,Pret A Manger,Eating Out,8,1003
26,10,2015,ATM Cash Withdrawal,General,10,993
26,10,2015,Civic Shop,,8,985
27,10,2015,Greggs,Eating Out,8,977
27,10,2015,ATM Cash Withdrawal,General,10,967
28,10,2015,McDonalds,Eating Out,5,962
28,10,2015,ATM Cash Withdrawal,General,10,952
29,10,2015,Paying back Julie,,4,948
30,10,2015,Waitrose,Groceries,69,879
30,10,2015,McDonalds,Eating Out,6,873
30,10,2015,Dominos Pizza,Eating Out,42,831
31,10,2015,Civic Shop,,5,826
1,11,2015,Rhino Sports salary,General,1700,2526
1,11,2015,Anglo restaurant,Eating Out,52,2474
2,11,2015,South West Trains,Transport,25,2449
2,11,2015,Costa Coffee,Eating Out,2,2447
3,11,2015,Wild Bean Cafe,Eating Out,2,2445
3,11,2015,ATM Cash Withdrawal,General,20,2425
4,11,2015,Chicken Cottage,Eating Out,8,2417
5,11,2015,Wild Bean Cafe,Eating Out,1,2416
6,11,2015,Sainsburys,Groceries,89,2327
6,11,2015,Wild Bean Cafe,Eating Out,2,2325
6,11,2015,Scott's Restaurant,Eating Out,58,2267
7,11,2015,Cubit and West rent,Rent,550,1717
7,11,2015,Fabric Club,Eating Out,16,1701
7,11,2015,Fabric Club,Eating Out,9,1692
7,11,2015,Fabric Club,Eating Out,12,1680
7,11,2015,Fabric Club,Eating Out,14,1666
8,11,2015,ATM Cash Withdrawal,General,10,1656
9,11,2015,South West Trains,Transport,30,1626
9,11,2015,Starbucks Coffee,Eating Out,1,1625
9,11,2015,The West Cornwall Pasty Company,Eating Out,6,1619
11,11,2015,Starbucks Coffee,Eating Out,2,1617
11,11,2015,Subway,Eating Out,5,1612
12,11,2015,Starbucks Coffee,Eating Out,1,1611
13,11,2015,Morrisons,Groceries,85,1526
13,11,2015,Caffe Nero,Eating Out,2,1524
13,11,2015,Pret A Manger,Eating Out,6,1518
13,11,2015,Scott's Restaurant,Eating Out,30,1488
15,11,2015,BRGAS-Electricity,Bills,56,1432
15,11,2015,BRGAS-Gas,Bills,66,1366
15,11,2015,ATM Cash Withdrawal,General,10,1356
16,11,2015,LBS Council Tax,Bills,50,1306
16,11,2015,South West Trains,Transport,32,1274
16,11,2015,ATM Cash Withdrawal,General,20,1254
17,11,2015,Costa Coffee,Eating Out,2,1252
18,11,2015,Wild Bean Cafe,Eating Out,1,1251
18,11,2015,ATM Cash Withdrawal,General,10,1241
19,11,2015,Caffe Nero,Eating Out,1,1240
19,11,2015,Subway,Eating Out,7,1233
20,11,2015,VIRGIN MEDIA PYMTS,Bills,28,1205
20,11,2015,Waitrose,Groceries,47,1158
20,11,2015,Starbucks Coffee,Eating Out,1,1157
20,11,2015,The Grand Pub,Eating Out,11,1146
20,11,2015,Restaurant Gordon RamsayPortland Restaurant,Eating Out,41,1105
20,11,2015,ATM Cash Withdrawal,General,10,1095
21,11,2015,ATM Cash Withdrawal,General,10,1085
22,11,2015,Paying back James,,3,1082
23,11,2015,South West Trains,Transport,35,1047
23,11,2015,ATM Cash Withdrawal,General,20,1027
24,11,2015,O2,Bills,34,993
24,11,2015,Pret A Manger,Eating Out,5,988
25,11,2015,Wild Bean Cafe,Eating Out,2,986
25,11,2015,The West Cornwall Pasty Company,Eating Out,6,980
25,11,2015,ATM Cash Withdrawal,General,20,960
26,11,2015,Costa Coffee,Eating Out,2,958
26,11,2015,McDonalds,Eating Out,5,953
26,11,2015,ATM Cash Withdrawal,General,10,943
26,11,2015,Tool Shop,,3,940
27,11,2015,Tescos,Groceries,69,871
27,11,2015,Starbucks Coffee,Eating Out,1,870
27,11,2015,ATM Cash Withdrawal,General,10,860
29,11,2015,Restaurant Gordon RamsayPortland Restaurant,Eating Out,45,815
30,11,2015,South West Trains,Transport,27,788
30,11,2015,Starbucks Coffee,Eating Out,2,786
30,11,2015,McDonalds,Eating Out,6,780
1,12,2015,Rhino Sports salary,General,1700,2480
1,12,2015,Costa Coffee,Eating Out,1,2479
1,12,2015,Chicken Cottage,Eating Out,5,2474
2,12,2015,Wild Bean Cafe,Eating Out,2,2472
3,12,2015,Starbucks Coffee,Eating Out,2,2470
3,12,2015,McDonalds,Eating Out,8,2462
4,12,2015,Sainsburys,Groceries,62,2400
4,12,2015,Wild Bean Cafe,Eating Out,1,2399
4,12,2015,Chicken Cottage,Eating Out,8,2391
4,12,2015,The Grand Pub,Eating Out,16,2375
4,12,2015,The Grand Pub,Eating Out,15,2360
4,12,2015,The Grand Pub,Eating Out,5,2355
4,12,2015,ATM Cash Withdrawal,General,10,2345
5,12,2015,Ministry of Sound ClubXOYO Club,Eating Out,14,2331
5,12,2015,Ministry of Sound ClubXOYO Club,Eating Out,16,2315
5,12,2015,Ministry of Sound ClubXOYO Club,Eating Out,11,2304
5,12,2015,Ministry of Sound ClubXOYO Club,Eating Out,10,2294
5,12,2015,Ministry of Sound ClubXOYO Club,Eating Out,12,2282
5,12,2015,Ministry of Sound ClubXOYO Club,Eating Out,12,2270
6,12,2015,Anglo restaurant,Eating Out,36,2234
7,12,2015,Cubit and West rent,Rent,550,1684
7,12,2015,South West Trains,Transport,29,1655
7,12,2015,Wild Bean Cafe,Eating Out,1,1654
8,12,2015,Costa Coffee,Eating Out,2,1652
8,12,2015,Pret A Manger,Eating Out,7,1645
9,12,2015,Caffe Nero,Eating Out,1,1644
9,12,2015,Subway,Eating Out,6,1638
9,12,2015,ATM Cash Withdrawal,General,20,1618
10,12,2015,Starbucks Coffee,Eating Out,2,1616
11,12,2015,Tescos,Groceries,65,1551
11,12,2015,Starbucks Coffee,Eating Out,2,1549
12,12,2015,ATM Cash Withdrawal,General,10,1539
13,12,2015,ATM Cash Withdrawal,General,10,1529
14,12,2015,South West Trains,Transport,26,1503
14,12,2015,Starbucks Coffee,Eating Out,1,1502
14,12,2015,ATM Cash Withdrawal,General,20,1482
15,12,2015,BRGAS-Electricity,Bills,35,1447
15,12,2015,BRGAS-Gas,Bills,38,1409
15,12,2015,Starbucks Coffee,Eating Out,1,1408
15,12,2015,Pret A Manger,Eating Out,4,1404
16,12,2015,LBS Council Tax,Bills,50,1354
16,12,2015,Costa Coffee,Eating Out,2,1352
16,12,2015,Subway,Eating Out,5,1347
17,12,2015,Starbucks Coffee,Eating Out,2,1345
17,12,2015,Chicken Cottage,Eating Out,4,1341
17,12,2015,ATM Cash Withdrawal,General,20,1321
18,12,2015,Waitrose,Groceries,87,1234
18,12,2015,Heaven Club,Eating Out,10,1224
18,12,2015,Heaven Club,Eating Out,6,1218
18,12,2015,Heaven Club,Eating Out,15,1203
18,12,2015,Paying back Julie,,6,1197
19,12,2015,The Grand Pub,Eating Out,6,1191
19,12,2015,Dominos Pizza,Eating Out,32,1159
19,12,2015,Red Shop,,3,1156
20,12,2015,VIRGIN MEDIA PYMTS,Bills,48,1108
21,12,2015,South West Trains,Transport,30,1078
21,12,2015,Wild Bean Cafe,Eating Out,2,1076
21,12,2015,The West Cornwall Pasty Company,Eating Out,6,1070
21,12,2015,ATM Cash Withdrawal,General,20,1050
21,12,2015,Civic Shop,,1,1049
22,12,2015,Pret A Manger,Eating Out,8,1041
23,12,2015,Starbucks Coffee,Eating Out,2,1039
24,12,2015,O2,Bills,31,1008
24,12,2015,Wild Bean Cafe,Eating Out,1,1007
24,12,2015,Chicken Cottage,Eating Out,8,999
25,12,2015,Tescos,Groceries,65,934
25,12,2015,McDonalds,Eating Out,8,926
25,12,2015,Restaurant Gordon RamsayPortland Restaurant,Eating Out,24,902
26,12,2015,ATM Cash Withdrawal,General,10,892
27,12,2015,Anglo restaurant,Eating Out,31,861
28,12,2015,South West Trains,Transport,24,837
28,12,2015,Starbucks Coffee,Eating Out,1,836
29,12,2015,Wild Bean Cafe,Eating Out,2,834
29,12,2015,Chicken Cottage,Eating Out,5,829
29,12,2015,ATM Cash Withdrawal,General,10,819
30,12,2015,Costa Coffee,Eating Out,1,818
30,12,2015,Subway,Eating Out,5,813
31,12,2015,Pret A Manger,Eating Out,8,805
31,12,2015,ATM Cash Withdrawal,General,20,785
1,1,2016,Rhino Sports salary,General,1700,2485
1,1,2016,Tescos,Groceries,60,2425
1,1,2016,Costa Coffee,Eating Out,1,2424
1,1,2016,Chicken Cottage,Eating Out,8,2416
2,1,2016,ATM Cash Withdrawal,General,20,2396
3,1,2016,ATM Cash Withdrawal,General,20,2376
4,1,2016,South West Trains,Transport,36,2340
4,1,2016,Starbucks Coffee,Eating Out,2,2338
4,1,2016,The West Cornwall Pasty Company,Eating Out,8,2330
5,1,2016,Wild Bean Cafe,Eating Out,2,2328
5,1,2016,Chicken Cottage,Eating Out,7,2321
6,1,2016,McDonalds,Eating Out,5,2316
7,1,2016,Cubit and West rent,Rent,550,1766
7,1,2016,Caffe Nero,Eating Out,2,1764
7,1,2016,Greggs,Eating Out,5,1759
8,1,2016,Waitrose,Groceries,56,1703
8,1,2016,Caffe Nero,Eating Out,2,1701
8,1,2016,The Grand Pub,Eating Out,7,1694
8,1,2016,The Grand Pub,Eating Out,10,1684
8,1,2016,The Grand Pub,Eating Out,14,1670
8,1,2016,The Grand Pub,Eating Out,14,1656
8,1,2016,Restaurant Gordon RamsayPortland Restaurant,Eating Out,24,1632
9,1,2016,Dominos Pizza,Eating Out,24,1608
10,1,2016,ATM Cash Withdrawal,General,10,1598
11,1,2016,South West Trains,Transport,33,1565
11,1,2016,Costa Coffee,Eating Out,2,1563
11,1,2016,Pret A Manger,Eating Out,8,1555
11,1,2016,ATM Cash Withdrawal,General,10,1545
11,1,2016,Cheam Service Station,,6,1539
12,1,2016,Starbucks Coffee,Eating Out,2,1537
12,1,2016,McDonalds,Eating Out,6,1531
12,1,2016,Tool Shop,,1,1530
13,1,2016,Caffe Nero,Eating Out,2,1528
13,1,2016,Tool Shop,,3,1525
14,1,2016,Costa Coffee,Eating Out,2,1523
15,1,2016,BRGAS-Electricity,Bills,42,1481
15,1,2016,BRGAS-Gas,Bills,48,1433
15,1,2016,Waitrose,Groceries,47,1386
15,1,2016,Caffe Nero,Eating Out,2,1384
16,1,2016,LBS Council Tax,Bills,50,1334
16,1,2016,Scott's Restaurant,Eating Out,36,1298
17,1,2016,Red Shop,,5,1293
18,1,2016,South West Trains,Transport,35,1258
18,1,2016,Caffe Nero,Eating Out,1,1257
18,1,2016,McDonalds,Eating Out,7,1250
19,1,2016,Costa Coffee,Eating Out,1,1249
19,1,2016,Subway,Eating Out,6,1243
19,1,2016,ATM Cash Withdrawal,General,20,1223
20,1,2016,VIRGIN MEDIA PYMTS,Bills,58,1165
20,1,2016,Starbucks Coffee,Eating Out,2,1163
20,1,2016,McDonalds,Eating Out,6,1157
21,1,2016,Wild Bean Cafe,Eating Out,1,1156
21,1,2016,Pret A Manger,Eating Out,6,1150
22,1,2016,Sainsburys,Groceries,87,1063
22,1,2016,Starbucks Coffee,Eating Out,2,1061
22,1,2016,Fabric Club,Eating Out,12,1049
22,1,2016,Fabric Club,Eating Out,8,1041
22,1,2016,Fabric Club,Eating Out,10,1031
22,1,2016,Fabric Club,Eating Out,9,1022
22,1,2016,Fabric Club,Eating Out,13,1009
22,1,2016,Fabric Club,Eating Out,5,1004
22,1,2016,ATM Cash Withdrawal,General,20,984
23,1,2016,Pizza Express,Eating Out,52,932
24,1,2016,O2,Bills,32,900
24,1,2016,Dominos Pizza,Eating Out,45,855
24,1,2016,Red Shop,,2,853
25,1,2016,South West Trains,Transport,28,825
25,1,2016,Caffe Nero,Eating Out,1,824
25,1,2016,ATM Cash Withdrawal,General,20,804
26,1,2016,Caffe Nero,Eating Out,1,803
26,1,2016,The West Cornwall Pasty Company,Eating Out,5,798
26,1,2016,ATM Cash Withdrawal,General,10,788
26,1,2016,Civic Shop,,3,785
27,1,2016,Starbucks Coffee,Eating Out,2,783
28,1,2016,Costa Coffee,Eating Out,2,781
29,1,2016,Waitrose,Groceries,87,694
29,1,2016,Costa Coffee,Eating Out,2,692
1,2,2016,Rhino Sports salary,General,1700,2392
1,2,2016,South West Trains,Transport,25,2367
1,2,2016,Caffe Nero,Eating Out,1,2366
2,2,2016,Starbucks Coffee,Eating Out,2,2364
2,2,2016,Pret A Manger,Eating Out,8,2356
2,2,2016,ATM Cash Withdrawal,General,20,2336
3,2,2016,Caffe Nero,Eating Out,1,2335
4,2,2016,Starbucks Coffee,Eating Out,2,2333
4,2,2016,McDonalds,Eating Out,7,2326
5,2,2016,Waitrose,Groceries,82,2244
5,2,2016,Anglo restaurant,Eating Out,52,2192
7,2,2016,Cubit and West rent,Rent,550,1642
8,2,2016,South West Trains,Transport,32,1610
8,2,2016,Caffe Nero,Eating Out,2,1608
8,2,2016,Subway,Eating Out,4,1604
9,2,2016,Chicken Cottage,Eating Out,7,1597
10,2,2016,Wild Bean Cafe,Eating Out,1,1596
10,2,2016,McDonalds,Eating Out,5,1591
11,2,2016,Costa Coffee,Eating Out,2,1589
11,2,2016,McDonalds,Eating Out,5,1584
12,2,2016,Waitrose,Groceries,73,1511
12,2,2016,Starbucks Coffee,Eating Out,2,1509
12,2,2016,Chicken Cottage,Eating Out,6,1503
12,2,2016,Restaurant Gordon RamsayPortland Restaurant,Eating Out,50,1453
12,2,2016,ATM Cash Withdrawal,General,10,1443
15,2,2016,BRGAS-Electricity,Bills,36,1407
15,2,2016,BRGAS-Gas,Bills,40,1367
15,2,2016,South West Trains,Transport,32,1335
15,2,2016,Caffe Nero,Eating Out,2,1333
16,2,2016,LBS Council Tax,Bills,50,1283
16,2,2016,Caffe Nero,Eating Out,2,1281
16,2,2016,Subway,Eating Out,5,1276
17,2,2016,Caffe Nero,Eating Out,1,1275
18,2,2016,Wild Bean Cafe,Eating Out,2,1273
18,2,2016,The West Cornwall Pasty Company,Eating Out,5,1268
18,2,2016,ATM Cash Withdrawal,General,10,1258
19,2,2016,ASDA,Groceries,67,1191
19,2,2016,Wild Bean Cafe,Eating Out,2,1189
20,2,2016,VIRGIN MEDIA PYMTS,Bills,59,1130
20,2,2016,Paying back Julie,,1,1129
21,2,2016,Dominos Pizza,Eating Out,56,1073
22,2,2016,South West Trains,Transport,26,1047
22,2,2016,Caffe Nero,Eating Out,1,1046
23,2,2016,Starbucks Coffee,Eating Out,2,1044
23,2,2016,ATM Cash Withdrawal,General,20,1024
23,2,2016,Paying back James,,7,1017
24,2,2016,O2,Bills,32,985
24,2,2016,Costa Coffee,Eating Out,2,983
24,2,2016,Civic Shop,,6,977
25,2,2016,Wild Bean Cafe,Eating Out,2,975
25,2,2016,Chicken Cottage,Eating Out,6,969
25,2,2016,Paying back Julie,,2,967
26,2,2016,ASDA,Groceries,56,911
26,2,2016,Wild Bean Cafe,Eating Out,2,909
26,2,2016,Chicken Cottage,Eating Out,7,902
26,2,2016,Restaurant Gordon RamsayPortland Restaurant,Eating Out,25,877
26,2,2016,ATM Cash Withdrawal,General,10,867
27,2,2016,Fabric Club,Eating Out,14,853
29,2,2016,South West Trains,Transport,33,820
29,2,2016,Caffe Nero,Eating Out,2,818
1,3,2016,Rhino Sports salary,General,1700,2518
1,3,2016,Starbucks Coffee,Eating Out,2,2516
1,3,2016,Greggs,Eating Out,8,2508
2,3,2016,Caffe Nero,Eating Out,2,2506
2,3,2016,Greggs,Eating Out,4,2502
3,3,2016,Wild Bean Cafe,Eating Out,2,2500
3,3,2016,Tool Shop,,9,2491
4,3,2016,Waitrose,Groceries,45,2446
4,3,2016,Costa Coffee,Eating Out,2,2444
4,3,2016,Red Shop,,1,2443
5,3,2016,Restaurant Gordon RamsayPortland Restaurant,Eating Out,51,2392
6,3,2016,Restaurant Gordon RamsayPortland Restaurant,Eating Out,30,2362
6,3,2016,ATM Cash Withdrawal,General,10,2352
7,3,2016,Cubit and West rent,Rent,550,1802
7,3,2016,South West Trains,Transport,35,1767
7,3,2016,Caffe Nero,Eating Out,2,1765
7,3,2016,The West Cornwall Pasty Company,Eating Out,8,1757
8,3,2016,Caffe Nero,Eating Out,2,1755
8,3,2016,ATM Cash Withdrawal,General,20,1735
9,3,2016,Wild Bean Cafe,Eating Out,1,1734
9,3,2016,Chicken Cottage,Eating Out,5,1729
10,3,2016,Costa Coffee,Eating Out,2,1727
10,3,2016,ATM Cash Withdrawal,General,20,1707
11,3,2016,Tescos,Groceries,88,1619
11,3,2016,Caffe Nero,Eating Out,1,1618
12,3,2016,ATM Cash Withdrawal,General,10,1608
12,3,2016,Paying back James,,6,1602
13,3,2016,Restaurant Gordon RamsayPortland Restaurant,Eating Out,38,1564
13,3,2016,Tool Shop,,3,1561
14,3,2016,South West Trains,Transport,29,1532
14,3,2016,Subway,Eating Out,4,1528
15,3,2016,BRGAS-Electricity,Bills,43,1485
15,3,2016,BRGAS-Gas,Bills,27,1458
15,3,2016,Starbucks Coffee,Eating Out,2,1456
15,3,2016,McDonalds,Eating Out,5,1451
16,3,2016,LBS Council Tax,Bills,50,1401
17,3,2016,Pret A Manger,Eating Out,7,1394
17,3,2016,ATM Cash Withdrawal,General,20,1374
17,3,2016,Paying back James,,2,1372
18,3,2016,Sainsburys,Groceries,42,1330
20,3,2016,VIRGIN MEDIA PYMTS,Bills,47,1283
21,3,2016,South West Trains,Transport,36,1247
21,3,2016,Costa Coffee,Eating Out,1,1246
22,3,2016,Pret A Manger,Eating Out,7,1239
22,3,2016,ATM Cash Withdrawal,General,20,1219
23,3,2016,Starbucks Coffee,Eating Out,2,1217
24,3,2016,O2,Bills,31,1186
25,3,2016,Waitrose,Groceries,72,1114
25,3,2016,Costa Coffee,Eating Out,2,1112
25,3,2016,The West Cornwall Pasty Company,Eating Out,4,1108
25,3,2016,ATM Cash Withdrawal,General,10,1098
26,3,2016,The Grand Pub,Eating Out,5,1093
26,3,2016,The Grand Pub,Eating Out,8,1085
26,3,2016,The Grand Pub,Eating Out,13,1072
26,3,2016,The Grand Pub,Eating Out,7,1065
26,3,2016,The Grand Pub,Eating Out,13,1052
26,3,2016,Anglo restaurant,Eating Out,57,995
27,3,2016,Anglo restaurant,Eating Out,56,939
27,3,2016,ATM Cash Withdrawal,General,10,929
28,3,2016,South West Trains,Transport,34,895
28,3,2016,Starbucks Coffee,Eating Out,1,894
28,3,2016,Subway,Eating Out,7,887
29,3,2016,Caffe Nero,Eating Out,2,885
30,3,2016,Caffe Nero,Eating Out,1,884
31,3,2016,Starbucks Coffee,Eating Out,1,883
1,4,2016,Rhino Sports salary,General,1700,2583
1,4,2016,Sainsburys,Groceries,62,2521
1,4,2016,McDonalds,Eating Out,6,2515
1,4,2016,ATM Cash Withdrawal,General,20,2495
2,4,2016,Anglo restaurant,Eating Out,25,2470
2,4,2016,ATM Cash Withdrawal,General,20,2450
3,4,2016,Restaurant Gordon RamsayPortland Restaurant,Eating Out,29,2421
3,4,2016,Cheam Service Station,,5,2416
4,4,2016,South West Trains,Transport,24,2392
4,4,2016,Costa Coffee,Eating Out,2,2390
4,4,2016,McDonalds,Eating Out,6,2384
5,4,2016,Wild Bean Cafe,Eating Out,1,2383
5,4,2016,Chicken Cottage,Eating Out,5,2378
6,4,2016,The West Cornwall Pasty Company,Eating Out,5,2373
7,4,2016,Cubit and West rent,Rent,550,1823
7,4,2016,Caffe Nero,Eating Out,1,1822
7,4,2016,ATM Cash Withdrawal,General,20,1802
8,4,2016,ASDA,Groceries,80,1722
8,4,2016,Wild Bean Cafe,Eating Out,2,1720
8,4,2016,Scott's Restaurant,Eating Out,58,1662
8,4,2016,ATM Cash Withdrawal,General,20,1642
9,4,2016,Restaurant Gordon RamsayPortland Restaurant,Eating Out,39,1603
10,4,2016,ATM Cash Withdrawal,General,20,1583
10,4,2016,Tool Tec,,6,1577
11,4,2016,South West Trains,Transport,26,1551
11,4,2016,Starbucks Coffee,Eating Out,2,1549
11,4,2016,Chicken Cottage,Eating Out,5,1544
13,4,2016,Starbucks Coffee,Eating Out,2,1542
13,4,2016,The West Cornwall Pasty Company,Eating Out,6,1536
15,4,2016,BRGAS-Electricity,Bills,29,1507
15,4,2016,BRGAS-Gas,Bills,39,1468
15,4,2016,Tescos,Groceries,60,1408
15,4,2016,Caffe Nero,Eating Out,2,1406
16,4,2016,LBS Council Tax,Bills,50,1356
16,4,2016,Ministry of Sound ClubXOYO Club,Eating Out,13,1343
16,4,2016,Ministry of Sound ClubXOYO Club,Eating Out,11,1332
16,4,2016,Scott's Restaurant,Eating Out,41,1291
16,4,2016,ATM Cash Withdrawal,General,10,1281
18,4,2016,South West Trains,Transport,36,1245
18,4,2016,Caffe Nero,Eating Out,1,1244
18,4,2016,Greggs,Eating Out,8,1236
19,4,2016,Starbucks Coffee,Eating Out,2,1234
19,4,2016,The West Cornwall Pasty Company,Eating Out,5,1229
20,4,2016,VIRGIN MEDIA PYMTS,Bills,36,1193
20,4,2016,Caffe Nero,Eating Out,1,1192
20,4,2016,Greggs,Eating Out,4,1188
21,4,2016,ATM Cash Withdrawal,General,10,1178
21,4,2016,Paying back Julie,,2,1176
22,4,2016,Morrisons,Groceries,57,1119
22,4,2016,Caffe Nero,Eating Out,1,1118
24,4,2016,O2,Bills,38,1080
24,4,2016,Anglo restaurant,Eating Out,49,1031
25,4,2016,South West Trains,Transport,31,1000
25,4,2016,Wild Bean Cafe,Eating Out,2,998
26,4,2016,Starbucks Coffee,Eating Out,2,996
26,4,2016,Civic Shop,,4,992
27,4,2016,Costa Coffee,Eating Out,2,990
27,4,2016,Greggs,Eating Out,6,984
28,4,2016,Starbucks Coffee,Eating Out,2,982
28,4,2016,Greggs,Eating Out,7,975
29,4,2016,Waitrose,Groceries,60,915
29,4,2016,Starbucks Coffee,Eating Out,2,913
29,4,2016,McDonalds,Eating Out,7,906
29,4,2016,The Grand Pub,Eating Out,15,891
29,4,2016,The Grand Pub,Eating Out,14,877
29,4,2016,The Grand Pub,Eating Out,12,865
29,4,2016,The Grand Pub,Eating Out,10,855
29,4,2016,The Grand Pub,Eating Out,7,848
29,4,2016,The Grand Pub,Eating Out,12,836
29,4,2016,Pizza Express,Eating Out,34,802
30,4,2016,Ministry of Sound ClubXOYO Club,Eating Out,16,786
30,4,2016,Ministry of Sound ClubXOYO Club,Eating Out,11,775
30,4,2016,Ministry of Sound ClubXOYO Club,Eating Out,11,764
30,4,2016,Ministry of Sound ClubXOYO Club,Eating Out,15,749
30,4,2016,Ministry of Sound ClubXOYO Club,Eating Out,5,744
30,4,2016,Ministry of Sound ClubXOYO Club,Eating Out,12,732
30,4,2016,Anglo restaurant,Eating Out,45,687
1,5,2016,Rhino Sports salary,General,1700,2387
1,5,2016,Paying back Julie,,1,2386
2,5,2016,South West Trains,Transport,28,2358
2,5,2016,Starbucks Coffee,Eating Out,2,2356
3,5,2016,Greggs,Eating Out,6,2350
3,5,2016,ATM Cash Withdrawal,General,10,2340
4,5,2016,Caffe Nero,Eating Out,2,2338
4,5,2016,Cheam Service Station,,1,2337
5,5,2016,Wild Bean Cafe,Eating Out,2,2335
5,5,2016,The West Cornwall Pasty Company,Eating Out,5,2330
5,5,2016,ATM Cash Withdrawal,General,20,2310
6,5,2016,Sainsburys,Groceries,62,2248
6,5,2016,Greggs,Eating Out,6,2242
6,5,2016,Cheam Service Station,,7,2235
7,5,2016,Cubit and West rent,Rent,550,1685
7,5,2016,ATM Cash Withdrawal,General,10,1675
8,5,2016,Pizza Express,Eating Out,53,1622
8,5,2016,Tool Tec,,9,1613
9,5,2016,South West Trains,Transport,31,1582
9,5,2016,Caffe Nero,Eating Out,1,1581
9,5,2016,Chicken Cottage,Eating Out,6,1575
10,5,2016,Greggs,Eating Out,5,1570
11,5,2016,Wild Bean Cafe,Eating Out,2,1568
11,5,2016,ATM Cash Withdrawal,General,10,1558
12,5,2016,Caffe Nero,Eating Out,1,1557
12,5,2016,The West Cornwall Pasty Company,Eating Out,8,1549
13,5,2016,Morrisons,Groceries,54,1495
13,5,2016,Caffe Nero,Eating Out,2,1493
13,5,2016,Subway,Eating Out,5,1488
13,5,2016,Fabric Club,Eating Out,11,1477
13,5,2016,Fabric Club,Eating Out,5,1472
13,5,2016,Fabric Club,Eating Out,13,1459
13,5,2016,Fabric Club,Eating Out,15,1444
14,5,2016,ATM Cash Withdrawal,General,10,1434
15,5,2016,BRGAS-Electricity,Bills,37,1397
15,5,2016,BRGAS-Gas,Bills,38,1359
16,5,2016,LBS Council Tax,Bills,50,1309
16,5,2016,South West Trains,Transport,32,1277
16,5,2016,Costa Coffee,Eating Out,1,1276
16,5,2016,Pret A Manger,Eating Out,5,1271
17,5,2016,Starbucks Coffee,Eating Out,1,1270
17,5,2016,The West Cornwall Pasty Company,Eating Out,5,1265
18,5,2016,Starbucks Coffee,Eating Out,1,1264
18,5,2016,The West Cornwall Pasty Company,Eating Out,4,1260
18,5,2016,ATM Cash Withdrawal,General,20,1240
19,5,2016,Costa Coffee,Eating Out,1,1239
19,5,2016,The West Cornwall Pasty Company,Eating Out,8,1231
19,5,2016,ATM Cash Withdrawal,General,20,1211
20,5,2016,VIRGIN MEDIA PYMTS,Bills,38,1173
20,5,2016,Waitrose,Groceries,57,1116
20,5,2016,McDonalds,Eating Out,7,1109
20,5,2016,Ministry of Sound ClubXOYO Club,Eating Out,7,1102
20,5,2016,Ministry of Sound ClubXOYO Club,Eating Out,6,1096
20,5,2016,Ministry of Sound ClubXOYO Club,Eating Out,16,1080
20,5,2016,Scott's Restaurant,Eating Out,32,1048
21,5,2016,Dominos Pizza,Eating Out,25,1023
21,5,2016,Tool Tec,,6,1017
22,5,2016,ATM Cash Withdrawal,General,20,997
23,5,2016,South West Trains,Transport,33,964
23,5,2016,Caffe Nero,Eating Out,2,962
23,5,2016,Pret A Manger,Eating Out,7,955
23,5,2016,ATM Cash Withdrawal,General,10,945
24,5,2016,O2,Bills,32,913
24,5,2016,Costa Coffee,Eating Out,2,911
25,5,2016,Caffe Nero,Eating Out,2,909
25,5,2016,The West Cornwall Pasty Company,Eating Out,6,903
27,5,2016,Waitrose,Groceries,75,828
27,5,2016,Starbucks Coffee,Eating Out,2,826
28,5,2016,Tool Shop,,8,818
29,5,2016,Pizza Express,Eating Out,29,789
29,5,2016,ATM Cash Withdrawal,General,20,769
30,5,2016,South West Trains,Transport,34,735
30,5,2016,Starbucks Coffee,Eating Out,1,734
31,5,2016,Caffe Nero,Eating Out,2,732
31,5,2016,Subway,Eating Out,6,726
31,5,2016,ATM Cash Withdrawal,General,10,716
1,6,2016,Rhino Sports salary,General,1700,2416
1,6,2016,Chicken Cottage,Eating Out,6,2410
2,6,2016,Starbucks Coffee,Eating Out,1,2409
2,6,2016,McDonalds,Eating Out,7,2402
2,6,2016,ATM Cash Withdrawal,General,10,2392
3,6,2016,Waitrose,Groceries,44,2348
3,6,2016,Pret A Manger,Eating Out,5,2343
3,6,2016,Fabric Club,Eating Out,16,2327
3,6,2016,Fabric Club,Eating Out,11,2316
3,6,2016,Fabric Club,Eating Out,10,2306
3,6,2016,Fabric Club,Eating Out,10,2296
3,6,2016,Fabric Club,Eating Out,10,2286
3,6,2016,Fabric Club,Eating Out,9,2277
3,6,2016,Anglo restaurant,Eating Out,59,2218
3,6,2016,ATM Cash Withdrawal,General,20,2198
5,6,2016,ATM Cash Withdrawal,General,10,2188
6,6,2016,South West Trains,Transport,37,2151
6,6,2016,Starbucks Coffee,Eating Out,2,2149
6,6,2016,Pret A Manger,Eating Out,5,2144
6,6,2016,ATM Cash Withdrawal,General,10,2134
7,6,2016,Cubit and West rent,Rent,550,1584
7,6,2016,Caffe Nero,Eating Out,1,1583
8,6,2016,Wild Bean Cafe,Eating Out,2,1581
8,6,2016,Greggs,Eating Out,8,1573
9,6,2016,Caffe Nero,Eating Out,2,1571
9,6,2016,Pret A Manger,Eating Out,4,1567
10,6,2016,Sainsburys,Groceries,84,1483
10,6,2016,The West Cornwall Pasty Company,Eating Out,7,1476
10,6,2016,Dominos Pizza,Eating Out,43,1433
11,6,2016,Fabric Club,Eating Out,9,1424
11,6,2016,Fabric Club,Eating Out,14,1410
12,6,2016,ATM Cash Withdrawal,General,10,1400
13,6,2016,South West Trains,Transport,34,1366
13,6,2016,Costa Coffee,Eating Out,1,1365
13,6,2016,Subway,Eating Out,4,1361
14,6,2016,Wild Bean Cafe,Eating Out,1,1360
14,6,2016,The West Cornwall Pasty Company,Eating Out,8,1352
15,6,2016,BRGAS-Electricity,Bills,23,1329
15,6,2016,BRGAS-Gas,Bills,43,1286
15,6,2016,Starbucks Coffee,Eating Out,1,1285
15,6,2016,Chicken Cottage,Eating Out,5,1280
16,6,2016,LBS Council Tax,Bills,50,1230
16,6,2016,Caffe Nero,Eating Out,1,1229
16,6,2016,ATM Cash Withdrawal,General,10,1219
17,6,2016,ASDA,Groceries,81,1138
17,6,2016,Costa Coffee,Eating Out,2,1136
17,6,2016,Pret A Manger,Eating Out,6,1130
18,6,2016,ATM Cash Withdrawal,General,10,1120
20,6,2016,VIRGIN MEDIA PYMTS,Bills,47,1073
20,6,2016,South West Trains,Transport,32,1041
20,6,2016,McDonalds,Eating Out,7,1034
21,6,2016,Wild Bean Cafe,Eating Out,1,1033
21,6,2016,Greggs,Eating Out,7,1026
22,6,2016,Subway,Eating Out,7,1019
23,6,2016,Caffe Nero,Eating Out,2,1017
24,6,2016,O2,Bills,31,986
24,6,2016,Tescos,Groceries,74,912
24,6,2016,Starbucks Coffee,Eating Out,2,910
25,6,2016,ATM Cash Withdrawal,General,20,890
26,6,2016,ATM Cash Withdrawal,General,10,880
27,6,2016,South West Trains,Transport,34,846
27,6,2016,Chicken Cottage,Eating Out,4,842
28,6,2016,Costa Coffee,Eating Out,2,840
29,6,2016,Starbucks Coffee,Eating Out,2,838
30,6,2016,Subway,Eating Out,5,833
1,7,2016,Rhino Sports salary,General,1700,2533
1,7,2016,Waitrose,Groceries,61,2472
1,7,2016,Starbucks Coffee,Eating Out,1,2471
1,7,2016,Dominos Pizza,Eating Out,53,2418
1,7,2016,ATM Cash Withdrawal,General,20,2398
2,7,2016,Ministry of Sound ClubXOYO Club,Eating Out,8,2390
2,7,2016,Ministry of Sound ClubXOYO Club,Eating Out,16,2374
2,7,2016,Anglo restaurant,Eating Out,38,2336
3,7,2016,ATM Cash Withdrawal,General,20,2316
4,7,2016,South West Trains,Transport,30,2286
4,7,2016,The West Cornwall Pasty Company,Eating Out,5,2281
4,7,2016,ATM Cash Withdrawal,General,20,2261
4,7,2016,Tool Shop,,1,2260
5,7,2016,Wild Bean Cafe,Eating Out,2,2258
5,7,2016,McDonalds,Eating Out,4,2254
5,7,2016,ATM Cash Withdrawal,General,10,2244
6,7,2016,Civic Shop,,7,2237
7,7,2016,Cubit and West rent,Rent,550,1687
7,7,2016,Wild Bean Cafe,Eating Out,2,1685
7,7,2016,Subway,Eating Out,6,1679
7,7,2016,ATM Cash Withdrawal,General,20,1659
7,7,2016,Tool Shop,,2,1657
8,7,2016,Tescos,Groceries,62,1595
8,7,2016,Caffe Nero,Eating Out,2,1593
8,7,2016,Anglo restaurant,Eating Out,40,1553
8,7,2016,ATM Cash Withdrawal,General,10,1543
9,7,2016,ATM Cash Withdrawal,General,20,1523
10,7,2016,ATM Cash Withdrawal,General,10,1513
11,7,2016,South West Trains,Transport,28,1485
11,7,2016,Wild Bean Cafe,Eating Out,1,1484
11,7,2016,The West Cornwall Pasty Company,Eating Out,8,1476
12,7,2016,Starbucks Coffee,Eating Out,1,1475
12,7,2016,ATM Cash Withdrawal,General,10,1465
13,7,2016,Starbucks Coffee,Eating Out,2,1463
13,7,2016,The West Cornwall Pasty Company,Eating Out,5,1458
13,7,2016,ATM Cash Withdrawal,General,10,1448
14,7,2016,Caffe Nero,Eating Out,2,1446
14,7,2016,Chicken Cottage,Eating Out,5,1441
14,7,2016,ATM Cash Withdrawal,General,10,1431
14,7,2016,Tool Shop,,3,1428
15,7,2016,BRGAS-Electricity,Bills,40,1388
15,7,2016,BRGAS-Gas,Bills,32,1356
15,7,2016,Tescos,Groceries,72,1284
15,7,2016,Costa Coffee,Eating Out,1,1283
15,7,2016,Restaurant Gordon RamsayPortland Restaurant,Eating Out,36,1247
16,7,2016,LBS Council Tax,Bills,50,1197
16,7,2016,ATM Cash Withdrawal,General,20,1177
18,7,2016,South West Trains,Transport,38,1139
18,7,2016,Costa Coffee,Eating Out,2,1137
19,7,2016,Greggs,Eating Out,7,1130
20,7,2016,VIRGIN MEDIA PYMTS,Bills,49,1081
20,7,2016,Subway,Eating Out,4,1077
20,7,2016,ATM Cash Withdrawal,General,10,1067
21,7,2016,The West Cornwall Pasty Company,Eating Out,5,1062
22,7,2016,Sainsburys,Groceries,67,995
22,7,2016,Costa Coffee,Eating Out,2,993
22,7,2016,Anglo restaurant,Eating Out,40,953
24,7,2016,O2,Bills,32,921
24,7,2016,Paying back James,,4,917
25,7,2016,South West Trains,Transport,27,890
25,7,2016,Costa Coffee,Eating Out,2,888
25,7,2016,Pret A Manger,Eating Out,7,881
27,7,2016,Subway,Eating Out,5,876
28,7,2016,McDonalds,Eating Out,6,870
28,7,2016,Tool Tec,,8,862
29,7,2016,Tescos,Groceries,42,820
29,7,2016,Caffe Nero,Eating Out,2,818
30,7,2016,Anglo restaurant,Eating Out,27,791
1,8,2016,Rhino Sports salary,General,1700,2491
1,8,2016,South West Trains,Transport,38,2453
1,8,2016,ATM Cash Withdrawal,General,10,2443
2,8,2016,Wild Bean Cafe,Eating Out,2,2441
2,8,2016,Chicken Cottage,Eating Out,5,2436
3,8,2016,Caffe Nero,Eating Out,2,2434
3,8,2016,Greggs,Eating Out,7,2427
4,8,2016,Paying back Julie,,3,2424
5,8,2016,Waitrose,Groceries,54,2370
5,8,2016,Costa Coffee,Eating Out,2,2368
5,8,2016,Pizza Express,Eating Out,54,2314
5,8,2016,Civic Shop,,7,2307
6,8,2016,ATM Cash Withdrawal,General,20,2287
7,8,2016,Cubit and West rent,Rent,550,1737
8,8,2016,South West Trains,Transport,31,1706
8,8,2016,Costa Coffee,Eating Out,2,1704
9,8,2016,Caffe Nero,Eating Out,2,1702
9,8,2016,The West Cornwall Pasty Company,Eating Out,6,1696
9,8,2016,ATM Cash Withdrawal,General,20,1676
10,8,2016,Costa Coffee,Eating Out,1,1675
10,8,2016,Paying back James,,9,1666
12,8,2016,ASDA,Groceries,67,1599
12,8,2016,Costa Coffee,Eating Out,2,1597
13,8,2016,Fabric Club,Eating Out,10,1587
13,8,2016,Fabric Club,Eating Out,13,1574
13,8,2016,Fabric Club,Eating Out,14,1560
13,8,2016,Anglo restaurant,Eating Out,40,1520
14,8,2016,Scott's Restaurant,Eating Out,33,1487
14,8,2016,ATM Cash Withdrawal,General,10,1477
15,8,2016,BRGAS-Electricity,Bills,43,1434
15,8,2016,BRGAS-Gas,Bills,27,1407
15,8,2016,South West Trains,Transport,24,1383
15,8,2016,Costa Coffee,Eating Out,2,1381
15,8,2016,Greggs,Eating Out,4,1377
16,8,2016,LBS Council Tax,Bills,50,1327
16,8,2016,Starbucks Coffee,Eating Out,2,1325
16,8,2016,Pret A Manger,Eating Out,5,1320
17,8,2016,Caffe Nero,Eating Out,1,1319
17,8,2016,ATM Cash Withdrawal,General,20,1299
18,8,2016,Starbucks Coffee,Eating Out,2,1297
18,8,2016,Pret A Manger,Eating Out,8,1289
19,8,2016,Sainsburys,Groceries,59,1230
19,8,2016,ATM Cash Withdrawal,General,20,1210
20,8,2016,VIRGIN MEDIA PYMTS,Bills,55,1155
20,8,2016,ATM Cash Withdrawal,General,10,1145
22,8,2016,South West Trains,Transport,26,1119
22,8,2016,Starbucks Coffee,Eating Out,1,1118
22,8,2016,McDonalds,Eating Out,8,1110
23,8,2016,Starbucks Coffee,Eating Out,2,1108
23,8,2016,Pret A Manger,Eating Out,7,1101
24,8,2016,O2,Bills,31,1070
24,8,2016,Wild Bean Cafe,Eating Out,1,1069
24,8,2016,The West Cornwall Pasty Company,Eating Out,7,1062
25,8,2016,McDonalds,Eating Out,7,1055
25,8,2016,ATM Cash Withdrawal,General,10,1045
26,8,2016,Waitrose,Groceries,57,988
26,8,2016,Wild Bean Cafe,Eating Out,1,987
27,8,2016,Dominos Pizza,Eating Out,53,934
29,8,2016,South West Trains,Transport,26,908
29,8,2016,Subway,Eating Out,7,901
30,8,2016,Starbucks Coffee,Eating Out,2,899
30,8,2016,Greggs,Eating Out,8,891
31,8,2016,Starbucks Coffee,Eating Out,1,890
31,8,2016,ATM Cash Withdrawal,General,20,870
1,9,2016,Rhino Sports salary,General,1700,2570
1,9,2016,Caffe Nero,Eating Out,1,2569
1,9,2016,Chicken Cottage,Eating Out,7,2562
2,9,2016,Waitrose,Groceries,61,2501
2,9,2016,Caffe Nero,Eating Out,1,2500
2,9,2016,Anglo restaurant,Eating Out,57,2443
3,9,2016,ATM Cash Withdrawal,General,20,2423
5,9,2016,South West Trains,Transport,26,2397
5,9,2016,Wild Bean Cafe,Eating Out,1,2396
5,9,2016,The West Cornwall Pasty Company,Eating Out,6,2390
5,9,2016,ATM Cash Withdrawal,General,10,2380
6,9,2016,Wild Bean Cafe,Eating Out,1,2379
6,9,2016,Greggs,Eating Out,6,2373
7,9,2016,Cubit and West rent,Rent,550,1823
7,9,2016,Starbucks Coffee,Eating Out,2,1821
7,9,2016,Greggs,Eating Out,7,1814
8,9,2016,Starbucks Coffee,Eating Out,2,1812
9,9,2016,ASDA,Groceries,55,1757
9,9,2016,Wild Bean Cafe,Eating Out,2,1755
9,9,2016,The West Cornwall Pasty Company,Eating Out,5,1750
9,9,2016,ATM Cash Withdrawal,General,10,1740
10,9,2016,Fabric Club,Eating Out,11,1729
10,9,2016,Fabric Club,Eating Out,10,1719
10,9,2016,Fabric Club,Eating Out,8,1711
10,9,2016,Fabric Club,Eating Out,14,1697
10,9,2016,Fabric Club,Eating Out,14,1683
10,9,2016,Fabric Club,Eating Out,13,1670
11,9,2016,Anglo restaurant,Eating Out,36,1634
12,9,2016,South West Trains,Transport,25,1609
12,9,2016,The West Cornwall Pasty Company,Eating Out,5,1604
12,9,2016,ATM Cash Withdrawal,General,20,1584
13,9,2016,Caffe Nero,Eating Out,1,1583
14,9,2016,Wild Bean Cafe,Eating Out,2,1581
14,9,2016,Greggs,Eating Out,7,1574
14,9,2016,ATM Cash Withdrawal,General,20,1554
15,9,2016,BRGAS-Electricity,Bills,32,1522
15,9,2016,BRGAS-Gas,Bills,44,1478
15,9,2016,Chicken Cottage,Eating Out,8,1470
16,9,2016,LBS Council Tax,Bills,50,1420
16,9,2016,Sainsburys,Groceries,82,1338
16,9,2016,Caffe Nero,Eating Out,1,1337
16,9,2016,The West Cornwall Pasty Company,Eating Out,6,1331
17,9,2016,ATM Cash Withdrawal,General,10,1321
18,9,2016,Anglo restaurant,Eating Out,30,1291
18,9,2016,ATM Cash Withdrawal,General,10,1281
19,9,2016,South West Trains,Transport,37,1244
19,9,2016,Wild Bean Cafe,Eating Out,1,1243
19,9,2016,Paying back Julie,,1,1242
20,9,2016,VIRGIN MEDIA PYMTS,Bills,47,1195
20,9,2016,The West Cornwall Pasty Company,Eating Out,7,1188
21,9,2016,Caffe Nero,Eating Out,2,1186
21,9,2016,Greggs,Eating Out,7,1179
21,9,2016,Paying back James,,3,1176
22,9,2016,Wild Bean Cafe,Eating Out,1,1175
23,9,2016,Sainsburys,Groceries,75,1100
23,9,2016,Greggs,Eating Out,5,1095
24,9,2016,O2,Bills,32,1063
25,9,2016,Anglo restaurant,Eating Out,47,1016
26,9,2016,South West Trains,Transport,27,989
26,9,2016,Costa Coffee,Eating Out,1,988
27,9,2016,Starbucks Coffee,Eating Out,2,986
27,9,2016,Greggs,Eating Out,4,982
27,9,2016,ATM Cash Withdrawal,General,20,962
28,9,2016,Wild Bean Cafe,Eating Out,1,961
28,9,2016,Chicken Cottage,Eating Out,8,953
29,9,2016,Caffe Nero,Eating Out,2,951
30,9,2016,Morrisons,Groceries,76,875
30,9,2016,Caffe Nero,Eating Out,2,873
30,9,2016,Chicken Cottage,Eating Out,8,865
30,9,2016,ATM Cash Withdrawal,General,10,855
1,10,2016,Rhino Sports salary,General,1700,2555
1,10,2016,ATM Cash Withdrawal,General,10,2545
2,10,2016,Red Shop,,2,2543
3,10,2016,South West Trains,Transport,26,2517
3,10,2016,Costa Coffee,Eating Out,1,2516
3,10,2016,Subway,Eating Out,6,2510
4,10,2016,Caffe Nero,Eating Out,2,2508
4,10,2016,McDonalds,Eating Out,5,2503
4,10,2016,ATM Cash Withdrawal,General,20,2483
4,10,2016,Paying back James,,4,2479
5,10,2016,Costa Coffee,Eating Out,1,2478
5,10,2016,Pret A Manger,Eating Out,8,2470
6,10,2016,Wild Bean Cafe,Eating Out,2,2468
7,10,2016,Cubit and West rent,Rent,550,1918
7,10,2016,Sainsburys,Groceries,54,1864
7,10,2016,Starbucks Coffee,Eating Out,2,1862
7,10,2016,Dominos Pizza,Eating Out,53,1809
9,10,2016,Anglo restaurant,Eating Out,42,1767
10,10,2016,South West Trains,Transport,33,1734
10,10,2016,Wild Bean Cafe,Eating Out,2,1732
10,10,2016,Pret A Manger,Eating Out,5,1727
11,10,2016,Caffe Nero,Eating Out,2,1725
11,10,2016,McDonalds,Eating Out,4,1721
11,10,2016,ATM Cash Withdrawal,General,20,1701
12,10,2016,Starbucks Coffee,Eating Out,2,1699
12,10,2016,Pret A Manger,Eating Out,6,1693
12,10,2016,ATM Cash Withdrawal,General,20,1673
13,10,2016,Starbucks Coffee,Eating Out,2,1671
13,10,2016,McDonalds,Eating Out,6,1665
14,10,2016,ASDA,Groceries,74,1591
14,10,2016,Starbucks Coffee,Eating Out,1,1590
14,10,2016,Greggs,Eating Out,6,1584
15,10,2016,BRGAS-Electricity,Bills,35,1549
15,10,2016,BRGAS-Gas,Bills,21,1528
16,10,2016,LBS Council Tax,Bills,50,1478
17,10,2016,South West Trains,Transport,37,1441
17,10,2016,Starbucks Coffee,Eating Out,2,1439
17,10,2016,Pret A Manger,Eating Out,5,1434
18,10,2016,Chicken Cottage,Eating Out,5,1429
18,10,2016,ATM Cash Withdrawal,General,10,1419
19,10,2016,Starbucks Coffee,Eating Out,2,1417
19,10,2016,ATM Cash Withdrawal,General,20,1397
20,10,2016,VIRGIN MEDIA PYMTS,Bills,28,1369
20,10,2016,Starbucks Coffee,Eating Out,2,1367
20,10,2016,ATM Cash Withdrawal,General,10,1357
21,10,2016,Sainsburys,Groceries,62,1295
21,10,2016,Wild Bean Cafe,Eating Out,2,1293
21,10,2016,Anglo restaurant,Eating Out,32,1261
21,10,2016,ATM Cash Withdrawal,General,20,1241
21,10,2016,Tool Shop,,2,1239
23,10,2016,Dominos Pizza,Eating Out,51,1188
24,10,2016,O2,Bills,35,1153
24,10,2016,South West Trains,Transport,28,1125
24,10,2016,Caffe Nero,Eating Out,1,1124
24,10,2016,McDonalds,Eating Out,8,1116
24,10,2016,Paying back Julie,,7,1109
26,10,2016,Wild Bean Cafe,Eating Out,1,1108
26,10,2016,Subway,Eating Out,6,1102
26,10,2016,ATM Cash Withdrawal,General,10,1092
26,10,2016,Paying back James,,2,1090
27,10,2016,Wild Bean Cafe,Eating Out,1,1089
27,10,2016,Chicken Cottage,Eating Out,8,1081
28,10,2016,Sainsburys,Groceries,82,999
28,10,2016,Costa Coffee,Eating Out,2,997
28,10,2016,Pret A Manger,Eating Out,8,989
28,10,2016,ATM Cash Withdrawal,General,20,969
29,10,2016,ATM Cash Withdrawal,General,10,959
29,10,2016,Tool Shop,,2,957
30,10,2016,Dominos Pizza,Eating Out,33,924
31,10,2016,South West Trains,Transport,34,890
31,10,2016,Costa Coffee,Eating Out,2,888
1,11,2016,Rhino Sports salary,General,1700,2588
1,11,2016,Wild Bean Cafe,Eating Out,2,2586
1,11,2016,Pret A Manger,Eating Out,5,2581
2,11,2016,Wild Bean Cafe,Eating Out,2,2579
2,11,2016,ATM Cash Withdrawal,General,10,2569
3,11,2016,Costa Coffee,Eating Out,2,2567
3,11,2016,The West Cornwall Pasty Company,Eating Out,5,2562
4,11,2016,Sainsburys,Groceries,63,2499
4,11,2016,Starbucks Coffee,Eating Out,2,2497
4,11,2016,Pizza Express,Eating Out,59,2438
4,11,2016,ATM Cash Withdrawal,General,20,2418
5,11,2016,Ministry of Sound ClubXOYO Club,Eating Out,8,2410
5,11,2016,Ministry of Sound ClubXOYO Club,Eating Out,5,2405
5,11,2016,Ministry of Sound ClubXOYO Club,Eating Out,5,2400
5,11,2016,Ministry of Sound ClubXOYO Club,Eating Out,11,2389
5,11,2016,Ministry of Sound ClubXOYO Club,Eating Out,13,2376
5,11,2016,Ministry of Sound ClubXOYO Club,Eating Out,9,2367
5,11,2016,Pizza Express,Eating Out,38,2329
6,11,2016,Scott's Restaurant,Eating Out,57,2272
7,11,2016,Cubit and West rent,Rent,550,1722
7,11,2016,South West Trains,Transport,28,1694
7,11,2016,Costa Coffee,Eating Out,2,1692
7,11,2016,ATM Cash Withdrawal,General,20,1672
8,11,2016,Wild Bean Cafe,Eating Out,2,1670
8,11,2016,McDonalds,Eating Out,7,1663
8,11,2016,ATM Cash Withdrawal,General,10,1653
9,11,2016,Starbucks Coffee,Eating Out,1,1652
9,11,2016,Greggs,Eating Out,7,1645
9,11,2016,Paying back James,,2,1643
10,11,2016,Starbucks Coffee,Eating Out,2,1641
10,11,2016,Greggs,Eating Out,6,1635
11,11,2016,Waitrose,Groceries,47,1588
11,11,2016,Caffe Nero,Eating Out,1,1587
11,11,2016,Pret A Manger,Eating Out,4,1583
13,11,2016,ATM Cash Withdrawal,General,10,1573
13,11,2016,Paying back Julie,,4,1569
14,11,2016,South West Trains,Transport,29,1540
15,11,2016,BRGAS-Electricity,Bills,70,1470
15,11,2016,BRGAS-Gas,Bills,29,1441
15,11,2016,Caffe Nero,Eating Out,2,1439
16,11,2016,LBS Council Tax,Bills,50,1389
16,11,2016,Wild Bean Cafe,Eating Out,2,1387
16,11,2016,Subway,Eating Out,6,1381
17,11,2016,Wild Bean Cafe,Eating Out,2,1379
17,11,2016,McDonalds,Eating Out,8,1371
17,11,2016,ATM Cash Withdrawal,General,10,1361
17,11,2016,Civic Shop,,1,1360
18,11,2016,Waitrose,Groceries,80,1280
18,11,2016,Starbucks Coffee,Eating Out,2,1278
18,11,2016,Dominos Pizza,Eating Out,49,1229
18,11,2016,ATM Cash Withdrawal,General,10,1219
19,11,2016,ATM Cash Withdrawal,General,20,1199
20,11,2016,VIRGIN MEDIA PYMTS,Bills,33,1166
20,11,2016,Scott's Restaurant,Eating Out,52,1114
21,11,2016,South West Trains,Transport,31,1083
21,11,2016,Costa Coffee,Eating Out,2,1081
21,11,2016,Pret A Manger,Eating Out,8,1073
21,11,2016,ATM Cash Withdrawal,General,20,1053
22,11,2016,ATM Cash Withdrawal,General,20,1033
23,11,2016,Greggs,Eating Out,4,1029
23,11,2016,ATM Cash Withdrawal,General,10,1019
24,11,2016,O2,Bills,34,985
24,11,2016,Starbucks Coffee,Eating Out,1,984
25,11,2016,Waitrose,Groceries,79,905
25,11,2016,Caffe Nero,Eating Out,2,903
25,11,2016,Fabric Club,Eating Out,12,891
25,11,2016,Fabric Club,Eating Out,8,883
25,11,2016,Fabric Club,Eating Out,14,869
25,11,2016,Fabric Club,Eating Out,10,859
25,11,2016,Fabric Club,Eating Out,7,852
26,11,2016,Anglo restaurant,Eating Out,57,795
27,11,2016,Tool Shop,,5,790
28,11,2016,South West Trains,Transport,37,753
28,11,2016,Wild Bean Cafe,Eating Out,1,752
29,11,2016,Greggs,Eating Out,4,748
30,11,2016,Costa Coffee,Eating Out,1,747
30,11,2016,Greggs,Eating Out,5,742
1,12,2016,Rhino Sports salary,General,1700,2442
1,12,2016,Caffe Nero,Eating Out,1,2441
1,12,2016,Subway,Eating Out,6,2435
2,12,2016,Sainsburys,Groceries,51,2384
2,12,2016,Costa Coffee,Eating Out,2,2382
2,12,2016,The West Cornwall Pasty Company,Eating Out,7,2375
2,12,2016,Heaven Club,Eating Out,9,2366
2,12,2016,Heaven Club,Eating Out,16,2350
2,12,2016,Heaven Club,Eating Out,9,2341
2,12,2016,Heaven Club,Eating Out,14,2327
2,12,2016,Scott's Restaurant,Eating Out,41,2286
2,12,2016,ATM Cash Withdrawal,General,20,2266
3,12,2016,Fabric Club,Eating Out,6,2260
3,12,2016,Fabric Club,Eating Out,7,2253
3,12,2016,Fabric Club,Eating Out,14,2239
4,12,2016,ATM Cash Withdrawal,General,20,2219
4,12,2016,Tool Tec,,7,2212
5,12,2016,South West Trains,Transport,36,2176
5,12,2016,Caffe Nero,Eating Out,2,2174
5,12,2016,The West Cornwall Pasty Company,Eating Out,6,2168
5,12,2016,ATM Cash Withdrawal,General,20,2148
5,12,2016,Paying back James,,4,2144
6,12,2016,Costa Coffee,Eating Out,2,2142
6,12,2016,ATM Cash Withdrawal,General,20,2122
7,12,2016,Cubit and West rent,Rent,550,1572
7,12,2016,The West Cornwall Pasty Company,Eating Out,6,1566
8,12,2016,Starbucks Coffee,Eating Out,1,1565
8,12,2016,The West Cornwall Pasty Company,Eating Out,8,1557
8,12,2016,ATM Cash Withdrawal,General,20,1537
9,12,2016,Waitrose,Groceries,51,1486
9,12,2016,Wild Bean Cafe,Eating Out,1,1485
9,12,2016,Pret A Manger,Eating Out,7,1478
9,12,2016,Heaven Club,Eating Out,13,1465
9,12,2016,Heaven Club,Eating Out,14,1451
9,12,2016,Heaven Club,Eating Out,12,1439
9,12,2016,Tool Shop,,7,1432
10,12,2016,Heaven Club,Eating Out,5,1427
10,12,2016,Heaven Club,Eating Out,15,1412
10,12,2016,Pizza Express,Eating Out,51,1361
11,12,2016,ATM Cash Withdrawal,General,10,1351
12,12,2016,South West Trains,Transport,27,1324
12,12,2016,Costa Coffee,Eating Out,2,1322
12,12,2016,Paying back Julie,,9,1313
13,12,2016,Caffe Nero,Eating Out,1,1312
13,12,2016,Pret A Manger,Eating Out,7,1305
14,12,2016,McDonalds,Eating Out,8,1297
15,12,2016,BRGAS-Electricity,Bills,29,1268
15,12,2016,BRGAS-Gas,Bills,29,1239
15,12,2016,Wild Bean Cafe,Eating Out,1,1238
15,12,2016,Pret A Manger,Eating Out,8,1230
16,12,2016,LBS Council Tax,Bills,50,1180
16,12,2016,Sainsburys,Groceries,42,1138
16,12,2016,Starbucks Coffee,Eating Out,2,1136
16,12,2016,Heaven Club,Eating Out,7,1129
16,12,2016,Heaven Club,Eating Out,14,1115
17,12,2016,Scott's Restaurant,Eating Out,52,1063
19,12,2016,South West Trains,Transport,38,1025
19,12,2016,Costa Coffee,Eating Out,1,1024
19,12,2016,Greggs,Eating Out,5,1019
19,12,2016,ATM Cash Withdrawal,General,10,1009
20,12,2016,VIRGIN MEDIA PYMTS,Bills,33,976
20,12,2016,Costa Coffee,Eating Out,2,974
21,12,2016,Wild Bean Cafe,Eating Out,2,972
22,12,2016,Caffe Nero,Eating Out,2,970
22,12,2016,The West Cornwall Pasty Company,Eating Out,5,965
23,12,2016,Sainsburys,Groceries,79,886
23,12,2016,McDonalds,Eating Out,6,880
23,12,2016,ATM Cash Withdrawal,General,10,870
24,12,2016,O2,Bills,33,837
25,12,2016,Restaurant Gordon RamsayPortland Restaurant,Eating Out,39,798
26,12,2016,South West Trains,Transport,26,772
26,12,2016,Chicken Cottage,Eating Out,4,768
27,12,2016,Greggs,Eating Out,8,760
27,12,2016,ATM Cash Withdrawal,General,20,740
28,12,2016,The West Cornwall Pasty Company,Eating Out,5,735
29,12,2016,Costa Coffee,Eating Out,1,734
29,12,2016,Cheam Service Station,,8,726
30,12,2016,ASDA,Groceries,61,665
30,12,2016,Costa Coffee,Eating Out,2,663
30,12,2016,Pret A Manger,Eating Out,4,659
30,12,2016,Ministry of Sound ClubXOYO Club,Eating Out,12,647
30,12,2016,Ministry of Sound ClubXOYO Club,Eating Out,7,640
30,12,2016,Ministry of Sound ClubXOYO Club,Eating Out,7,633
30,12,2016,Ministry of Sound ClubXOYO Club,Eating Out,8,625
30,12,2016,Ministry of Sound ClubXOYO Club,Eating Out,10,615
30,12,2016,Ministry of Sound ClubXOYO Club,Eating Out,7,608
1,1,2017,Rhino Sports salary,General,1700,2308
2,1,2017,South West Trains,Transport,25,2283
2,1,2017,Chicken Cottage,Eating Out,5,2278
3,1,2017,Costa Coffee,Eating Out,2,2276
3,1,2017,Subway,Eating Out,6,2270
4,1,2017,ATM Cash Withdrawal,General,10,2260
5,1,2017,Costa Coffee,Eating Out,1,2259
6,1,2017,Morrisons,Groceries,45,2214
6,1,2017,Starbucks Coffee,Eating Out,1,2213
6,1,2017,Chicken Cottage,Eating Out,8,2205
6,1,2017,Scott's Restaurant,Eating Out,36,2169
7,1,2017,Cubit and West rent,Rent,550,1619
7,1,2017,Anglo restaurant,Eating Out,48,1571
7,1,2017,ATM Cash Withdrawal,General,20,1551
8,1,2017,Dominos Pizza,Eating Out,48,1503
8,1,2017,ATM Cash Withdrawal,General,20,1483
9,1,2017,South West Trains,Transport,28,1455
9,1,2017,Pret A Manger,Eating Out,5,1450
11,1,2017,Wild Bean Cafe,Eating Out,1,1449
11,1,2017,Pret A Manger,Eating Out,7,1442
12,1,2017,Starbucks Coffee,Eating Out,1,1441
13,1,2017,Tescos,Groceries,64,1377
13,1,2017,Subway,Eating Out,7,1370
14,1,2017,The Grand Pub,Eating Out,15,1355
14,1,2017,The Grand Pub,Eating Out,11,1344
14,1,2017,The Grand Pub,Eating Out,8,1336
14,1,2017,The Grand Pub,Eating Out,10,1326
14,1,2017,Pizza Express,Eating Out,35,1291
14,1,2017,ATM Cash Withdrawal,General,20,1271
15,1,2017,BRGAS-Electricity,Bills,45,1226
15,1,2017,BRGAS-Gas,Bills,79,1147
15,1,2017,Restaurant Gordon RamsayPortland Restaurant,Eating Out,28,1119
16,1,2017,LBS Council Tax,Bills,50,1069
16,1,2017,South West Trains,Transport,25,1044
16,1,2017,The West Cornwall Pasty Company,Eating Out,7,1037
17,1,2017,Caffe Nero,Eating Out,2,1035
17,1,2017,The West Cornwall Pasty Company,Eating Out,6,1029
17,1,2017,ATM Cash Withdrawal,General,10,1019
18,1,2017,Caffe Nero,Eating Out,2,1017
18,1,2017,Subway,Eating Out,8,1009
18,1,2017,ATM Cash Withdrawal,General,10,999
20,1,2017,VIRGIN MEDIA PYMTS,Bills,36,963
20,1,2017,Tescos,Groceries,76,887
20,1,2017,Caffe Nero,Eating Out,1,886
20,1,2017,ATM Cash Withdrawal,General,20,866
22,1,2017,ATM Cash Withdrawal,General,20,846
23,1,2017,South West Trains,Transport,38,808
23,1,2017,Caffe Nero,Eating Out,2,806
23,1,2017,Chicken Cottage,Eating Out,5,801
23,1,2017,ATM Cash Withdrawal,General,10,791
24,1,2017,O2,Bills,33,758
24,1,2017,Caffe Nero,Eating Out,2,756
24,1,2017,Subway,Eating Out,4,752
25,1,2017,Chicken Cottage,Eating Out,4,748
25,1,2017,Tool Shop,,3,745
26,1,2017,Caffe Nero,Eating Out,2,743
26,1,2017,ATM Cash Withdrawal,General,10,733
27,1,2017,Waitrose,Groceries,66,667
27,1,2017,Wild Bean Cafe,Eating Out,1,666
27,1,2017,Red Shop,,9,657
30,1,2017,South West Trains,Transport,35,622
30,1,2017,Costa Coffee,Eating Out,1,621
30,1,2017,Red Shop,,3,618
31,1,2017,Starbucks Coffee,Eating Out,1,617
31,1,2017,McDonalds,Eating Out,6,611
1,2,2017,Rhino Sports salary,General,1700,2311
1,2,2017,Starbucks Coffee,Eating Out,2,2309
1,2,2017,The West Cornwall Pasty Company,Eating Out,5,2304
1,2,2017,ATM Cash Withdrawal,General,20,2284
2,2,2017,Caffe Nero,Eating Out,2,2282
2,2,2017,McDonalds,Eating Out,5,2277
2,2,2017,ATM Cash Withdrawal,General,10,2267
2,2,2017,Tool Tec,,4,2263
3,2,2017,Tescos,Groceries,70,2193
3,2,2017,Caffe Nero,Eating Out,1,2192
3,2,2017,McDonalds,Eating Out,5,2187
3,2,2017,Ministry of Sound ClubXOYO Club,Eating Out,12,2175
3,2,2017,Ministry of Sound ClubXOYO Club,Eating Out,14,2161
4,2,2017,Scott's Restaurant,Eating Out,48,2113
5,2,2017,Dominos Pizza,Eating Out,37,2076
6,2,2017,South West Trains,Transport,25,2051
6,2,2017,Starbucks Coffee,Eating Out,2,2049
6,2,2017,ATM Cash Withdrawal,General,10,2039
7,2,2017,Cubit and West rent,Rent,550,1489
7,2,2017,Starbucks Coffee,Eating Out,2,1487
7,2,2017,McDonalds,Eating Out,5,1482
7,2,2017,Red Shop,,8,1474
8,2,2017,Starbucks Coffee,Eating Out,2,1472
8,2,2017,Pret A Manger,Eating Out,6,1466
8,2,2017,ATM Cash Withdrawal,General,10,1456
9,2,2017,Costa Coffee,Eating Out,1,1455
9,2,2017,Subway,Eating Out,6,1449
9,2,2017,ATM Cash Withdrawal,General,10,1439
10,2,2017,Sainsburys,Groceries,51,1388
10,2,2017,Wild Bean Cafe,Eating Out,1,1387
10,2,2017,Scott's Restaurant,Eating Out,37,1350
12,2,2017,ATM Cash Withdrawal,General,20,1330
13,2,2017,South West Trains,Transport,33,1297
13,2,2017,ATM Cash Withdrawal,General,10,1287
14,2,2017,Chicken Cottage,Eating Out,5,1282
14,2,2017,ATM Cash Withdrawal,General,10,1272
15,2,2017,BRGAS-Electricity,Bills,21,1251
15,2,2017,BRGAS-Gas,Bills,36,1215
15,2,2017,Caffe Nero,Eating Out,1,1214
15,2,2017,McDonalds,Eating Out,4,1210
15,2,2017,ATM Cash Withdrawal,General,20,1190
16,2,2017,LBS Council Tax,Bills,50,1140
16,2,2017,ATM Cash Withdrawal,General,20,1120
16,2,2017,Civic Shop,,3,1117
17,2,2017,Waitrose,Groceries,51,1066
17,2,2017,Costa Coffee,Eating Out,2,1064
17,2,2017,Chicken Cottage,Eating Out,4,1060
17,2,2017,Tool Shop,,9,1051
19,2,2017,ATM Cash Withdrawal,General,10,1041
20,2,2017,VIRGIN MEDIA PYMTS,Bills,49,992
20,2,2017,South West Trains,Transport,36,956
20,2,2017,Red Shop,,1,955
21,2,2017,ATM Cash Withdrawal,General,10,945
22,2,2017,Greggs,Eating Out,4,941
23,2,2017,Wild Bean Cafe,Eating Out,2,939
23,2,2017,Paying back Julie,,1,938
24,2,2017,O2,Bills,34,904
24,2,2017,Waitrose,Groceries,63,841
24,2,2017,Starbucks Coffee,Eating Out,2,839
24,2,2017,Subway,Eating Out,6,833
25,2,2017,ATM Cash Withdrawal,General,20,813
26,2,2017,Anglo restaurant,Eating Out,26,787
26,2,2017,ATM Cash Withdrawal,General,20,767
27,2,2017,South West Trains,Transport,37,730
27,2,2017,Costa Coffee,Eating Out,1,729
27,2,2017,ATM Cash Withdrawal,General,20,709
28,2,2017,Subway,Eating Out,6,703
1,3,2017,Rhino Sports salary,General,1700,2403
1,3,2017,McDonalds,Eating Out,6,2397
2,3,2017,Costa Coffee,Eating Out,1,2396
3,3,2017,ASDA,Groceries,77,2319
3,3,2017,Caffe Nero,Eating Out,2,2317
3,3,2017,Pizza Express,Eating Out,26,2291
4,3,2017,Scott's Restaurant,Eating Out,59,2232
4,3,2017,ATM Cash Withdrawal,General,20,2212
6,3,2017,South West Trains,Transport,35,2177
6,3,2017,Wild Bean Cafe,Eating Out,1,2176
7,3,2017,Cubit and West rent,Rent,550,1626
7,3,2017,Caffe Nero,Eating Out,2,1624
7,3,2017,Subway,Eating Out,7,1617
8,3,2017,Starbucks Coffee,Eating Out,2,1615
8,3,2017,The West Cornwall Pasty Company,Eating Out,8,1607
9,3,2017,Caffe Nero,Eating Out,1,1606
9,3,2017,ATM Cash Withdrawal,General,10,1596
10,3,2017,Tescos,Groceries,58,1538
10,3,2017,Subway,Eating Out,4,1534
10,3,2017,Restaurant Gordon RamsayPortland Restaurant,Eating Out,38,1496
11,3,2017,Scott's Restaurant,Eating Out,32,1464
12,3,2017,ATM Cash Withdrawal,General,10,1454
13,3,2017,South West Trains,Transport,31,1423
13,3,2017,Wild Bean Cafe,Eating Out,2,1421
13,3,2017,ATM Cash Withdrawal,General,20,1401
14,3,2017,Caffe Nero,Eating Out,1,1400
14,3,2017,ATM Cash Withdrawal,General,20,1380
15,3,2017,BRGAS-Electricity,Bills,22,1358
15,3,2017,BRGAS-Gas,Bills,35,1323
15,3,2017,Costa Coffee,Eating Out,1,1322
15,3,2017,Chicken Cottage,Eating Out,5,1317
16,3,2017,LBS Council Tax,Bills,50,1267
16,3,2017,Wild Bean Cafe,Eating Out,2,1265
16,3,2017,Greggs,Eating Out,4,1261
17,3,2017,Tescos,Groceries,66,1195
17,3,2017,Starbucks Coffee,Eating Out,2,1193
18,3,2017,Restaurant Gordon RamsayPortland Restaurant,Eating Out,27,1166
20,3,2017,VIRGIN MEDIA PYMTS,Bills,58,1108
20,3,2017,South West Trains,Transport,30,1078
20,3,2017,Starbucks Coffee,Eating Out,1,1077
20,3,2017,McDonalds,Eating Out,5,1072
21,3,2017,Caffe Nero,Eating Out,2,1070
21,3,2017,Chicken Cottage,Eating Out,8,1062
22,3,2017,Wild Bean Cafe,Eating Out,2,1060
23,3,2017,Starbucks Coffee,Eating Out,2,1058
23,3,2017,Greggs,Eating Out,4,1054
23,3,2017,ATM Cash Withdrawal,General,10,1044
24,3,2017,O2,Bills,30,1014
24,3,2017,Sainsburys,Groceries,75,939
24,3,2017,Starbucks Coffee,Eating Out,1,938
24,3,2017,McDonalds,Eating Out,4,934
24,3,2017,Dominos Pizza,Eating Out,34,900
24,3,2017,Tool Tec,,6,894
25,3,2017,Dominos Pizza,Eating Out,55,839
25,3,2017,ATM Cash Withdrawal,General,10,829
26,3,2017,ATM Cash Withdrawal,General,10,819
27,3,2017,South West Trains,Transport,37,782
27,3,2017,Wild Bean Cafe,Eating Out,2,780
28,3,2017,Wild Bean Cafe,Eating Out,2,778
30,3,2017,Caffe Nero,Eating Out,2,776
30,3,2017,McDonalds,Eating Out,6,770
31,3,2017,ASDA,Groceries,72,698
31,3,2017,Starbucks Coffee,Eating Out,2,696
31,3,2017,The West Cornwall Pasty Company,Eating Out,7,689
1,4,2017,Rhino Sports salary,General,1700,2389
1,4,2017,Paying back Julie,,9,2380
2,4,2017,Anglo restaurant,Eating Out,40,2340
3,4,2017,South West Trains,Transport,28,2312
3,4,2017,Subway,Eating Out,6,2306
3,4,2017,ATM Cash Withdrawal,General,20,2286
4,4,2017,Wild Bean Cafe,Eating Out,1,2285
4,4,2017,Subway,Eating Out,8,2277
5,4,2017,Starbucks Coffee,Eating Out,2,2275
5,4,2017,Chicken Cottage,Eating Out,5,2270
6,4,2017,Chicken Cottage,Eating Out,8,2262
7,4,2017,Cubit and West rent,Rent,550,1712
7,4,2017,Waitrose,Groceries,87,1625
7,4,2017,Wild Bean Cafe,Eating Out,1,1624
7,4,2017,Greggs,Eating Out,8,1616
7,4,2017,Tool Shop,,1,1615
8,4,2017,Pizza Express,Eating Out,26,1589
9,4,2017,ATM Cash Withdrawal,General,20,1569
10,4,2017,South West Trains,Transport,34,1535
10,4,2017,Caffe Nero,Eating Out,2,1533
10,4,2017,ATM Cash Withdrawal,General,10,1523
11,4,2017,Subway,Eating Out,5,1518
11,4,2017,ATM Cash Withdrawal,General,10,1508
12,4,2017,Wild Bean Cafe,Eating Out,2,1506
12,4,2017,Pret A Manger,Eating Out,8,1498
12,4,2017,ATM Cash Withdrawal,General,20,1478
13,4,2017,Wild Bean Cafe,Eating Out,2,1476
13,4,2017,Greggs,Eating Out,4,1472
14,4,2017,Sainsburys,Groceries,67,1405
14,4,2017,Starbucks Coffee,Eating Out,2,1403
14,4,2017,Pret A Manger,Eating Out,7,1396
14,4,2017,Dominos Pizza,Eating Out,48,1348
15,4,2017,BRGAS-Electricity,Bills,34,1314
15,4,2017,BRGAS-Gas,Bills,43,1271
15,4,2017,Fabric Club,Eating Out,6,1265
15,4,2017,Fabric Club,Eating Out,15,1250
15,4,2017,Fabric Club,Eating Out,9,1241
15,4,2017,Fabric Club,Eating Out,9,1232
15,4,2017,Fabric Club,Eating Out,12,1220
15,4,2017,ATM Cash Withdrawal,General,20,1200
16,4,2017,LBS Council Tax,Bills,50,1150
17,4,2017,South West Trains,Transport,24,1126
17,4,2017,Costa Coffee,Eating Out,1,1125
17,4,2017,Paying back Julie,,5,1120
18,4,2017,Starbucks Coffee,Eating Out,2,1118
19,4,2017,Pret A Manger,Eating Out,5,1113
20,4,2017,VIRGIN MEDIA PYMTS,Bills,39,1074
20,4,2017,Starbucks Coffee,Eating Out,2,1072
20,4,2017,Pret A Manger,Eating Out,8,1064
21,4,2017,ASDA,Groceries,52,1012
21,4,2017,Caffe Nero,Eating Out,1,1011
21,4,2017,The West Cornwall Pasty Company,Eating Out,7,1004
21,4,2017,ATM Cash Withdrawal,General,20,984
24,4,2017,O2,Bills,30,954
24,4,2017,South West Trains,Transport,38,916
24,4,2017,Wild Bean Cafe,Eating Out,1,915
24,4,2017,Chicken Cottage,Eating Out,8,907
24,4,2017,Tool Tec,,5,902
25,4,2017,Caffe Nero,Eating Out,2,900
25,4,2017,Greggs,Eating Out,4,896
26,4,2017,Costa Coffee,Eating Out,2,894
26,4,2017,Chicken Cottage,Eating Out,6,888
27,4,2017,Starbucks Coffee,Eating Out,1,887
27,4,2017,Chicken Cottage,Eating Out,5,882
27,4,2017,ATM Cash Withdrawal,General,10,872
28,4,2017,Sainsburys,Groceries,61,811
28,4,2017,Wild Bean Cafe,Eating Out,1,810
28,4,2017,Fabric Club,Eating Out,14,796
28,4,2017,Fabric Club,Eating Out,11,785
28,4,2017,Dominos Pizza,Eating Out,38,747
30,4,2017,Dominos Pizza,Eating Out,28,719
1,5,2017,Rhino Sports salary,General,1700,2419
1,5,2017,South West Trains,Transport,26,2393
1,5,2017,ATM Cash Withdrawal,General,20,2373
2,5,2017,Wild Bean Cafe,Eating Out,1,2372
2,5,2017,The West Cornwall Pasty Company,Eating Out,4,2368
2,5,2017,ATM Cash Withdrawal,General,20,2348
3,5,2017,Greggs,Eating Out,8,2340
4,5,2017,Pret A Manger,Eating Out,8,2332
4,5,2017,ATM Cash Withdrawal,General,20,2312
5,5,2017,Waitrose,Groceries,51,2261
5,5,2017,Greggs,Eating Out,5,2256
5,5,2017,Pizza Express,Eating Out,38,2218
5,5,2017,Cheam Service Station,,2,2216
6,5,2017,Ministry of Sound ClubXOYO Club,Eating Out,6,2210
6,5,2017,Ministry of Sound ClubXOYO Club,Eating Out,11,2199
6,5,2017,Ministry of Sound ClubXOYO Club,Eating Out,15,2184
7,5,2017,Cubit and West rent,Rent,550,1634
7,5,2017,Scott's Restaurant,Eating Out,51,1583
8,5,2017,South West Trains,Transport,26,1557
8,5,2017,Starbucks Coffee,Eating Out,1,1556
8,5,2017,Cheam Service Station,,1,1555
9,5,2017,Subway,Eating Out,6,1549
9,5,2017,Paying back Julie,,7,1542
10,5,2017,Tool Shop,,4,1538
11,5,2017,Starbucks Coffee,Eating Out,2,1536
11,5,2017,Chicken Cottage,Eating Out,8,1528
12,5,2017,Waitrose,Groceries,57,1471
12,5,2017,Wild Bean Cafe,Eating Out,1,1470
12,5,2017,Greggs,Eating Out,5,1465
12,5,2017,Restaurant Gordon RamsayPortland Restaurant,Eating Out,54,1411
13,5,2017,Pizza Express,Eating Out,37,1374
13,5,2017,ATM Cash Withdrawal,General,10,1364
15,5,2017,BRGAS-Electricity,Bills,34,1330
15,5,2017,BRGAS-Gas,Bills,28,1302
15,5,2017,South West Trains,Transport,35,1267
16,5,2017,LBS Council Tax,Bills,50,1217
16,5,2017,Wild Bean Cafe,Eating Out,1,1216
17,5,2017,Costa Coffee,Eating Out,1,1215
17,5,2017,McDonalds,Eating Out,7,1208
18,5,2017,Costa Coffee,Eating Out,1,1207
19,5,2017,Waitrose,Groceries,42,1165
19,5,2017,Costa Coffee,Eating Out,2,1163
19,5,2017,Subway,Eating Out,6,1157
19,5,2017,ATM Cash Withdrawal,General,10,1147
20,5,2017,VIRGIN MEDIA PYMTS,Bills,45,1102
22,5,2017,South West Trains,Transport,37,1065
22,5,2017,Wild Bean Cafe,Eating Out,2,1063
22,5,2017,Pret A Manger,Eating Out,7,1056
22,5,2017,Tool Shop,,5,1051
23,5,2017,Starbucks Coffee,Eating Out,1,1050
23,5,2017,Subway,Eating Out,8,1042
24,5,2017,O2,Bills,34,1008
24,5,2017,Starbucks Coffee,Eating Out,2,1006
24,5,2017,The West Cornwall Pasty Company,Eating Out,5,1001
24,5,2017,Paying back Julie,,2,999
25,5,2017,Costa Coffee,Eating Out,2,997
25,5,2017,ATM Cash Withdrawal,General,10,987
26,5,2017,Tescos,Groceries,60,927
26,5,2017,Costa Coffee,Eating Out,2,925
26,5,2017,Subway,Eating Out,6,919
26,5,2017,Heaven Club,Eating Out,5,914
26,5,2017,Heaven Club,Eating Out,6,908
26,5,2017,Heaven Club,Eating Out,7,901
26,5,2017,Heaven Club,Eating Out,14,887
26,5,2017,Heaven Club,Eating Out,6,881
29,5,2017,South West Trains,Transport,28,853
29,5,2017,Wild Bean Cafe,Eating Out,2,851
29,5,2017,McDonalds,Eating Out,6,845
30,5,2017,Caffe Nero,Eating Out,2,843
30,5,2017,The West Cornwall Pasty Company,Eating Out,7,836
31,5,2017,Starbucks Coffee,Eating Out,2,834
31,5,2017,ATM Cash Withdrawal,General,10,824
1,6,2017,Rhino Sports salary,General,1700,2524
1,6,2017,Costa Coffee,Eating Out,2,2522
1,6,2017,Greggs,Eating Out,6,2516
2,6,2017,ASDA,Groceries,75,2441
2,6,2017,Wild Bean Cafe,Eating Out,2,2439
2,6,2017,The West Cornwall Pasty Company,Eating Out,6,2433
3,6,2017,Dominos Pizza,Eating Out,34,2399
4,6,2017,Cheam Service Station,,7,2392
5,6,2017,South West Trains,Transport,25,2367
5,6,2017,The West Cornwall Pasty Company,Eating Out,8,2359
6,6,2017,Costa Coffee,Eating Out,2,2357
7,6,2017,Cubit and West rent,Rent,550,1807
8,6,2017,Costa Coffee,Eating Out,1,1806
8,6,2017,McDonalds,Eating Out,5,1801
9,6,2017,Waitrose,Groceries,65,1736
9,6,2017,Caffe Nero,Eating Out,2,1734
10,6,2017,ATM Cash Withdrawal,General,10,1724
11,6,2017,Civic Shop,,3,1721
12,6,2017,South West Trains,Transport,25,1696
12,6,2017,The West Cornwall Pasty Company,Eating Out,7,1689
13,6,2017,Costa Coffee,Eating Out,1,1688
13,6,2017,Subway,Eating Out,8,1680
14,6,2017,Caffe Nero,Eating Out,1,1679
14,6,2017,Tool Shop,,6,1673
15,6,2017,BRGAS-Electricity,Bills,34,1639
15,6,2017,BRGAS-Gas,Bills,25,1614
15,6,2017,Civic Shop,,8,1606
16,6,2017,LBS Council Tax,Bills,50,1556
16,6,2017,Morrisons,Groceries,45,1511
16,6,2017,Wild Bean Cafe,Eating Out,1,1510
17,6,2017,ATM Cash Withdrawal,General,20,1490
18,6,2017,Anglo restaurant,Eating Out,59,1431
18,6,2017,ATM Cash Withdrawal,General,20,1411
19,6,2017,South West Trains,Transport,35,1376
19,6,2017,Wild Bean Cafe,Eating Out,2,1374
19,6,2017,The West Cornwall Pasty Company,Eating Out,8,1366
19,6,2017,Civic Shop,,7,1359
20,6,2017,VIRGIN MEDIA PYMTS,Bills,59,1300
20,6,2017,Costa Coffee,Eating Out,2,1298
21,6,2017,Caffe Nero,Eating Out,1,1297
21,6,2017,Subway,Eating Out,5,1292
21,6,2017,ATM Cash Withdrawal,General,10,1282
22,6,2017,Starbucks Coffee,Eating Out,1,1281
22,6,2017,Pret A Manger,Eating Out,8,1273
23,6,2017,ASDA,Groceries,88,1185
23,6,2017,Starbucks Coffee,Eating Out,2,1183
23,6,2017,Chicken Cottage,Eating Out,6,1177
23,6,2017,Paying back James,,6,1171
24,6,2017,O2,Bills,36,1135
24,6,2017,Pizza Express,Eating Out,24,1111
24,6,2017,Tool Tec,,9,1102
25,6,2017,ATM Cash Withdrawal,General,10,1092
26,6,2017,South West Trains,Transport,24,1068
26,6,2017,Costa Coffee,Eating Out,1,1067
26,6,2017,Subway,Eating Out,4,1063
27,6,2017,Costa Coffee,Eating Out,1,1062
27,6,2017,Subway,Eating Out,7,1055
28,6,2017,Caffe Nero,Eating Out,2,1053
28,6,2017,Subway,Eating Out,6,1047
28,6,2017,ATM Cash Withdrawal,General,20,1027
29,6,2017,Subway,Eating Out,5,1022
30,6,2017,Sainsburys,Groceries,68,954
30,6,2017,Caffe Nero,Eating Out,2,952
30,6,2017,The West Cornwall Pasty Company,Eating Out,6,946
30,6,2017,Anglo restaurant,Eating Out,56,890
1,7,2017,Rhino Sports salary,General,1700,2590
1,7,2017,ATM Cash Withdrawal,General,20,2570
2,7,2017,Pizza Express,Eating Out,44,2526
3,7,2017,South West Trains,Transport,35,2491
3,7,2017,Wild Bean Cafe,Eating Out,1,2490
3,7,2017,Greggs,Eating Out,5,2485
4,7,2017,Starbucks Coffee,Eating Out,1,2484
5,7,2017,Starbucks Coffee,Eating Out,1,2483
5,7,2017,Chicken Cottage,Eating Out,4,2479
6,7,2017,Wild Bean Cafe,Eating Out,2,2477
6,7,2017,Greggs,Eating Out,4,2473
7,7,2017,Cubit and West rent,Rent,550,1923
7,7,2017,Waitrose,Groceries,62,1861
7,7,2017,Subway,Eating Out,7,1854
8,7,2017,ATM Cash Withdrawal,General,10,1844
9,7,2017,Pizza Express,Eating Out,46,1798
10,7,2017,South West Trains,Transport,34,1764
10,7,2017,Caffe Nero,Eating Out,2,1762
10,7,2017,Greggs,Eating Out,8,1754
10,7,2017,Tool Shop,,1,1753
11,7,2017,Starbucks Coffee,Eating Out,1,1752
12,7,2017,Caffe Nero,Eating Out,1,1751
12,7,2017,The West Cornwall Pasty Company,Eating Out,4,1747
13,7,2017,Wild Bean Cafe,Eating Out,2,1745
13,7,2017,The West Cornwall Pasty Company,Eating Out,8,1737
14,7,2017,Waitrose,Groceries,53,1684
14,7,2017,Starbucks Coffee,Eating Out,2,1682
14,7,2017,Pret A Manger,Eating Out,7,1675
15,7,2017,BRGAS-Electricity,Bills,28,1647
15,7,2017,BRGAS-Gas,Bills,35,1612
15,7,2017,ATM Cash Withdrawal,General,20,1592
16,7,2017,LBS Council Tax,Bills,50,1542
17,7,2017,South West Trains,Transport,33,1509
17,7,2017,Caffe Nero,Eating Out,2,1507
17,7,2017,ATM Cash Withdrawal,General,10,1497
18,7,2017,Costa Coffee,Eating Out,1,1496
18,7,2017,ATM Cash Withdrawal,General,20,1476
19,7,2017,Wild Bean Cafe,Eating Out,2,1474
19,7,2017,Pret A Manger,Eating Out,7,1467
19,7,2017,ATM Cash Withdrawal,General,20,1447
20,7,2017,VIRGIN MEDIA PYMTS,Bills,51,1396
20,7,2017,Caffe Nero,Eating Out,2,1394
20,7,2017,Subway,Eating Out,6,1388
21,7,2017,Morrisons,Groceries,67,1321
21,7,2017,Caffe Nero,Eating Out,2,1319
21,7,2017,Greggs,Eating Out,8,1311
23,7,2017,Cheam Service Station,,2,1309
24,7,2017,O2,Bills,33,1276
24,7,2017,South West Trains,Transport,32,1244
24,7,2017,Costa Coffee,Eating Out,2,1242
24,7,2017,Greggs,Eating Out,8,1234
24,7,2017,ATM Cash Withdrawal,General,10,1224
25,7,2017,Greggs,Eating Out,8,1216
27,7,2017,Subway,Eating Out,4,1212
28,7,2017,Waitrose,Groceries,65,1147
28,7,2017,Costa Coffee,Eating Out,2,1145
29,7,2017,Pizza Express,Eating Out,36,1109
29,7,2017,Tool Tec,,3,1106
30,7,2017,Scott's Restaurant,Eating Out,49,1057
30,7,2017,Paying back James,,4,1053
31,7,2017,South West Trains,Transport,24,1029
31,7,2017,Caffe Nero,Eating Out,1,1028
31,7,2017,Pret A Manger,Eating Out,5,1023
1,8,2017,Rhino Sports salary,General,1700,2723
1,8,2017,Starbucks Coffee,Eating Out,2,2721
1,8,2017,McDonalds,Eating Out,7,2714
1,8,2017,ATM Cash Withdrawal,General,10,2704
2,8,2017,Costa Coffee,Eating Out,1,2703
2,8,2017,McDonalds,Eating Out,4,2699
3,8,2017,Caffe Nero,Eating Out,2,2697
3,8,2017,Greggs,Eating Out,8,2689
4,8,2017,Waitrose,Groceries,77,2612
4,8,2017,Caffe Nero,Eating Out,1,2611
4,8,2017,The West Cornwall Pasty Company,Eating Out,5,2606
4,8,2017,ATM Cash Withdrawal,General,10,2596
5,8,2017,ATM Cash Withdrawal,General,20,2576
7,8,2017,Cubit and West rent,Rent,550,2026
7,8,2017,South West Trains,Transport,31,1995
7,8,2017,Starbucks Coffee,Eating Out,2,1993
7,8,2017,McDonalds,Eating Out,5,1988
8,8,2017,Starbucks Coffee,Eating Out,2,1986
8,8,2017,Chicken Cottage,Eating Out,4,1982
9,8,2017,Caffe Nero,Eating Out,1,1981
9,8,2017,Greggs,Eating Out,7,1974
10,8,2017,Starbucks Coffee,Eating Out,2,1972
10,8,2017,Paying back James,,3,1969
11,8,2017,Sainsburys,Groceries,76,1893
11,8,2017,Starbucks Coffee,Eating Out,2,1891
11,8,2017,Chicken Cottage,Eating Out,4,1887
11,8,2017,Scott's Restaurant,Eating Out,31,1856
13,8,2017,ATM Cash Withdrawal,General,20,1836
13,8,2017,Paying back Julie,,8,1828
14,8,2017,South West Trains,Transport,32,1796
14,8,2017,Caffe Nero,Eating Out,2,1794
14,8,2017,ATM Cash Withdrawal,General,20,1774
15,8,2017,BRGAS-Electricity,Bills,24,1750
15,8,2017,BRGAS-Gas,Bills,44,1706
15,8,2017,Starbucks Coffee,Eating Out,1,1705
15,8,2017,Greggs,Eating Out,4,1701
15,8,2017,ATM Cash Withdrawal,General,10,1691
16,8,2017,LBS Council Tax,Bills,50,1641
16,8,2017,Wild Bean Cafe,Eating Out,2,1639
16,8,2017,Chicken Cottage,Eating Out,6,1633
17,8,2017,Wild Bean Cafe,Eating Out,1,1632
18,8,2017,Tescos,Groceries,59,1573
18,8,2017,Wild Bean Cafe,Eating Out,1,1572
18,8,2017,Subway,Eating Out,7,1565
18,8,2017,Dominos Pizza,Eating Out,40,1525
18,8,2017,ATM Cash Withdrawal,General,20,1505
19,8,2017,Pizza Express,Eating Out,52,1453
20,8,2017,VIRGIN MEDIA PYMTS,Bills,58,1395
21,8,2017,South West Trains,Transport,35,1360
21,8,2017,Starbucks Coffee,Eating Out,1,1359
22,8,2017,Pret A Manger,Eating Out,8,1351
23,8,2017,Costa Coffee,Eating Out,2,1349
23,8,2017,Chicken Cottage,Eating Out,4,1345
24,8,2017,O2,Bills,36,1309
24,8,2017,Wild Bean Cafe,Eating Out,2,1307
24,8,2017,Subway,Eating Out,4,1303
25,8,2017,ASDA,Groceries,45,1258
25,8,2017,Chicken Cottage,Eating Out,4,1254
25,8,2017,Pizza Express,Eating Out,53,1201
26,8,2017,Fabric Club,Eating Out,15,1186
26,8,2017,Fabric Club,Eating Out,9,1177
26,8,2017,Fabric Club,Eating Out,7,1170
26,8,2017,Fabric Club,Eating Out,14,1156
26,8,2017,Fabric Club,Eating Out,7,1149
26,8,2017,Cheam Service Station,,8,1141
27,8,2017,Tool Shop,,7,1134
28,8,2017,South West Trains,Transport,32,1102
28,8,2017,Caffe Nero,Eating Out,1,1101
28,8,2017,ATM Cash Withdrawal,General,20,1081
29,8,2017,Costa Coffee,Eating Out,2,1079
29,8,2017,Cheam Service Station,,4,1075
30,8,2017,Subway,Eating Out,4,1071
30,8,2017,Paying back James,,6,1065
31,8,2017,ATM Cash Withdrawal,General,20,1045
1,9,2017,Rhino Sports salary,General,1700,2745
1,9,2017,Sainsburys,Groceries,44,2701
1,9,2017,Caffe Nero,Eating Out,1,2700
1,9,2017,Subway,Eating Out,6,2694
2,9,2017,Pizza Express,Eating Out,40,2654
3,9,2017,ATM Cash Withdrawal,General,20,2634
4,9,2017,South West Trains,Transport,31,2603
4,9,2017,Costa Coffee,Eating Out,1,2602
4,9,2017,ATM Cash Withdrawal,General,10,2592
5,9,2017,Costa Coffee,Eating Out,1,2591
5,9,2017,Chicken Cottage,Eating Out,8,2583
6,9,2017,Starbucks Coffee,Eating Out,2,2581
6,9,2017,The West Cornwall Pasty Company,Eating Out,5,2576
7,9,2017,Cubit and West rent,Rent,550,2026
7,9,2017,Wild Bean Cafe,Eating Out,1,2025
7,9,2017,McDonalds,Eating Out,5,2020
7,9,2017,Paying back James,,4,2016
8,9,2017,Morrisons,Groceries,57,1959
8,9,2017,Greggs,Eating Out,6,1953
8,9,2017,Heaven Club,Eating Out,15,1938
8,9,2017,Heaven Club,Eating Out,15,1923
8,9,2017,Heaven Club,Eating Out,13,1910
8,9,2017,Heaven Club,Eating Out,8,1902
8,9,2017,Heaven Club,Eating Out,10,1892
8,9,2017,Heaven Club,Eating Out,9,1883
8,9,2017,Scott's Restaurant,Eating Out,48,1835
9,9,2017,ATM Cash Withdrawal,General,20,1815
9,9,2017,Civic Shop,,2,1813
10,9,2017,Anglo restaurant,Eating Out,40,1773
11,9,2017,South West Trains,Transport,26,1747
11,9,2017,Costa Coffee,Eating Out,1,1746
11,9,2017,Chicken Cottage,Eating Out,7,1739
12,9,2017,Caffe Nero,Eating Out,2,1737
12,9,2017,Subway,Eating Out,7,1730
13,9,2017,Wild Bean Cafe,Eating Out,2,1728
13,9,2017,McDonalds,Eating Out,7,1721
14,9,2017,Starbucks Coffee,Eating Out,2,1719
14,9,2017,Pret A Manger,Eating Out,8,1711
15,9,2017,BRGAS-Electricity,Bills,43,1668
15,9,2017,BRGAS-Gas,Bills,35,1633
15,9,2017,Sainsburys,Groceries,58,1575
15,9,2017,Wild Bean Cafe,Eating Out,1,1574
15,9,2017,Anglo restaurant,Eating Out,58,1516
15,9,2017,ATM Cash Withdrawal,General,20,1496
16,9,2017,LBS Council Tax,Bills,50,1446
18,9,2017,South West Trains,Transport,34,1412
18,9,2017,Costa Coffee,Eating Out,2,1410
18,9,2017,The West Cornwall Pasty Company,Eating Out,7,1403
19,9,2017,Caffe Nero,Eating Out,2,1401
20,9,2017,VIRGIN MEDIA PYMTS,Bills,33,1368
20,9,2017,Starbucks Coffee,Eating Out,1,1367
20,9,2017,McDonalds,Eating Out,7,1360
20,9,2017,ATM Cash Withdrawal,General,20,1340
21,9,2017,Starbucks Coffee,Eating Out,2,1338
21,9,2017,Chicken Cottage,Eating Out,4,1334
22,9,2017,ASDA,Groceries,85,1249
22,9,2017,Costa Coffee,Eating Out,1,1248
22,9,2017,ATM Cash Withdrawal,General,20,1228
24,9,2017,O2,Bills,34,1194
24,9,2017,Anglo restaurant,Eating Out,54,1140
25,9,2017,South West Trains,Transport,29,1111
26,9,2017,Wild Bean Cafe,Eating Out,2,1109
26,9,2017,ATM Cash Withdrawal,General,20,1089
27,9,2017,Costa Coffee,Eating Out,1,1088
27,9,2017,Chicken Cottage,Eating Out,8,1080
27,9,2017,Tool Tec,,3,1077
28,9,2017,Wild Bean Cafe,Eating Out,1,1076
28,9,2017,ATM Cash Withdrawal,General,10,1066
29,9,2017,Morrisons,Groceries,56,1010
29,9,2017,Wild Bean Cafe,Eating Out,1,1009
29,9,2017,Subway,Eating Out,4,1005
29,9,2017,Ministry of Sound ClubXOYO Club,Eating Out,8,997
29,9,2017,Ministry of Sound ClubXOYO Club,Eating Out,15,982
29,9,2017,Ministry of Sound ClubXOYO Club,Eating Out,13,969
29,9,2017,Ministry of Sound ClubXOYO Club,Eating Out,5,964
29,9,2017,Ministry of Sound ClubXOYO Club,Eating Out,11,953
29,9,2017,Dominos Pizza,Eating Out,59,894
30,9,2017,Paying back James,,3,891
1,10,2017,Rhino Sports salary,General,1700,2591
2,10,2017,South West Trains,Transport,37,2554
2,10,2017,Starbucks Coffee,Eating Out,1,2553
2,10,2017,Chicken Cottage,Eating Out,8,2545
3,10,2017,Wild Bean Cafe,Eating Out,2,2543
3,10,2017,ATM Cash Withdrawal,General,20,2523
4,10,2017,Caffe Nero,Eating Out,1,2522
4,10,2017,Chicken Cottage,Eating Out,5,2517
4,10,2017,ATM Cash Withdrawal,General,20,2497
5,10,2017,Costa Coffee,Eating Out,1,2496
5,10,2017,Subway,Eating Out,5,2491
5,10,2017,ATM Cash Withdrawal,General,20,2471
6,10,2017,ASDA,Groceries,86,2385
6,10,2017,Subway,Eating Out,6,2379
6,10,2017,ATM Cash Withdrawal,General,10,2369
7,10,2017,Cubit and West rent,Rent,550,1819
8,10,2017,ATM Cash Withdrawal,General,10,1809
9,10,2017,South West Trains,Transport,28,1781
10,10,2017,Wild Bean Cafe,Eating Out,2,1779
10,10,2017,Chicken Cottage,Eating Out,5,1774
11,10,2017,Greggs,Eating Out,5,1769
12,10,2017,Caffe Nero,Eating Out,2,1767
12,10,2017,Pret A Manger,Eating Out,5,1762
13,10,2017,Morrisons,Groceries,63,1699
13,10,2017,Starbucks Coffee,Eating Out,2,1697
13,10,2017,McDonalds,Eating Out,8,1689
13,10,2017,Cheam Service Station,,5,1684
15,10,2017,BRGAS-Electricity,Bills,38,1646
15,10,2017,BRGAS-Gas,Bills,25,1621
15,10,2017,Red Shop,,4,1617
16,10,2017,LBS Council Tax,Bills,50,1567
16,10,2017,South West Trains,Transport,32,1535
16,10,2017,ATM Cash Withdrawal,General,10,1525
17,10,2017,Costa Coffee,Eating Out,1,1524
17,10,2017,Chicken Cottage,Eating Out,5,1519
17,10,2017,ATM Cash Withdrawal,General,10,1509
17,10,2017,Red Shop,,1,1508
18,10,2017,ATM Cash Withdrawal,General,10,1498
19,10,2017,Chicken Cottage,Eating Out,6,1492
19,10,2017,ATM Cash Withdrawal,General,20,1472
20,10,2017,VIRGIN MEDIA PYMTS,Bills,31,1441
20,10,2017,Waitrose,Groceries,56,1385
20,10,2017,The West Cornwall Pasty Company,Eating Out,7,1378
20,10,2017,Paying back Julie,,7,1371
21,10,2017,Fabric Club,Eating Out,6,1365
21,10,2017,Fabric Club,Eating Out,12,1353
21,10,2017,Fabric Club,Eating Out,16,1337
21,10,2017,Fabric Club,Eating Out,10,1327
21,10,2017,Pizza Express,Eating Out,51,1276
21,10,2017,Tool Tec,,2,1274
22,10,2017,Anglo restaurant,Eating Out,59,1215
23,10,2017,South West Trains,Transport,34,1181
23,10,2017,Starbucks Coffee,Eating Out,1,1180
23,10,2017,McDonalds,Eating Out,5,1175
24,10,2017,O2,Bills,33,1142
24,10,2017,Costa Coffee,Eating Out,2,1140
24,10,2017,McDonalds,Eating Out,5,1135
25,10,2017,ATM Cash Withdrawal,General,10,1125
25,10,2017,Tool Tec,,3,1122
26,10,2017,Caffe Nero,Eating Out,2,1120
26,10,2017,Tool Tec,,6,1114
27,10,2017,Sainsburys,Groceries,70,1044
27,10,2017,Starbucks Coffee,Eating Out,2,1042
27,10,2017,Greggs,Eating Out,4,1038
27,10,2017,ATM Cash Withdrawal,General,20,1018
28,10,2017,Ministry of Sound ClubXOYO Club,Eating Out,12,1006
28,10,2017,Ministry of Sound ClubXOYO Club,Eating Out,13,993
28,10,2017,Ministry of Sound ClubXOYO Club,Eating Out,15,978
28,10,2017,Ministry of Sound ClubXOYO Club,Eating Out,10,968
29,10,2017,Dominos Pizza,Eating Out,36,932
29,10,2017,ATM Cash Withdrawal,General,20,912
30,10,2017,South West Trains,Transport,36,876
30,10,2017,Costa Coffee,Eating Out,1,875
30,10,2017,McDonalds,Eating Out,7,868
30,10,2017,ATM Cash Withdrawal,General,10,858
31,10,2017,Starbucks Coffee,Eating Out,1,857
31,10,2017,Subway,Eating Out,6,851
1,11,2017,Rhino Sports salary,General,1700,2551
1,11,2017,Costa Coffee,Eating Out,2,2549
1,11,2017,Pret A Manger,Eating Out,8,2541
2,11,2017,Caffe Nero,Eating Out,1,2540
2,11,2017,Pret A Manger,Eating Out,8,2532
2,11,2017,ATM Cash Withdrawal,General,10,2522
3,11,2017,ASDA,Groceries,58,2464
3,11,2017,Starbucks Coffee,Eating Out,2,2462
3,11,2017,Subway,Eating Out,6,2456
4,11,2017,Dominos Pizza,Eating Out,37,2419
4,11,2017,ATM Cash Withdrawal,General,10,2409
6,11,2017,South West Trains,Transport,38,2371
6,11,2017,Caffe Nero,Eating Out,1,2370
6,11,2017,McDonalds,Eating Out,6,2364
7,11,2017,Cubit and West rent,Rent,550,1814
7,11,2017,Wild Bean Cafe,Eating Out,1,1813
7,11,2017,The West Cornwall Pasty Company,Eating Out,7,1806
7,11,2017,ATM Cash Withdrawal,General,10,1796
9,11,2017,Wild Bean Cafe,Eating Out,2,1794
10,11,2017,Waitrose,Groceries,85,1709
10,11,2017,Costa Coffee,Eating Out,1,1708
10,11,2017,Red Shop,,7,1701
11,11,2017,Dominos Pizza,Eating Out,48,1653
12,11,2017,Pizza Express,Eating Out,39,1614
12,11,2017,ATM Cash Withdrawal,General,10,1604
13,11,2017,South West Trains,Transport,24,1580
13,11,2017,Caffe Nero,Eating Out,2,1578
13,11,2017,ATM Cash Withdrawal,General,20,1558
15,11,2017,BRGAS-Electricity,Bills,47,1511
15,11,2017,BRGAS-Gas,Bills,52,1459
15,11,2017,Wild Bean Cafe,Eating Out,2,1457
16,11,2017,LBS Council Tax,Bills,50,1407
16,11,2017,Costa Coffee,Eating Out,1,1406
16,11,2017,Chicken Cottage,Eating Out,8,1398
17,11,2017,Morrisons,Groceries,54,1344
17,11,2017,Caffe Nero,Eating Out,1,1343
17,11,2017,Chicken Cottage,Eating Out,8,1335
20,11,2017,VIRGIN MEDIA PYMTS,Bills,46,1289
20,11,2017,South West Trains,Transport,37,1252
20,11,2017,Costa Coffee,Eating Out,2,1250
20,11,2017,ATM Cash Withdrawal,General,20,1230
21,11,2017,Starbucks Coffee,Eating Out,2,1228
21,11,2017,Pret A Manger,Eating Out,7,1221
22,11,2017,McDonalds,Eating Out,8,1213
22,11,2017,Cheam Service Station,,2,1211
24,11,2017,O2,Bills,31,1180
24,11,2017,Sainsburys,Groceries,52,1128
24,11,2017,Caffe Nero,Eating Out,1,1127
24,11,2017,Greggs,Eating Out,8,1119
24,11,2017,Scott's Restaurant,Eating Out,28,1091
25,11,2017,ATM Cash Withdrawal,General,10,1081
26,11,2017,Anglo restaurant,Eating Out,57,1024
27,11,2017,South West Trains,Transport,35,989
27,11,2017,Costa Coffee,Eating Out,2,987
28,11,2017,Caffe Nero,Eating Out,1,986
29,11,2017,Caffe Nero,Eating Out,2,984
29,11,2017,McDonalds,Eating Out,5,979
30,11,2017,Costa Coffee,Eating Out,2,977
30,11,2017,Greggs,Eating Out,6,971
1,12,2017,Rhino Sports salary,General,1700,2671
1,12,2017,Morrisons,Groceries,48,2623
1,12,2017,Chicken Cottage,Eating Out,5,2618
2,12,2017,ATM Cash Withdrawal,General,20,2598
3,12,2017,ATM Cash Withdrawal,General,10,2588
3,12,2017,Tool Shop,,6,2582
4,12,2017,South West Trains,Transport,30,2552
4,12,2017,Wild Bean Cafe,Eating Out,2,2550
4,12,2017,ATM Cash Withdrawal,General,10,2540
5,12,2017,The West Cornwall Pasty Company,Eating Out,7,2533
5,12,2017,ATM Cash Withdrawal,General,20,2513
6,12,2017,McDonalds,Eating Out,5,2508
7,12,2017,Cubit and West rent,Rent,550,1958
7,12,2017,Caffe Nero,Eating Out,2,1956
7,12,2017,The West Cornwall Pasty Company,Eating Out,6,1950
7,12,2017,ATM Cash Withdrawal,General,10,1940
8,12,2017,ASDA,Groceries,80,1860
8,12,2017,Caffe Nero,Eating Out,2,1858
8,12,2017,Subway,Eating Out,5,1853
8,12,2017,Dominos Pizza,Eating Out,43,1810
11,12,2017,South West Trains,Transport,34,1776
11,12,2017,McDonalds,Eating Out,8,1768
13,12,2017,Wild Bean Cafe,Eating Out,2,1766
13,12,2017,The West Cornwall Pasty Company,Eating Out,8,1758
13,12,2017,ATM Cash Withdrawal,General,10,1748
14,12,2017,Starbucks Coffee,Eating Out,1,1747
14,12,2017,Pret A Manger,Eating Out,7,1740
14,12,2017,ATM Cash Withdrawal,General,20,1720
15,12,2017,BRGAS-Electricity,Bills,24,1696
15,12,2017,BRGAS-Gas,Bills,26,1670
15,12,2017,Tescos,Groceries,83,1587
15,12,2017,Greggs,Eating Out,7,1580
15,12,2017,Heaven Club,Eating Out,16,1564
15,12,2017,Heaven Club,Eating Out,9,1555
15,12,2017,Heaven Club,Eating Out,5,1550
15,12,2017,Heaven Club,Eating Out,14,1536
15,12,2017,Heaven Club,Eating Out,12,1524
15,12,2017,Paying back Julie,,1,1523
16,12,2017,LBS Council Tax,Bills,50,1473
16,12,2017,Tool Shop,,8,1465
17,12,2017,Restaurant Gordon RamsayPortland Restaurant,Eating Out,32,1433
18,12,2017,South West Trains,Transport,32,1401
18,12,2017,Starbucks Coffee,Eating Out,1,1400
18,12,2017,McDonalds,Eating Out,4,1396
19,12,2017,Costa Coffee,Eating Out,2,1394
19,12,2017,Greggs,Eating Out,4,1390
19,12,2017,ATM Cash Withdrawal,General,20,1370
20,12,2017,VIRGIN MEDIA PYMTS,Bills,42,1328
21,12,2017,Starbucks Coffee,Eating Out,2,1326
22,12,2017,Morrisons,Groceries,76,1250
22,12,2017,Wild Bean Cafe,Eating Out,2,1248
22,12,2017,Heaven Club,Eating Out,16,1232
23,12,2017,Pizza Express,Eating Out,29,1203
24,12,2017,O2,Bills,37,1166
25,12,2017,South West Trains,Transport,31,1135
25,12,2017,Starbucks Coffee,Eating Out,2,1133
26,12,2017,McDonalds,Eating Out,6,1127
27,12,2017,Wild Bean Cafe,Eating Out,2,1125
27,12,2017,Chicken Cottage,Eating Out,5,1120
27,12,2017,ATM Cash Withdrawal,General,20,1100
28,12,2017,Starbucks Coffee,Eating Out,2,1098
29,12,2017,Tescos,Groceries,81,1017
29,12,2017,Costa Coffee,Eating Out,2,1015
29,12,2017,Chicken Cottage,Eating Out,7,1008
30,12,2017,Scott's Restaurant,Eating Out,27,981
31,12,2017,Anglo restaurant,Eating Out,56,925
31,12,2017,Tool Tec,,5,920
1,1,2018,Rhino Sports salary,General,1700,2620
1,1,2018,South West Trains,Transport,29,2591
1,1,2018,Caffe Nero,Eating Out,2,2589
1,1,2018,ATM Cash Withdrawal,General,20,2569
1,1,2018,Cheam Service Station,,1,2568
3,1,2018,Chicken Cottage,Eating Out,5,2563
4,1,2018,Starbucks Coffee,Eating Out,2,2561
5,1,2018,Waitrose,Groceries,62,2499
5,1,2018,Starbucks Coffee,Eating Out,2,2497
5,1,2018,Dominos Pizza,Eating Out,34,2463
6,1,2018,Dominos Pizza,Eating Out,43,2420
7,1,2018,Cubit and West rent,Rent,550,1870
7,1,2018,Restaurant Gordon RamsayPortland Restaurant,Eating Out,29,1841
8,1,2018,South West Trains,Transport,37,1804
8,1,2018,Subway,Eating Out,8,1796
8,1,2018,Cheam Service Station,,7,1789
9,1,2018,Caffe Nero,Eating Out,2,1787
9,1,2018,Red Shop,,7,1780
10,1,2018,Wild Bean Cafe,Eating Out,1,1779
10,1,2018,Pret A Manger,Eating Out,6,1773
10,1,2018,Tool Tec,,2,1771
11,1,2018,Wild Bean Cafe,Eating Out,2,1769
11,1,2018,Pret A Manger,Eating Out,6,1763
12,1,2018,Tescos,Groceries,42,1721
12,1,2018,Wild Bean Cafe,Eating Out,2,1719
12,1,2018,The West Cornwall Pasty Company,Eating Out,5,1714
12,1,2018,ATM Cash Withdrawal,General,20,1694
14,1,2018,ATM Cash Withdrawal,General,20,1674
14,1,2018,Red Shop,,5,1669
15,1,2018,BRGAS-Electricity,Bills,64,1605
15,1,2018,BRGAS-Gas,Bills,84,1521
15,1,2018,South West Trains,Transport,31,1490
15,1,2018,Caffe Nero,Eating Out,1,1489
15,1,2018,Chicken Cottage,Eating Out,7,1482
15,1,2018,ATM Cash Withdrawal,General,20,1462
16,1,2018,LBS Council Tax,Bills,50,1412
16,1,2018,Costa Coffee,Eating Out,2,1410
16,1,2018,The West Cornwall Pasty Company,Eating Out,5,1405
17,1,2018,Costa Coffee,Eating Out,2,1403
18,1,2018,Costa Coffee,Eating Out,2,1401
18,1,2018,Chicken Cottage,Eating Out,8,1393
19,1,2018,Sainsburys,Groceries,57,1336
19,1,2018,Wild Bean Cafe,Eating Out,1,1335
19,1,2018,Red Shop,,7,1328
20,1,2018,VIRGIN MEDIA PYMTS,Bills,31,1297
20,1,2018,ATM Cash Withdrawal,General,20,1277
21,1,2018,ATM Cash Withdrawal,General,10,1267
22,1,2018,South West Trains,Transport,35,1232
22,1,2018,Costa Coffee,Eating Out,2,1230
22,1,2018,ATM Cash Withdrawal,General,10,1220
23,1,2018,Greggs,Eating Out,6,1214
23,1,2018,Red Shop,,8,1206
24,1,2018,O2,Bills,31,1175
24,1,2018,Costa Coffee,Eating Out,2,1173
24,1,2018,Chicken Cottage,Eating Out,8,1165
24,1,2018,ATM Cash Withdrawal,General,20,1145
25,1,2018,Chicken Cottage,Eating Out,6,1139
25,1,2018,ATM Cash Withdrawal,General,10,1129
26,1,2018,Tescos,Groceries,69,1060
26,1,2018,Greggs,Eating Out,4,1056
26,1,2018,Anglo restaurant,Eating Out,51,1005
27,1,2018,Pizza Express,Eating Out,51,954
27,1,2018,ATM Cash Withdrawal,General,10,944
27,1,2018,Cheam Service Station,,3,941
28,1,2018,ATM Cash Withdrawal,General,10,931
29,1,2018,South West Trains,Transport,29,902
29,1,2018,Costa Coffee,Eating Out,2,900
29,1,2018,McDonalds,Eating Out,5,895
30,1,2018,Wild Bean Cafe,Eating Out,2,893
30,1,2018,Greggs,Eating Out,6,887
31,1,2018,Pret A Manger,Eating Out,7,880
31,1,2018,ATM Cash Withdrawal,General,10,870
1,2,2018,Rhino Sports salary,General,1700,2570
1,2,2018,Starbucks Coffee,Eating Out,1,2569
1,2,2018,The West Cornwall Pasty Company,Eating Out,6,2563
1,2,2018,Cheam Service Station,,2,2561
2,2,2018,Sainsburys,Groceries,52,2509
2,2,2018,Starbucks Coffee,Eating Out,2,2507
2,2,2018,Restaurant Gordon RamsayPortland Restaurant,Eating Out,38,2469
3,2,2018,Anglo restaurant,Eating Out,52,2417
4,2,2018,ATM Cash Withdrawal,General,10,2407
5,2,2018,South West Trains,Transport,30,2377
6,2,2018,Starbucks Coffee,Eating Out,2,2375
6,2,2018,Chicken Cottage,Eating Out,8,2367
6,2,2018,ATM Cash Withdrawal,General,20,2347
7,2,2018,Cubit and West rent,Rent,550,1797
7,2,2018,Starbucks Coffee,Eating Out,2,1795
7,2,2018,McDonalds,Eating Out,5,1790
8,2,2018,Starbucks Coffee,Eating Out,2,1788
8,2,2018,Civic Shop,,6,1782
9,2,2018,Morrisons,Groceries,81,1701
9,2,2018,Caffe Nero,Eating Out,2,1699
9,2,2018,McDonalds,Eating Out,6,1693
9,2,2018,ATM Cash Withdrawal,General,20,1673
10,2,2018,ATM Cash Withdrawal,General,20,1653
12,2,2018,South West Trains,Transport,31,1622
12,2,2018,Caffe Nero,Eating Out,2,1620
12,2,2018,ATM Cash Withdrawal,General,10,1610
13,2,2018,McDonalds,Eating Out,7,1603
14,2,2018,Starbucks Coffee,Eating Out,2,1601
14,2,2018,McDonalds,Eating Out,4,1597
15,2,2018,BRGAS-Electricity,Bills,40,1557
15,2,2018,BRGAS-Gas,Bills,34,1523
15,2,2018,Starbucks Coffee,Eating Out,2,1521
15,2,2018,The West Cornwall Pasty Company,Eating Out,5,1516
15,2,2018,Tool Shop,,1,1515
16,2,2018,LBS Council Tax,Bills,50,1465
16,2,2018,ASDA,Groceries,88,1377
16,2,2018,Wild Bean Cafe,Eating Out,2,1375
16,2,2018,ATM Cash Withdrawal,General,10,1365
17,2,2018,Restaurant Gordon RamsayPortland Restaurant,Eating Out,32,1333
17,2,2018,ATM Cash Withdrawal,General,20,1313
18,2,2018,Dominos Pizza,Eating Out,36,1277
19,2,2018,South West Trains,Transport,37,1240
19,2,2018,The West Cornwall Pasty Company,Eating Out,8,1232
20,2,2018,VIRGIN MEDIA PYMTS,Bills,41,1191
21,2,2018,Wild Bean Cafe,Eating Out,2,1189
21,2,2018,Greggs,Eating Out,4,1185
21,2,2018,ATM Cash Withdrawal,General,20,1165
22,2,2018,Starbucks Coffee,Eating Out,1,1164
22,2,2018,Pret A Manger,Eating Out,7,1157
23,2,2018,Tescos,Groceries,42,1115
23,2,2018,Caffe Nero,Eating Out,1,1114
23,2,2018,Subway,Eating Out,5,1109
24,2,2018,O2,Bills,38,1071
24,2,2018,Heaven Club,Eating Out,15,1056
24,2,2018,Heaven Club,Eating Out,7,1049
24,2,2018,Heaven Club,Eating Out,9,1040
24,2,2018,Heaven Club,Eating Out,16,1024
24,2,2018,Heaven Club,Eating Out,6,1018
24,2,2018,Heaven Club,Eating Out,9,1009
25,2,2018,ATM Cash Withdrawal,General,10,999
26,2,2018,South West Trains,Transport,36,963
26,2,2018,McDonalds,Eating Out,5,958
27,2,2018,ATM Cash Withdrawal,General,10,948
28,2,2018,Costa Coffee,Eating Out,2,946
28,2,2018,McDonalds,Eating Out,8,938
28,2,2018,ATM Cash Withdrawal,General,10,928
1,3,2018,Rhino Sports salary,General,1700,2628
1,3,2018,Greggs,Eating Out,7,2621
1,3,2018,ATM Cash Withdrawal,General,10,2611
2,3,2018,ASDA,Groceries,69,2542
2,3,2018,Wild Bean Cafe,Eating Out,2,2540
2,3,2018,The West Cornwall Pasty Company,Eating Out,4,2536
3,3,2018,Fabric Club,Eating Out,7,2529
3,3,2018,Fabric Club,Eating Out,7,2522
3,3,2018,ATM Cash Withdrawal,General,10,2512
3,3,2018,Red Shop,,3,2509
4,3,2018,ATM Cash Withdrawal,General,10,2499
4,3,2018,Cheam Service Station,,2,2497
5,3,2018,South West Trains,Transport,32,2465
6,3,2018,Costa Coffee,Eating Out,2,2463
7,3,2018,Cubit and West rent,Rent,550,1913
7,3,2018,Costa Coffee,Eating Out,1,1912
7,3,2018,ATM Cash Withdrawal,General,10,1902
8,3,2018,Chicken Cottage,Eating Out,4,1898
9,3,2018,Tescos,Groceries,73,1825
9,3,2018,Starbucks Coffee,Eating Out,2,1823
9,3,2018,Pret A Manger,Eating Out,5,1818
9,3,2018,ATM Cash Withdrawal,General,20,1798
10,3,2018,Anglo restaurant,Eating Out,55,1743
11,3,2018,Scott's Restaurant,Eating Out,35,1708
11,3,2018,ATM Cash Withdrawal,General,20,1688
12,3,2018,South West Trains,Transport,32,1656
12,3,2018,Caffe Nero,Eating Out,2,1654
13,3,2018,Wild Bean Cafe,Eating Out,2,1652
13,3,2018,ATM Cash Withdrawal,General,10,1642
14,3,2018,Caffe Nero,Eating Out,2,1640
14,3,2018,McDonalds,Eating Out,8,1632
15,3,2018,BRGAS-Electricity,Bills,37,1595
15,3,2018,BRGAS-Gas,Bills,25,1570
15,3,2018,The West Cornwall Pasty Company,Eating Out,8,1562
16,3,2018,LBS Council Tax,Bills,50,1512
16,3,2018,ASDA,Groceries,61,1451
16,3,2018,Costa Coffee,Eating Out,1,1450
16,3,2018,Scott's Restaurant,Eating Out,30,1420
16,3,2018,ATM Cash Withdrawal,General,10,1410
16,3,2018,Red Shop,,5,1405
17,3,2018,Anglo restaurant,Eating Out,53,1352
17,3,2018,ATM Cash Withdrawal,General,10,1342
19,3,2018,South West Trains,Transport,31,1311
19,3,2018,Starbucks Coffee,Eating Out,2,1309
19,3,2018,The West Cornwall Pasty Company,Eating Out,5,1304
20,3,2018,VIRGIN MEDIA PYMTS,Bills,29,1275
20,3,2018,Costa Coffee,Eating Out,1,1274
20,3,2018,Pret A Manger,Eating Out,4,1270
21,3,2018,Wild Bean Cafe,Eating Out,1,1269
22,3,2018,Starbucks Coffee,Eating Out,1,1268
23,3,2018,Morrisons,Groceries,84,1184
23,3,2018,Caffe Nero,Eating Out,1,1183
23,3,2018,Greggs,Eating Out,7,1176
24,3,2018,O2,Bills,36,1140
24,3,2018,Restaurant Gordon RamsayPortland Restaurant,Eating Out,46,1094
24,3,2018,ATM Cash Withdrawal,General,10,1084
25,3,2018,Pizza Express,Eating Out,50,1034
25,3,2018,ATM Cash Withdrawal,General,20,1014
26,3,2018,South West Trains,Transport,28,986
26,3,2018,Wild Bean Cafe,Eating Out,2,984
26,3,2018,Subway,Eating Out,6,978
26,3,2018,Red Shop,,9,969
27,3,2018,Costa Coffee,Eating Out,1,968
27,3,2018,Subway,Eating Out,7,961
28,3,2018,Costa Coffee,Eating Out,2,959
28,3,2018,Chicken Cottage,Eating Out,7,952
28,3,2018,ATM Cash Withdrawal,General,20,932
29,3,2018,Wild Bean Cafe,Eating Out,2,930
29,3,2018,Subway,Eating Out,6,924
29,3,2018,ATM Cash Withdrawal,General,10,914
30,3,2018,Tescos,Groceries,67,847
30,3,2018,Wild Bean Cafe,Eating Out,2,845
30,3,2018,Ministry of Sound ClubXOYO Club,Eating Out,13,832
31,3,2018,Ministry of Sound ClubXOYO Club,Eating Out,10,822
31,3,2018,Ministry of Sound ClubXOYO Club,Eating Out,15,807
31,3,2018,Ministry of Sound ClubXOYO Club,Eating Out,5,802
31,3,2018,Ministry of Sound ClubXOYO Club,Eating Out,8,794
31,3,2018,Anglo restaurant,Eating Out,34,760
31,3,2018,Paying back James,,5,755
1,4,2018,Rhino Sports salary,General,1700,2455
2,4,2018,South West Trains,Transport,36,2419
2,4,2018,Starbucks Coffee,Eating Out,2,2417
3,4,2018,Starbucks Coffee,Eating Out,2,2415
3,4,2018,Subway,Eating Out,4,2411
4,4,2018,The West Cornwall Pasty Company,Eating Out,8,2403
4,4,2018,ATM Cash Withdrawal,General,10,2393
5,4,2018,Costa Coffee,Eating Out,1,2392
5,4,2018,Subway,Eating Out,8,2384
5,4,2018,ATM Cash Withdrawal,General,20,2364
6,4,2018,Tescos,Groceries,64,2300
6,4,2018,Scott's Restaurant,Eating Out,35,2265
6,4,2018,Cheam Service Station,,4,2261
7,4,2018,Cubit and West rent,Rent,550,1711
8,4,2018,Restaurant Gordon RamsayPortland Restaurant,Eating Out,38,1673
8,4,2018,Paying back James,,7,1666
9,4,2018,South West Trains,Transport,38,1628
9,4,2018,Caffe Nero,Eating Out,1,1627
9,4,2018,The West Cornwall Pasty Company,Eating Out,7,1620
10,4,2018,Wild Bean Cafe,Eating Out,2,1618
10,4,2018,The West Cornwall Pasty Company,Eating Out,6,1612
10,4,2018,ATM Cash Withdrawal,General,10,1602
10,4,2018,Paying back Julie,,8,1594
11,4,2018,Costa Coffee,Eating Out,2,1592
11,4,2018,ATM Cash Withdrawal,General,10,1582
11,4,2018,Cheam Service Station,,7,1575
12,4,2018,Starbucks Coffee,Eating Out,2,1573
12,4,2018,Chicken Cottage,Eating Out,4,1569
12,4,2018,Tool Tec,,3,1566
13,4,2018,Waitrose,Groceries,69,1497
13,4,2018,Starbucks Coffee,Eating Out,1,1496
13,4,2018,Greggs,Eating Out,7,1489
15,4,2018,BRGAS-Electricity,Bills,42,1447
15,4,2018,BRGAS-Gas,Bills,22,1425
16,4,2018,LBS Council Tax,Bills,50,1375
16,4,2018,South West Trains,Transport,25,1350
16,4,2018,Caffe Nero,Eating Out,1,1349
16,4,2018,The West Cornwall Pasty Company,Eating Out,5,1344
16,4,2018,Tool Tec,,6,1338
17,4,2018,Starbucks Coffee,Eating Out,2,1336
17,4,2018,Chicken Cottage,Eating Out,8,1328
17,4,2018,Paying back Julie,,1,1327
18,4,2018,Caffe Nero,Eating Out,1,1326
18,4,2018,Chicken Cottage,Eating Out,6,1320
18,4,2018,ATM Cash Withdrawal,General,20,1300
19,4,2018,Costa Coffee,Eating Out,2,1298
19,4,2018,Greggs,Eating Out,5,1293
19,4,2018,Paying back James,,8,1285
20,4,2018,VIRGIN MEDIA PYMTS,Bills,34,1251
20,4,2018,Tescos,Groceries,62,1189
20,4,2018,Subway,Eating Out,7,1182
21,4,2018,ATM Cash Withdrawal,General,20,1162
