Day,Month,Year,Description,Category,Value,Balance
1,1,2010,Rhino Sports salary,General,1700,1700
1,1,2010,Waitrose,Groceries,68,1632
1,1,2010,Wild Bean Cafe,Eating Out,2,1630
1,1,2010,Subway,Eating Out,7,1623
1,1,2010,Pizza Express,Eating Out,55,1568
4,1,2010,South West Trains,Transport,35,1533
6,1,2010,Costa Coffee,Eating Out,1,1532
6,1,2010,Pret A Manger,Eating Out,8,1524
6,1,2010,Tool Shop,,2,1522
7,1,2010,Cubit and West rent,Rent,550,972
7,1,2010,Wild Bean Cafe,Eating Out,2,970
7,1,2010,Greggs,Eating Out,4,966
8,1,2010,Morrisons,Groceries,45,921
8,1,2010,Greggs,Eating Out,8,913
8,1,2010,Restaurant Gordon RamsayPortland Restaurant,Eating Out,34,879
11,1,2010,South West Trains,Transport,37,842
11,1,2010,Wild Bean Cafe,Eating Out,1,841
11,1,2010,McDonalds,Eating Out,5,836
11,1,2010,Paying back Julie,,5,831
12,1,2010,ATM Cash Withdrawal,General,20,811
13,1,2010,Wild Bean Cafe,Eating Out,1,810
14,1,2010,Costa Coffee,Eating Out,2,808
14,1,2010,The West Cornwall Pasty Company,Eating Out,7,801
14,1,2010,ATM Cash Withdrawal,General,20,781
14,1,2010,Tool Shop,,7,774
15,1,2010,BRGAS-Electricity,Bills,26,748
15,1,2010,BRGAS-Gas,Bills,35,713
15,1,2010,Sainsburys,Groceries,49,664
15,1,2010,Wild Bean Cafe,Eating Out,1,663
15,1,2010,The West Cornwall Pasty Company,Eating Out,8,655
15,1,2010,Tool Shop,,9,646
16,1,2010,LBS Council Tax,Bills,50,596
16,1,2010,Dominos Pizza,Eating Out,28,568
16,1,2010,Tool Tec,,9,559
17,1,2010,Restaurant Gordon RamsayPortland Restaurant,Eating Out,39,520
17,1,2010,ATM Cash Withdrawal,General,10,510
18,1,2010,South West Trains,Transport,32,478
18,1,2010,Costa Coffee,Eating Out,1,477
18,1,2010,Greggs,Eating Out,8,469
18,1,2010,ATM Cash Withdrawal,General,20,449
19,1,2010,Caffe Nero,Eating Out,1,448
19,1,2010,McDonalds,Eating Out,8,440
20,1,2010,VIRGIN MEDIA PYMTS,Bills,54,386
20,1,2010,Starbucks Coffee,Eating Out,2,384
20,1,2010,The West Cornwall Pasty Company,Eating Out,7,377
20,1,2010,Red Shop,,9,368
21,1,2010,Costa Coffee,Eating Out,1,367
21,1,2010,The West Cornwall Pasty Company,Eating Out,6,361
21,1,2010,ATM Cash Withdrawal,General,20,341
22,1,2010,ASDA,Groceries,64,277
22,1,2010,Costa Coffee,Eating Out,1,276
22,1,2010,The West Cornwall Pasty Company,Eating Out,7,269
22,1,2010,Scott's Restaurant,Eating Out,38,231
23,1,2010,Ministry of Sound ClubXOYO Club,Eating Out,9,222
23,1,2010,Ministry of Sound ClubXOYO Club,Eating Out,15,207
23,1,2010,Ministry of Sound ClubXOYO Club,Eating Out,9,198
23,1,2010,Ministry of Sound ClubXOYO Club,Eating Out,16,182
23,1,2010,Ministry of Sound ClubXOYO Club,Eating Out,14,168
23,1,2010,Anglo restaurant,Eating Out,56,112
23,1,2010,ATM Cash Withdrawal,General,10,102
24,1,2010,O2,Bills,37,65
25,1,2010,South West Trains,Transport,29,36
25,1,2010,Wild Bean Cafe,Eating Out,2,34
25,1,2010,The West Cornwall Pasty Company,Eating Out,5,29
26,1,2010,Caffe Nero,Eating Out,1,28
26,1,2010,McDonalds,Eating Out,6,22
27,1,2010,Starbucks Coffee,Eating Out,1,21
27,1,2010,Chicken Cottage,Eating Out,8,13
27,1,2010,ATM Cash Withdrawal,General,20,-7
28,1,2010,Subway,Eating Out,4,-11
29,1,2010,ASDA,Groceries,74,-85
29,1,2010,Costa Coffee,Eating Out,1,-86
29,1,2010,Subway,Eating Out,6,-92
29,1,2010,Pizza Express,Eating Out,58,-150
29,1,2010,ATM Cash Withdrawal,General,20,-170
31,1,2010,Scott's Restaurant,Eating Out,44,-214
1,2,2010,Rhino Sports salary,General,1700,1486
1,2,2010,South West Trains,Transport,36,1450
1,2,2010,Starbucks Coffee,Eating Out,1,1449
1,2,2010,The West Cornwall Pasty Company,Eating Out,7,1442
2,2,2010,Starbucks Coffee,Eating Out,1,1441
3,2,2010,Starbucks Coffee,Eating Out,2,1439
3,2,2010,Greggs,Eating Out,6,1433
4,2,2010,Caffe Nero,Eating Out,1,1432
4,2,2010,Subway,Eating Out,7,1425
5,2,2010,Sainsburys,Groceries,62,1363
5,2,2010,Costa Coffee,Eating Out,2,1361
5,2,2010,Subway,Eating Out,6,1355
5,2,2010,Dominos Pizza,Eating Out,40,1315
5,2,2010,ATM Cash Withdrawal,General,20,1295
7,2,2010,Cubit and West rent,Rent,550,745
7,2,2010,ATM Cash Withdrawal,General,20,725
8,2,2010,South West Trains,Transport,34,691
8,2,2010,Caffe Nero,Eating Out,2,689
8,2,2010,The West Cornwall Pasty Company,Eating Out,8,681
9,2,2010,Costa Coffee,Eating Out,2,679
9,2,2010,Pret A Manger,Eating Out,7,672
10,2,2010,Starbucks Coffee,Eating Out,1,671
10,2,2010,McDonalds,Eating Out,5,666
11,2,2010,Wild Bean Cafe,Eating Out,1,665
12,2,2010,ASDA,Groceries,71,594
12,2,2010,Wild Bean Cafe,Eating Out,2,592
15,2,2010,BRGAS-Electricity,Bills,32,560
15,2,2010,BRGAS-Gas,Bills,25,535
15,2,2010,South West Trains,Transport,38,497
15,2,2010,Caffe Nero,Eating Out,2,495
16,2,2010,LBS Council Tax,Bills,50,445
17,2,2010,Starbucks Coffee,Eating Out,1,444
18,2,2010,Starbucks Coffee,Eating Out,2,442
18,2,2010,Chicken Cottage,Eating Out,7,435
19,2,2010,Tescos,Groceries,49,386
19,2,2010,Caffe Nero,Eating Out,1,385
19,2,2010,Subway,Eating Out,8,377
19,2,2010,Pizza Express,Eating Out,25,352
20,2,2010,VIRGIN MEDIA PYMTS,Bills,32,320
20,2,2010,Scott's Restaurant,Eating Out,28,292
22,2,2010,South West Trains,Transport,35,257
22,2,2010,Caffe Nero,Eating Out,2,255
23,2,2010,Caffe Nero,Eating Out,2,253
23,2,2010,The West Cornwall Pasty Company,Eating Out,7,246
24,2,2010,O2,Bills,36,210
24,2,2010,Paying back James,,2,208
25,2,2010,Starbucks Coffee,Eating Out,1,207
25,2,2010,McDonalds,Eating Out,8,199
26,2,2010,Waitrose,Groceries,65,134
26,2,2010,Chicken Cottage,Eating Out,8,126
26,2,2010,Scott's Restaurant,Eating Out,54,72
27,2,2010,Heaven Club,Eating Out,11,61
27,2,2010,Heaven Club,Eating Out,7,54
27,2,2010,Heaven Club,Eating Out,16,38
27,2,2010,Heaven Club,Eating Out,5,33
27,2,2010,Heaven Club,Eating Out,12,21
27,2,2010,Heaven Club,Eating Out,12,9
27,2,2010,Dominos Pizza,Eating Out,38,-29
28,2,2010,ATM Cash Withdrawal,General,20,-49
1,3,2010,Rhino Sports salary,General,1700,1651
1,3,2010,South West Trains,Transport,35,1616
1,3,2010,Wild Bean Cafe,Eating Out,1,1615
2,3,2010,Costa Coffee,Eating Out,2,1613
3,3,2010,Costa Coffee,Eating Out,2,1611
3,3,2010,Chicken Cottage,Eating Out,7,1604
4,3,2010,McDonalds,Eating Out,8,1596
5,3,2010,ASDA,Groceries,76,1520
5,3,2010,Costa Coffee,Eating Out,1,1519
5,3,2010,Greggs,Eating Out,7,1512
5,3,2010,Dominos Pizza,Eating Out,52,1460
6,3,2010,Paying back James,,4,1456
7,3,2010,Cubit and West rent,Rent,550,906
7,3,2010,Anglo restaurant,Eating Out,25,881
7,3,2010,ATM Cash Withdrawal,General,20,861
8,3,2010,South West Trains,Transport,35,826
8,3,2010,Wild Bean Cafe,Eating Out,2,824
8,3,2010,Subway,Eating Out,6,818
8,3,2010,ATM Cash Withdrawal,General,20,798
9,3,2010,Costa Coffee,Eating Out,2,796
9,3,2010,Subway,Eating Out,7,789
9,3,2010,ATM Cash Withdrawal,General,10,779
9,3,2010,Tool Tec,,2,777
10,3,2010,Wild Bean Cafe,Eating Out,2,775
11,3,2010,Costa Coffee,Eating Out,2,773
11,3,2010,The West Cornwall Pasty Company,Eating Out,7,766
12,3,2010,Sainsburys,Groceries,78,688
12,3,2010,Costa Coffee,Eating Out,1,687
12,3,2010,Subway,Eating Out,7,680
12,3,2010,Civic Shop,,3,677
13,3,2010,Pizza Express,Eating Out,46,631
15,3,2010,BRGAS-Electricity,Bills,26,605
15,3,2010,BRGAS-Gas,Bills,44,561
15,3,2010,South West Trains,Transport,35,526
15,3,2010,Wild Bean Cafe,Eating Out,2,524
15,3,2010,Pret A Manger,Eating Out,7,517
16,3,2010,LBS Council Tax,Bills,50,467
16,3,2010,Wild Bean Cafe,Eating Out,2,465
16,3,2010,Pret A Manger,Eating Out,4,461
16,3,2010,Cheam Service Station,,5,456
17,3,2010,Starbucks Coffee,Eating Out,2,454
17,3,2010,Subway,Eating Out,6,448
18,3,2010,Costa Coffee,Eating Out,2,446
18,3,2010,Pret A Manger,Eating Out,4,442
19,3,2010,Sainsburys,Groceries,42,400
19,3,2010,Costa Coffee,Eating Out,2,398
19,3,2010,Chicken Cottage,Eating Out,4,394
19,3,2010,Scott's Restaurant,Eating Out,26,368
19,3,2010,Tool Shop,,8,360
20,3,2010,VIRGIN MEDIA PYMTS,Bills,44,316
20,3,2010,ATM Cash Withdrawal,General,20,296
20,3,2010,Paying back James,,2,294
22,3,2010,South West Trains,Transport,24,270
22,3,2010,Wild Bean Cafe,Eating Out,2,268
22,3,2010,The West Cornwall Pasty Company,Eating Out,7,261
23,3,2010,Starbucks Coffee,Eating Out,2,259
23,3,2010,McDonalds,Eating Out,4,255
24,3,2010,O2,Bills,35,220
24,3,2010,Greggs,Eating Out,8,212
25,3,2010,Costa Coffee,Eating Out,2,210
26,3,2010,Waitrose,Groceries,45,165
26,3,2010,Caffe Nero,Eating Out,2,163
27,3,2010,Dominos Pizza,Eating Out,44,119
27,3,2010,ATM Cash Withdrawal,General,10,109
29,3,2010,South West Trains,Transport,34,75
29,3,2010,Chicken Cottage,Eating Out,8,67
31,3,2010,Wild Bean Cafe,Eating Out,2,65
31,3,2010,The West Cornwall Pasty Company,Eating Out,8,57
1,4,2010,Rhino Sports salary,General,1700,1757
1,4,2010,Starbucks Coffee,Eating Out,2,1755
2,4,2010,Morrisons,Groceries,71,1684
2,4,2010,Wild Bean Cafe,Eating Out,1,1683
2,4,2010,Restaurant Gordon RamsayPortland Restaurant,Eating Out,28,1655
3,4,2010,ATM Cash Withdrawal,General,20,1635
4,4,2010,Scott's Restaurant,Eating Out,27,1608
4,4,2010,ATM Cash Withdrawal,General,20,1588
5,4,2010,South West Trains,Transport,29,1559
5,4,2010,McDonalds,Eating Out,8,1551
6,4,2010,Starbucks Coffee,Eating Out,2,1549
6,4,2010,Chicken Cottage,Eating Out,7,1542
6,4,2010,Paying back Julie,,6,1536
7,4,2010,Cubit and West rent,Rent,550,986
7,4,2010,Starbucks Coffee,Eating Out,2,984
7,4,2010,Pret A Manger,Eating Out,6,978
7,4,2010,ATM Cash Withdrawal,General,10,968
8,4,2010,Subway,Eating Out,8,960
9,4,2010,Morrisons,Groceries,42,918
9,4,2010,Costa Coffee,Eating Out,2,916
9,4,2010,The West Cornwall Pasty Company,Eating Out,5,911
9,4,2010,Restaurant Gordon RamsayPortland Restaurant,Eating Out,26,885
10,4,2010,Red Shop,,3,882
11,4,2010,Scott's Restaurant,Eating Out,40,842
12,4,2010,South West Trains,Transport,30,812
12,4,2010,Costa Coffee,Eating Out,2,810
12,4,2010,The West Cornwall Pasty Company,Eating Out,5,805
13,4,2010,Caffe Nero,Eating Out,1,804
13,4,2010,McDonalds,Eating Out,8,796
14,4,2010,Wild Bean Cafe,Eating Out,2,794
14,4,2010,Subway,Eating Out,7,787
15,4,2010,BRGAS-Electricity,Bills,35,752
15,4,2010,BRGAS-Gas,Bills,40,712
15,4,2010,Chicken Cottage,Eating Out,4,708
16,4,2010,LBS Council Tax,Bills,50,658
16,4,2010,ASDA,Groceries,87,571
16,4,2010,Starbucks Coffee,Eating Out,1,570
16,4,2010,Dominos Pizza,Eating Out,42,528
16,4,2010,ATM Cash Withdrawal,General,20,508
18,4,2010,Anglo restaurant,Eating Out,53,455
18,4,2010,ATM Cash Withdrawal,General,20,435
19,4,2010,South West Trains,Transport,25,410
19,4,2010,Wild Bean Cafe,Eating Out,2,408
19,4,2010,Greggs,Eating Out,5,403
19,4,2010,ATM Cash Withdrawal,General,20,383
20,4,2010,VIRGIN MEDIA PYMTS,Bills,34,349
20,4,2010,Starbucks Coffee,Eating Out,2,347
20,4,2010,ATM Cash Withdrawal,General,10,337
21,4,2010,Starbucks Coffee,Eating Out,2,335
21,4,2010,Chicken Cottage,Eating Out,7,328
22,4,2010,Chicken Cottage,Eating Out,6,322
22,4,2010,Red Shop,,4,318
23,4,2010,Waitrose,Groceries,78,240
23,4,2010,Wild Bean Cafe,Eating Out,2,238
23,4,2010,Greggs,Eating Out,5,233
23,4,2010,Dominos Pizza,Eating Out,46,187
24,4,2010,O2,Bills,38,149
24,4,2010,Dominos Pizza,Eating Out,33,116
24,4,2010,Tool Tec,,1,115
26,4,2010,South West Trains,Transport,27,88
26,4,2010,Costa Coffee,Eating Out,2,86
26,4,2010,Pret A Manger,Eating Out,7,79
26,4,2010,ATM Cash Withdrawal,General,20,59
27,4,2010,Costa Coffee,Eating Out,2,57
27,4,2010,Subway,Eating Out,7,50
28,4,2010,Costa Coffee,Eating Out,1,49
28,4,2010,McDonalds,Eating Out,6,43
29,4,2010,Pret A Manger,Eating Out,5,38
29,4,2010,ATM Cash Withdrawal,General,10,28
30,4,2010,Sainsburys,Groceries,44,-16
30,4,2010,Starbucks Coffee,Eating Out,2,-18
30,4,2010,ATM Cash Withdrawal,General,20,-38
1,5,2010,Rhino Sports salary,General,1700,1662
1,5,2010,ATM Cash Withdrawal,General,10,1652
1,5,2010,Civic Shop,,8,1644
2,5,2010,Restaurant Gordon RamsayPortland Restaurant,Eating Out,35,1609
2,5,2010,ATM Cash Withdrawal,General,10,1599
3,5,2010,South West Trains,Transport,35,1564
3,5,2010,Costa Coffee,Eating Out,1,1563
3,5,2010,Chicken Cottage,Eating Out,5,1558
4,5,2010,Costa Coffee,Eating Out,2,1556
4,5,2010,Greggs,Eating Out,6,1550
4,5,2010,ATM Cash Withdrawal,General,20,1530
5,5,2010,McDonalds,Eating Out,5,1525
6,5,2010,Starbucks Coffee,Eating Out,1,1524
7,5,2010,Cubit and West rent,Rent,550,974
7,5,2010,Sainsburys,Groceries,52,922
7,5,2010,Caffe Nero,Eating Out,2,920
7,5,2010,The West Cornwall Pasty Company,Eating Out,5,915
9,5,2010,Scott's Restaurant,Eating Out,31,884
10,5,2010,South West Trains,Transport,37,847
10,5,2010,Costa Coffee,Eating Out,2,845
11,5,2010,Wild Bean Cafe,Eating Out,2,843
12,5,2010,Wild Bean Cafe,Eating Out,1,842
12,5,2010,The West Cornwall Pasty Company,Eating Out,5,837
13,5,2010,Caffe Nero,Eating Out,2,835
13,5,2010,ATM Cash Withdrawal,General,10,825
14,5,2010,Sainsburys,Groceries,87,738
14,5,2010,Costa Coffee,Eating Out,1,737
14,5,2010,The West Cornwall Pasty Company,Eating Out,7,730
14,5,2010,The Grand Pub,Eating Out,5,725
14,5,2010,The Grand Pub,Eating Out,6,719
14,5,2010,The Grand Pub,Eating Out,7,712
14,5,2010,The Grand Pub,Eating Out,7,705
14,5,2010,The Grand Pub,Eating Out,16,689
14,5,2010,Restaurant Gordon RamsayPortland Restaurant,Eating Out,59,630
15,5,2010,BRGAS-Electricity,Bills,35,595
15,5,2010,BRGAS-Gas,Bills,35,560
16,5,2010,LBS Council Tax,Bills,50,510
16,5,2010,Pizza Express,Eating Out,34,476
17,5,2010,South West Trains,Transport,37,439
17,5,2010,Chicken Cottage,Eating Out,8,431
17,5,2010,Paying back Julie,,5,426
18,5,2010,Starbucks Coffee,Eating Out,2,424
18,5,2010,The West Cornwall Pasty Company,Eating Out,8,416
19,5,2010,Caffe Nero,Eating Out,1,415
19,5,2010,Greggs,Eating Out,4,411
19,5,2010,ATM Cash Withdrawal,General,10,401
20,5,2010,VIRGIN MEDIA PYMTS,Bills,51,350
20,5,2010,Costa Coffee,Eating Out,1,349
20,5,2010,Subway,Eating Out,7,342
21,5,2010,Morrisons,Groceries,60,282
21,5,2010,Costa Coffee,Eating Out,2,280
21,5,2010,ATM Cash Withdrawal,General,10,270
22,5,2010,ATM Cash Withdrawal,General,20,250
22,5,2010,Paying back James,,8,242
23,5,2010,ATM Cash Withdrawal,General,20,222
23,5,2010,Civic Shop,,6,216
24,5,2010,O2,Bills,30,186
24,5,2010,South West Trains,Transport,31,155
24,5,2010,McDonalds,Eating Out,8,147
25,5,2010,Costa Coffee,Eating Out,1,146
25,5,2010,The West Cornwall Pasty Company,Eating Out,4,142
26,5,2010,Starbucks Coffee,Eating Out,2,140
26,5,2010,Tool Shop,,7,133
27,5,2010,Wild Bean Cafe,Eating Out,1,132
28,5,2010,Sainsburys,Groceries,65,67
28,5,2010,Starbucks Coffee,Eating Out,2,65
28,5,2010,The West Cornwall Pasty Company,Eating Out,5,60
28,5,2010,Pizza Express,Eating Out,27,33
28,5,2010,ATM Cash Withdrawal,General,20,13
29,5,2010,Scott's Restaurant,Eating Out,56,-43
31,5,2010,South West Trains,Transport,24,-67
31,5,2010,Wild Bean Cafe,Eating Out,1,-68
31,5,2010,Pret A Manger,Eating Out,8,-76
1,6,2010,Rhino Sports salary,General,1700,1624
1,6,2010,Caffe Nero,Eating Out,2,1622
1,6,2010,Paying back James,,3,1619
2,6,2010,Starbucks Coffee,Eating Out,1,1618
2,6,2010,McDonalds,Eating Out,5,1613
3,6,2010,Caffe Nero,Eating Out,1,1612
3,6,2010,Chicken Cottage,Eating Out,4,1608
4,6,2010,Waitrose,Groceries,72,1536
4,6,2010,Starbucks Coffee,Eating Out,2,1534
4,6,2010,Subway,Eating Out,6,1528
4,6,2010,ATM Cash Withdrawal,General,20,1508
4,6,2010,Tool Tec,,5,1503
7,6,2010,Cubit and West rent,Rent,550,953
7,6,2010,South West Trains,Transport,37,916
7,6,2010,Wild Bean Cafe,Eating Out,1,915
7,6,2010,ATM Cash Withdrawal,General,10,905
8,6,2010,Starbucks Coffee,Eating Out,2,903
9,6,2010,Wild Bean Cafe,Eating Out,2,901
9,6,2010,McDonalds,Eating Out,7,894
9,6,2010,Tool Shop,,7,887
10,6,2010,Starbucks Coffee,Eating Out,2,885
10,6,2010,Pret A Manger,Eating Out,4,881
11,6,2010,Morrisons,Groceries,44,837
11,6,2010,Wild Bean Cafe,Eating Out,1,836
11,6,2010,Subway,Eating Out,6,830
12,6,2010,Anglo restaurant,Eating Out,41,789
12,6,2010,Red Shop,,6,783
13,6,2010,Dominos Pizza,Eating Out,26,757
14,6,2010,South West Trains,Transport,24,733
14,6,2010,Wild Bean Cafe,Eating Out,2,731
14,6,2010,Subway,Eating Out,7,724
15,6,2010,BRGAS-Electricity,Bills,32,692
15,6,2010,BRGAS-Gas,Bills,36,656
16,6,2010,LBS Council Tax,Bills,50,606
16,6,2010,Wild Bean Cafe,Eating Out,2,604
16,6,2010,The West Cornwall Pasty Company,Eating Out,6,598
16,6,2010,Tool Tec,,1,597
17,6,2010,Chicken Cottage,Eating Out,7,590
17,6,2010,ATM Cash Withdrawal,General,10,580
17,6,2010,Paying back James,,7,573
18,6,2010,Sainsburys,Groceries,57,516
18,6,2010,Chicken Cottage,Eating Out,5,511
18,6,2010,Heaven Club,Eating Out,6,505
18,6,2010,Heaven Club,Eating Out,13,492
19,6,2010,ATM Cash Withdrawal,General,10,482
20,6,2010,VIRGIN MEDIA PYMTS,Bills,36,446
20,6,2010,Restaurant Gordon RamsayPortland Restaurant,Eating Out,32,414
20,6,2010,ATM Cash Withdrawal,General,10,404
21,6,2010,South West Trains,Transport,32,372
21,6,2010,Pret A Manger,Eating Out,4,368
22,6,2010,Greggs,Eating Out,5,363
23,6,2010,Costa Coffee,Eating Out,1,362
24,6,2010,O2,Bills,32,330
24,6,2010,Wild Bean Cafe,Eating Out,1,329
24,6,2010,The West Cornwall Pasty Company,Eating Out,8,321
25,6,2010,Tescos,Groceries,44,277
25,6,2010,The West Cornwall Pasty Company,Eating Out,8,269
25,6,2010,Pizza Express,Eating Out,40,229
25,6,2010,ATM Cash Withdrawal,General,10,219
26,6,2010,Restaurant Gordon RamsayPortland Restaurant,Eating Out,52,167
28,6,2010,South West Trains,Transport,27,140
28,6,2010,Wild Bean Cafe,Eating Out,2,138
29,6,2010,Costa Coffee,Eating Out,2,136
29,6,2010,McDonalds,Eating Out,8,128
30,6,2010,Wild Bean Cafe,Eating Out,1,127
30,6,2010,Pret A Manger,Eating Out,7,120
30,6,2010,ATM Cash Withdrawal,General,20,100
1,7,2010,Rhino Sports salary,General,1700,1800
1,7,2010,Caffe Nero,Eating Out,1,1799
1,7,2010,Chicken Cottage,Eating Out,4,1795
2,7,2010,Tescos,Groceries,44,1751
2,7,2010,Costa Coffee,Eating Out,1,1750
2,7,2010,Scott's Restaurant,Eating Out,30,1720
3,7,2010,ATM Cash Withdrawal,General,10,1710
3,7,2010,British Airways,General,139,1571
3,7,2010,Cheam Service Station,,8,1563
4,7,2010,ATM Cash Withdrawal,General,20,1543
5,7,2010,South West Trains,Transport,27,1516
5,7,2010,Costa Coffee,Eating Out,2,1514
6,7,2010,Costa Coffee,Eating Out,1,1513
6,7,2010,Subway,Eating Out,5,1508
6,7,2010,Tool Tec,,4,1504
7,7,2010,Cubit and West rent,Rent,550,954
7,7,2010,Wild Bean Cafe,Eating Out,2,952
7,7,2010,The West Cornwall Pasty Company,Eating Out,7,945
8,7,2010,Wild Bean Cafe,Eating Out,1,944
8,7,2010,ATM Cash Withdrawal,General,10,934
9,7,2010,Tescos,Groceries,62,872
9,7,2010,Wild Bean Cafe,Eating Out,1,871
9,7,2010,Chicken Cottage,Eating Out,8,863
9,7,2010,Anglo restaurant,Eating Out,39,824
9,7,2010,ATM Cash Withdrawal,General,10,814
10,7,2010,Ministry of Sound ClubXOYO Club,Eating Out,9,805
10,7,2010,Anglo restaurant,Eating Out,56,749
10,7,2010,ATM Cash Withdrawal,General,10,739
11,7,2010,Pizza Express,Eating Out,38,701
12,7,2010,South West Trains,Transport,36,665
12,7,2010,Wild Bean Cafe,Eating Out,1,664
13,7,2010,Starbucks Coffee,Eating Out,2,662
13,7,2010,Chicken Cottage,Eating Out,4,658
14,7,2010,Costa Coffee,Eating Out,2,656
14,7,2010,Greggs,Eating Out,6,650
15,7,2010,BRGAS-Electricity,Bills,30,620
15,7,2010,BRGAS-Gas,Bills,26,594
16,7,2010,LBS Council Tax,Bills,50,544
16,7,2010,ASDA,Groceries,47,497
16,7,2010,Pizza Express,Eating Out,34,463
18,7,2010,Restaurant Gordon RamsayPortland Restaurant,Eating Out,38,425
19,7,2010,South West Trains,Transport,27,398
20,7,2010,VIRGIN MEDIA PYMTS,Bills,32,366
20,7,2010,Wild Bean Cafe,Eating Out,1,365
20,7,2010,Greggs,Eating Out,6,359
21,7,2010,Starbucks Coffee,Eating Out,1,358
21,7,2010,Subway,Eating Out,6,352
21,7,2010,ATM Cash Withdrawal,General,10,342
22,7,2010,Wild Bean Cafe,Eating Out,2,340
22,7,2010,Pret A Manger,Eating Out,4,336
23,7,2010,ASDA,Groceries,49,287
23,7,2010,McDonalds,Eating Out,6,281
23,7,2010,Scott's Restaurant,Eating Out,46,235
23,7,2010,ATM Cash Withdrawal,General,10,225
24,7,2010,O2,Bills,30,195
24,7,2010,Restaurant Gordon RamsayPortland Restaurant,Eating Out,41,154
26,7,2010,South West Trains,Transport,33,121
26,7,2010,Wild Bean Cafe,Eating Out,2,119
27,7,2010,Wild Bean Cafe,Eating Out,2,117
28,7,2010,Costa Coffee,Eating Out,1,116
28,7,2010,The West Cornwall Pasty Company,Eating Out,5,111
28,7,2010,Red Shop,,6,105
29,7,2010,Wild Bean Cafe,Eating Out,1,104
29,7,2010,Subway,Eating Out,8,96
30,7,2010,Waitrose,Groceries,58,38
30,7,2010,Greggs,Eating Out,6,32
30,7,2010,Scott's Restaurant,Eating Out,32,0
31,7,2010,Pizza Express,Eating Out,31,-31
1,8,2010,Rhino Sports salary,General,1700,1669
2,8,2010,South West Trains,Transport,26,1643
2,8,2010,Costa Coffee,Eating Out,2,1641
2,8,2010,McDonalds,Eating Out,7,1634
2,8,2010,ATM Cash Withdrawal,General,20,1614
4,8,2010,Starbucks Coffee,Eating Out,1,1613
4,8,2010,The West Cornwall Pasty Company,Eating Out,8,1605
4,8,2010,ATM Cash Withdrawal,General,10,1595
5,8,2010,Starbucks Coffee,Eating Out,1,1594
5,8,2010,Greggs,Eating Out,4,1590
5,8,2010,ATM Cash Withdrawal,General,10,1580
5,8,2010,Paying back James,,6,1574
6,8,2010,Tescos,Groceries,59,1515
6,8,2010,ATM Cash Withdrawal,General,20,1495
6,8,2010,Civic Shop,,6,1489
7,8,2010,Cubit and West rent,Rent,550,939
7,8,2010,Paying back Julie,,9,930
8,8,2010,Tool Tec,,1,929
9,8,2010,South West Trains,Transport,35,894
9,8,2010,Costa Coffee,Eating Out,1,893
9,8,2010,McDonalds,Eating Out,4,889
10,8,2010,Starbucks Coffee,Eating Out,2,887
11,8,2010,McDonalds,Eating Out,6,881
12,8,2010,The West Cornwall Pasty Company,Eating Out,4,877
13,8,2010,ASDA,Groceries,66,811
13,8,2010,Caffe Nero,Eating Out,1,810
13,8,2010,Pizza Express,Eating Out,31,779
13,8,2010,ATM Cash Withdrawal,General,10,769
14,8,2010,Heaven Club,Eating Out,5,764
14,8,2010,Heaven Club,Eating Out,8,756
14,8,2010,Tool Tec,,7,749
15,8,2010,BRGAS-Electricity,Bills,28,721
15,8,2010,BRGAS-Gas,Bills,42,679
15,8,2010,ATM Cash Withdrawal,General,20,659
16,8,2010,LBS Council Tax,Bills,50,609
16,8,2010,South West Trains,Transport,32,577
16,8,2010,Costa Coffee,Eating Out,2,575
16,8,2010,Chicken Cottage,Eating Out,6,569
17,8,2010,Costa Coffee,Eating Out,1,568
17,8,2010,Paying back Julie,,3,565
18,8,2010,Costa Coffee,Eating Out,2,563
19,8,2010,Starbucks Coffee,Eating Out,1,562
19,8,2010,Greggs,Eating Out,7,555
19,8,2010,Tool Tec,,1,554
20,8,2010,VIRGIN MEDIA PYMTS,Bills,30,524
20,8,2010,Tescos,Groceries,80,444
20,8,2010,Wild Bean Cafe,Eating Out,1,443
20,8,2010,Anglo restaurant,Eating Out,56,387
22,8,2010,Anglo restaurant,Eating Out,45,342
22,8,2010,Cheam Service Station,,5,337
23,8,2010,South West Trains,Transport,32,305
23,8,2010,Wild Bean Cafe,Eating Out,2,303
23,8,2010,The West Cornwall Pasty Company,Eating Out,5,298
24,8,2010,O2,Bills,30,268
24,8,2010,Costa Coffee,Eating Out,2,266
24,8,2010,The West Cornwall Pasty Company,Eating Out,6,260
25,8,2010,Caffe Nero,Eating Out,2,258
25,8,2010,ATM Cash Withdrawal,General,20,238
26,8,2010,Caffe Nero,Eating Out,2,236
26,8,2010,Greggs,Eating Out,5,231
26,8,2010,Cheam Service Station,,1,230
27,8,2010,Morrisons,Groceries,49,181
27,8,2010,McDonalds,Eating Out,8,173
27,8,2010,Ministry of Sound ClubXOYO Club,Eating Out,16,157
27,8,2010,Ministry of Sound ClubXOYO Club,Eating Out,15,142
28,8,2010,ATM Cash Withdrawal,General,20,122
30,8,2010,South West Trains,Transport,37,85
30,8,2010,Tool Tec,,7,78
31,8,2010,Wild Bean Cafe,Eating Out,1,77
31,8,2010,Subway,Eating Out,6,71
1,9,2010,Rhino Sports salary,General,1700,1771
1,9,2010,Caffe Nero,Eating Out,1,1770
1,9,2010,Subway,Eating Out,5,1765
2,9,2010,Starbucks Coffee,Eating Out,2,1763
2,9,2010,Subway,Eating Out,7,1756
3,9,2010,Morrisons,Groceries,81,1675
3,9,2010,Starbucks Coffee,Eating Out,2,1673
4,9,2010,Restaurant Gordon RamsayPortland Restaurant,Eating Out,29,1644
5,9,2010,Scott's Restaurant,Eating Out,48,1596
5,9,2010,ATM Cash Withdrawal,General,10,1586
5,9,2010,Civic Shop,,3,1583
6,9,2010,South West Trains,Transport,36,1547
6,9,2010,McDonalds,Eating Out,8,1539
7,9,2010,Cubit and West rent,Rent,550,989
7,9,2010,Costa Coffee,Eating Out,2,987
7,9,2010,Pret A Manger,Eating Out,8,979
8,9,2010,Costa Coffee,Eating Out,1,978
9,9,2010,Caffe Nero,Eating Out,2,976
9,9,2010,McDonalds,Eating Out,6,970
10,9,2010,Sainsburys,Groceries,57,913
10,9,2010,Starbucks Coffee,Eating Out,2,911
10,9,2010,Greggs,Eating Out,6,905
11,9,2010,ATM Cash Withdrawal,General,10,895
13,9,2010,South West Trains,Transport,25,870
13,9,2010,Costa Coffee,Eating Out,2,868
14,9,2010,Caffe Nero,Eating Out,2,866
14,9,2010,Tool Tec,,9,857
15,9,2010,BRGAS-Electricity,Bills,41,816
15,9,2010,BRGAS-Gas,Bills,41,775
15,9,2010,Starbucks Coffee,Eating Out,2,773
15,9,2010,Greggs,Eating Out,7,766
15,9,2010,ATM Cash Withdrawal,General,10,756
16,9,2010,LBS Council Tax,Bills,50,706
16,9,2010,Wild Bean Cafe,Eating Out,2,704
16,9,2010,Chicken Cottage,Eating Out,7,697
17,9,2010,Tescos,Groceries,76,621
17,9,2010,Costa Coffee,Eating Out,1,620
18,9,2010,Dominos Pizza,Eating Out,27,593
20,9,2010,VIRGIN MEDIA PYMTS,Bills,48,545
20,9,2010,South West Trains,Transport,24,521
20,9,2010,Costa Coffee,Eating Out,2,519
20,9,2010,Subway,Eating Out,6,513
21,9,2010,Starbucks Coffee,Eating Out,1,512
22,9,2010,Costa Coffee,Eating Out,2,510
22,9,2010,ATM Cash Withdrawal,General,10,500
22,9,2010,Cheam Service Station,,1,499
23,9,2010,Wild Bean Cafe,Eating Out,2,497
24,9,2010,O2,Bills,33,464
24,9,2010,Tescos,Groceries,45,419
24,9,2010,Caffe Nero,Eating Out,1,418
24,9,2010,Chicken Cottage,Eating Out,7,411
25,9,2010,Heaven Club,Eating Out,10,401
25,9,2010,Heaven Club,Eating Out,15,386
25,9,2010,Heaven Club,Eating Out,15,371
25,9,2010,Pizza Express,Eating Out,44,327
25,9,2010,ATM Cash Withdrawal,General,10,317
27,9,2010,South West Trains,Transport,30,287
27,9,2010,Wild Bean Cafe,Eating Out,2,285
27,9,2010,ATM Cash Withdrawal,General,20,265
28,9,2010,Wild Bean Cafe,Eating Out,1,264
28,9,2010,McDonalds,Eating Out,5,259
29,9,2010,Costa Coffee,Eating Out,2,257
29,9,2010,ATM Cash Withdrawal,General,20,237
30,9,2010,Costa Coffee,Eating Out,1,236
30,9,2010,Chicken Cottage,Eating Out,5,231
30,9,2010,ATM Cash Withdrawal,General,10,221
1,10,2010,Rhino Sports salary,General,1700,1921
1,10,2010,Sainsburys,Groceries,79,1842
1,10,2010,Costa Coffee,Eating Out,1,1841
1,10,2010,Chicken Cottage,Eating Out,5,1836
1,10,2010,ATM Cash Withdrawal,General,10,1826
3,10,2010,ATM Cash Withdrawal,General,10,1816
3,10,2010,Cheam Service Station,,8,1808
4,10,2010,South West Trains,Transport,35,1773
4,10,2010,Starbucks Coffee,Eating Out,1,1772
4,10,2010,McDonalds,Eating Out,7,1765
5,10,2010,Starbucks Coffee,Eating Out,1,1764
6,10,2010,Starbucks Coffee,Eating Out,1,1763
7,10,2010,Cubit and West rent,Rent,550,1213
7,10,2010,Starbucks Coffee,Eating Out,2,1211
7,10,2010,Subway,Eating Out,5,1206
8,10,2010,Tescos,Groceries,57,1149
8,10,2010,Caffe Nero,Eating Out,2,1147
8,10,2010,Civic Shop,,6,1141
9,10,2010,Dominos Pizza,Eating Out,51,1090
11,10,2010,South West Trains,Transport,34,1056
12,10,2010,Costa Coffee,Eating Out,1,1055
13,10,2010,The West Cornwall Pasty Company,Eating Out,4,1051
14,10,2010,Starbucks Coffee,Eating Out,1,1050
14,10,2010,Chicken Cottage,Eating Out,8,1042
15,10,2010,BRGAS-Electricity,Bills,41,1001
15,10,2010,BRGAS-Gas,Bills,41,960
15,10,2010,Sainsburys,Groceries,86,874
15,10,2010,Caffe Nero,Eating Out,1,873
15,10,2010,Pizza Express,Eating Out,59,814
16,10,2010,LBS Council Tax,Bills,50,764
16,10,2010,ATM Cash Withdrawal,General,20,744
17,10,2010,Dominos Pizza,Eating Out,33,711
18,10,2010,South West Trains,Transport,27,684
18,10,2010,Starbucks Coffee,Eating Out,2,682
18,10,2010,Pret A Manger,Eating Out,7,675
18,10,2010,ATM Cash Withdrawal,General,10,665
19,10,2010,Caffe Nero,Eating Out,1,664
19,10,2010,Chicken Cottage,Eating Out,8,656
19,10,2010,ATM Cash Withdrawal,General,20,636
19,10,2010,Red Shop,,6,630
20,10,2010,VIRGIN MEDIA PYMTS,Bills,46,584
20,10,2010,Costa Coffee,Eating Out,2,582
20,10,2010,Chicken Cottage,Eating Out,8,574
20,10,2010,ATM Cash Withdrawal,General,10,564
21,10,2010,Costa Coffee,Eating Out,2,562
21,10,2010,ATM Cash Withdrawal,General,20,542
22,10,2010,Morrisons,Groceries,62,480
22,10,2010,Wild Bean Cafe,Eating Out,1,479
22,10,2010,ATM Cash Withdrawal,General,10,469
22,10,2010,Civic Shop,,6,463
23,10,2010,Pizza Express,Eating Out,33,430
23,10,2010,ATM Cash Withdrawal,General,10,420
24,10,2010,O2,Bills,34,386
24,10,2010,Pizza Express,Eating Out,35,351
24,10,2010,ATM Cash Withdrawal,General,20,331
25,10,2010,South West Trains,Transport,34,297
25,10,2010,Subway,Eating Out,8,289
26,10,2010,Subway,Eating Out,7,282
27,10,2010,Caffe Nero,Eating Out,2,280
28,10,2010,Starbucks Coffee,Eating Out,2,278
28,10,2010,Subway,Eating Out,8,270
29,10,2010,ASDA,Groceries,46,224
29,10,2010,Starbucks Coffee,Eating Out,2,222
30,10,2010,Dominos Pizza,Eating Out,54,168
31,10,2010,ATM Cash Withdrawal,General,10,158
1,11,2010,Rhino Sports salary,General,1700,1858
1,11,2010,South West Trains,Transport,28,1830
1,11,2010,Costa Coffee,Eating Out,2,1828
1,11,2010,Chicken Cottage,Eating Out,8,1820
3,11,2010,Costa Coffee,Eating Out,2,1818
3,11,2010,Chicken Cottage,Eating Out,7,1811
4,11,2010,Caffe Nero,Eating Out,1,1810
4,11,2010,ATM Cash Withdrawal,General,20,1790
5,11,2010,Tescos,Groceries,82,1708
5,11,2010,Starbucks Coffee,Eating Out,2,1706
5,11,2010,Scott's Restaurant,Eating Out,30,1676
5,11,2010,ATM Cash Withdrawal,General,10,1666
6,11,2010,Dominos Pizza,Eating Out,45,1621
7,11,2010,Cubit and West rent,Rent,550,1071
8,11,2010,South West Trains,Transport,24,1047
8,11,2010,Caffe Nero,Eating Out,1,1046
8,11,2010,McDonalds,Eating Out,6,1040
8,11,2010,Tool Shop,,9,1031
9,11,2010,Greggs,Eating Out,4,1027
10,11,2010,Starbucks Coffee,Eating Out,1,1026
10,11,2010,The West Cornwall Pasty Company,Eating Out,8,1018
10,11,2010,ATM Cash Withdrawal,General,10,1008
11,11,2010,Wild Bean Cafe,Eating Out,2,1006
11,11,2010,Chicken Cottage,Eating Out,8,998
12,11,2010,Tescos,Groceries,45,953
12,11,2010,Costa Coffee,Eating Out,1,952
12,11,2010,Pizza Express,Eating Out,50,902
12,11,2010,ATM Cash Withdrawal,General,20,882
12,11,2010,Tool Shop,,9,873
14,11,2010,Restaurant Gordon RamsayPortland Restaurant,Eating Out,37,836
15,11,2010,BRGAS-Electricity,Bills,49,787
15,11,2010,BRGAS-Gas,Bills,36,751
15,11,2010,South West Trains,Transport,32,719
15,11,2010,Caffe Nero,Eating Out,1,718
16,11,2010,LBS Council Tax,Bills,50,668
16,11,2010,McDonalds,Eating Out,4,664
17,11,2010,Costa Coffee,Eating Out,1,663
17,11,2010,Tool Tec,,7,656
18,11,2010,Starbucks Coffee,Eating Out,1,655
18,11,2010,Civic Shop,,1,654
19,11,2010,Sainsburys,Groceries,64,590
19,11,2010,Caffe Nero,Eating Out,2,588
19,11,2010,ATM Cash Withdrawal,General,10,578
20,11,2010,VIRGIN MEDIA PYMTS,Bills,58,520
21,11,2010,Pizza Express,Eating Out,44,476
22,11,2010,South West Trains,Transport,24,452
23,11,2010,Costa Coffee,Eating Out,2,450
23,11,2010,Pret A Manger,Eating Out,5,445
23,11,2010,Civic Shop,,5,440
24,11,2010,O2,Bills,37,403
24,11,2010,Wild Bean Cafe,Eating Out,2,401
24,11,2010,ATM Cash Withdrawal,General,20,381
25,11,2010,Caffe Nero,Eating Out,2,379
25,11,2010,The West Cornwall Pasty Company,Eating Out,5,374
26,11,2010,ASDA,Groceries,82,292
26,11,2010,Starbucks Coffee,Eating Out,2,290
26,11,2010,The West Cornwall Pasty Company,Eating Out,7,283
26,11,2010,Fabric Club,Eating Out,7,276
26,11,2010,Fabric Club,Eating Out,6,270
26,11,2010,Fabric Club,Eating Out,9,261
26,11,2010,Fabric Club,Eating Out,10,251
26,11,2010,Fabric Club,Eating Out,5,246
26,11,2010,Fabric Club,Eating Out,7,239
26,11,2010,ATM Cash Withdrawal,General,10,229
27,11,2010,Ministry of Sound ClubXOYO Club,Eating Out,13,216
27,11,2010,Ministry of Sound ClubXOYO Club,Eating Out,12,204
27,11,2010,Ministry of Sound ClubXOYO Club,Eating Out,12,192
27,11,2010,Ministry of Sound ClubXOYO Club,Eating Out,16,176
27,11,2010,Ministry of Sound ClubXOYO Club,Eating Out,6,170
28,11,2010,Paying back James,,2,168
29,11,2010,South West Trains,Transport,27,141
29,11,2010,Starbucks Coffee,Eating Out,1,140
30,11,2010,Costa Coffee,Eating Out,2,138
30,11,2010,Chicken Cottage,Eating Out,5,133
1,12,2010,Rhino Sports salary,General,1700,1833
1,12,2010,Starbucks Coffee,Eating Out,2,1831
1,12,2010,Subway,Eating Out,5,1826
2,12,2010,Wild Bean Cafe,Eating Out,1,1825
2,12,2010,ATM Cash Withdrawal,General,20,1805
3,12,2010,Sainsburys,Groceries,86,1719
3,12,2010,Costa Coffee,Eating Out,1,1718
3,12,2010,Chicken Cottage,Eating Out,6,1712
5,12,2010,Pizza Express,Eating Out,49,1663
5,12,2010,ATM Cash Withdrawal,General,20,1643
6,12,2010,South West Trains,Transport,25,1618
6,12,2010,Greggs,Eating Out,6,1612
7,12,2010,Cubit and West rent,Rent,550,1062
7,12,2010,Costa Coffee,Eating Out,2,1060
8,12,2010,The West Cornwall Pasty Company,Eating Out,5,1055
9,12,2010,Costa Coffee,Eating Out,1,1054
9,12,2010,Chicken Cottage,Eating Out,5,1049
9,12,2010,ATM Cash Withdrawal,General,10,1039
10,12,2010,Morrisons,Groceries,79,960
10,12,2010,Wild Bean Cafe,Eating Out,2,958
10,12,2010,McDonalds,Eating Out,4,954
13,12,2010,South West Trains,Transport,31,923
13,12,2010,Costa Coffee,Eating Out,1,922
13,12,2010,McDonalds,Eating Out,6,916
14,12,2010,Caffe Nero,Eating Out,2,914
14,12,2010,Chicken Cottage,Eating Out,8,906
15,12,2010,BRGAS-Electricity,Bills,42,864
15,12,2010,BRGAS-Gas,Bills,30,834
15,12,2010,Costa Coffee,Eating Out,1,833
15,12,2010,Pret A Manger,Eating Out,8,825
15,12,2010,ATM Cash Withdrawal,General,20,805
16,12,2010,LBS Council Tax,Bills,50,755
16,12,2010,Wild Bean Cafe,Eating Out,1,754
17,12,2010,Sainsburys,Groceries,43,711
17,12,2010,Starbucks Coffee,Eating Out,2,709
17,12,2010,The West Cornwall Pasty Company,Eating Out,6,703
17,12,2010,Pizza Express,Eating Out,41,662
17,12,2010,Paying back Julie,,1,661
18,12,2010,Dominos Pizza,Eating Out,49,612
18,12,2010,ATM Cash Withdrawal,General,10,602
19,12,2010,ATM Cash Withdrawal,General,10,592
20,12,2010,VIRGIN MEDIA PYMTS,Bills,28,564
20,12,2010,South West Trains,Transport,33,531
20,12,2010,Wild Bean Cafe,Eating Out,2,529
20,12,2010,The West Cornwall Pasty Company,Eating Out,7,522
20,12,2010,ATM Cash Withdrawal,General,20,502
21,12,2010,Costa Coffee,Eating Out,2,500
21,12,2010,ATM Cash Withdrawal,General,10,490
22,12,2010,Caffe Nero,Eating Out,1,489
22,12,2010,Greggs,Eating Out,4,485
23,12,2010,Wild Bean Cafe,Eating Out,1,484
24,12,2010,O2,Bills,31,453
24,12,2010,ASDA,Groceries,59,394
24,12,2010,Chicken Cottage,Eating Out,6,388
25,12,2010,Pizza Express,Eating Out,35,353
26,12,2010,ATM Cash Withdrawal,General,10,343
27,12,2010,South West Trains,Transport,37,306
27,12,2010,Wild Bean Cafe,Eating Out,2,304
27,12,2010,McDonalds,Eating Out,4,300
28,12,2010,Caffe Nero,Eating Out,2,298
28,12,2010,Subway,Eating Out,5,293
29,12,2010,Wild Bean Cafe,Eating Out,1,292
29,12,2010,Subway,Eating Out,7,285
29,12,2010,ATM Cash Withdrawal,General,20,265
30,12,2010,Wild Bean Cafe,Eating Out,2,263
30,12,2010,McDonalds,Eating Out,8,255
30,12,2010,ATM Cash Withdrawal,General,10,245
31,12,2010,Sainsburys,Groceries,68,177
31,12,2010,ATM Cash Withdrawal,General,10,167
1,1,2011,Rhino Sports salary,General,1700,1867
1,1,2011,Anglo restaurant,Eating Out,58,1809
1,1,2011,ATM Cash Withdrawal,General,20,1789
2,1,2011,Scott's Restaurant,Eating Out,27,1762
2,1,2011,ATM Cash Withdrawal,General,10,1752
3,1,2011,South West Trains,Transport,35,1717
3,1,2011,Costa Coffee,Eating Out,2,1715
3,1,2011,ATM Cash Withdrawal,General,20,1695
4,1,2011,Starbucks Coffee,Eating Out,2,1693
4,1,2011,Chicken Cottage,Eating Out,5,1688
4,1,2011,Civic Shop,,5,1683
5,1,2011,ATM Cash Withdrawal,General,10,1673
6,1,2011,Caffe Nero,Eating Out,2,1671
6,1,2011,Tool Shop,,9,1662
7,1,2011,Cubit and West rent,Rent,550,1112
7,1,2011,Waitrose,Groceries,47,1065
7,1,2011,Starbucks Coffee,Eating Out,1,1064
7,1,2011,Subway,Eating Out,8,1056
8,1,2011,Ministry of Sound ClubXOYO Club,Eating Out,16,1040
8,1,2011,Ministry of Sound ClubXOYO Club,Eating Out,13,1027
8,1,2011,ATM Cash Withdrawal,General,10,1017
10,1,2011,South West Trains,Transport,34,983
10,1,2011,Costa Coffee,Eating Out,2,981
10,1,2011,Chicken Cottage,Eating Out,8,973
11,1,2011,Wild Bean Cafe,Eating Out,1,972
11,1,2011,Greggs,Eating Out,4,968
12,1,2011,Starbucks Coffee,Eating Out,1,967
12,1,2011,Subway,Eating Out,6,961
13,1,2011,Starbucks Coffee,Eating Out,2,959
13,1,2011,McDonalds,Eating Out,8,951
13,1,2011,Civic Shop,,8,943
14,1,2011,Tescos,Groceries,67,876
14,1,2011,Costa Coffee,Eating Out,1,875
15,1,2011,BRGAS-Electricity,Bills,79,796
15,1,2011,BRGAS-Gas,Bills,37,759
15,1,2011,Restaurant Gordon RamsayPortland Restaurant,Eating Out,30,729
15,1,2011,Red Shop,,9,720
16,1,2011,LBS Council Tax,Bills,50,670
17,1,2011,South West Trains,Transport,27,643
17,1,2011,Wild Bean Cafe,Eating Out,2,641
17,1,2011,Pret A Manger,Eating Out,6,635
18,1,2011,Starbucks Coffee,Eating Out,1,634
18,1,2011,Pret A Manger,Eating Out,8,626
19,1,2011,Costa Coffee,Eating Out,1,625
19,1,2011,ATM Cash Withdrawal,General,10,615
20,1,2011,VIRGIN MEDIA PYMTS,Bills,35,580
20,1,2011,Costa Coffee,Eating Out,2,578
20,1,2011,The West Cornwall Pasty Company,Eating Out,7,571
20,1,2011,ATM Cash Withdrawal,General,10,561
21,1,2011,Sainsburys,Groceries,71,490
21,1,2011,Starbucks Coffee,Eating Out,2,488
21,1,2011,Ministry of Sound ClubXOYO Club,Eating Out,9,479
21,1,2011,Pizza Express,Eating Out,27,452
22,1,2011,Fabric Club,Eating Out,10,442
22,1,2011,Anglo restaurant,Eating Out,37,405
23,1,2011,Anglo restaurant,Eating Out,39,366
24,1,2011,O2,Bills,31,335
24,1,2011,South West Trains,Transport,38,297
24,1,2011,Starbucks Coffee,Eating Out,2,295
25,1,2011,Caffe Nero,Eating Out,1,294
25,1,2011,Greggs,Eating Out,7,287
25,1,2011,Tool Shop,,9,278
26,1,2011,Starbucks Coffee,Eating Out,2,276
26,1,2011,The West Cornwall Pasty Company,Eating Out,7,269
27,1,2011,Wild Bean Cafe,Eating Out,1,268
27,1,2011,Subway,Eating Out,7,261
27,1,2011,Paying back Julie,,4,257
28,1,2011,Waitrose,Groceries,69,188
28,1,2011,Caffe Nero,Eating Out,2,186
28,1,2011,Pret A Manger,Eating Out,7,179
29,1,2011,Paying back Julie,,9,170
31,1,2011,South West Trains,Transport,25,145
31,1,2011,Greggs,Eating Out,6,139
31,1,2011,ATM Cash Withdrawal,General,10,129
1,2,2011,Rhino Sports salary,General,1700,1829
1,2,2011,Wild Bean Cafe,Eating Out,1,1828
1,2,2011,ATM Cash Withdrawal,General,20,1808
2,2,2011,Costa Coffee,Eating Out,2,1806
3,2,2011,Costa Coffee,Eating Out,2,1804
3,2,2011,Greggs,Eating Out,8,1796
4,2,2011,Morrisons,Groceries,52,1744
4,2,2011,Costa Coffee,Eating Out,1,1743
4,2,2011,Pizza Express,Eating Out,25,1718
4,2,2011,ATM Cash Withdrawal,General,10,1708
5,2,2011,Restaurant Gordon RamsayPortland Restaurant,Eating Out,41,1667
6,2,2011,Pizza Express,Eating Out,51,1616
7,2,2011,Cubit and West rent,Rent,550,1066
7,2,2011,South West Trains,Transport,34,1032
7,2,2011,Wild Bean Cafe,Eating Out,2,1030
7,2,2011,Subway,Eating Out,5,1025
9,2,2011,Costa Coffee,Eating Out,2,1023
10,2,2011,Costa Coffee,Eating Out,2,1021
10,2,2011,Chicken Cottage,Eating Out,7,1014
11,2,2011,ASDA,Groceries,43,971
11,2,2011,Caffe Nero,Eating Out,1,970
11,2,2011,Chicken Cottage,Eating Out,6,964
11,2,2011,Heaven Club,Eating Out,7,957
11,2,2011,Heaven Club,Eating Out,5,952
12,2,2011,ATM Cash Withdrawal,General,20,932
13,2,2011,Pizza Express,Eating Out,33,899
14,2,2011,South West Trains,Transport,27,872
14,2,2011,Starbucks Coffee,Eating Out,1,871
15,2,2011,BRGAS-Electricity,Bills,24,847
15,2,2011,BRGAS-Gas,Bills,27,820
15,2,2011,Costa Coffee,Eating Out,2,818
15,2,2011,Chicken Cottage,Eating Out,8,810
15,2,2011,Civic Shop,,1,809
16,2,2011,LBS Council Tax,Bills,50,759
16,2,2011,Starbucks Coffee,Eating Out,2,757
16,2,2011,Chicken Cottage,Eating Out,7,750
17,2,2011,Caffe Nero,Eating Out,1,749
17,2,2011,Greggs,Eating Out,5,744
18,2,2011,Sainsburys,Groceries,55,689
18,2,2011,Caffe Nero,Eating Out,1,688
18,2,2011,Greggs,Eating Out,5,683
18,2,2011,Ministry of Sound ClubXOYO Club,Eating Out,8,675
18,2,2011,Ministry of Sound ClubXOYO Club,Eating Out,8,667
18,2,2011,Ministry of Sound ClubXOYO Club,Eating Out,5,662
18,2,2011,Ministry of Sound ClubXOYO Club,Eating Out,5,657
18,2,2011,ATM Cash Withdrawal,General,10,647
19,2,2011,Scott's Restaurant,Eating Out,48,599
20,2,2011,VIRGIN MEDIA PYMTS,Bills,56,543
20,2,2011,Scott's Restaurant,Eating Out,45,498
21,2,2011,South West Trains,Transport,27,471
21,2,2011,Wild Bean Cafe,Eating Out,2,469
21,2,2011,Greggs,Eating Out,7,462
22,2,2011,Greggs,Eating Out,7,455
22,2,2011,ATM Cash Withdrawal,General,10,445
23,2,2011,Costa Coffee,Eating Out,2,443
23,2,2011,ATM Cash Withdrawal,General,10,433
24,2,2011,O2,Bills,33,400
24,2,2011,Caffe Nero,Eating Out,2,398
24,2,2011,Civic Shop,,4,394
25,2,2011,Sainsburys,Groceries,81,313
25,2,2011,Starbucks Coffee,Eating Out,2,311
25,2,2011,McDonalds,Eating Out,8,303
25,2,2011,Scott's Restaurant,Eating Out,32,271
25,2,2011,Tool Shop,,1,270
26,2,2011,Fabric Club,Eating Out,6,264
26,2,2011,Fabric Club,Eating Out,15,249
26,2,2011,Fabric Club,Eating Out,10,239
26,2,2011,Fabric Club,Eating Out,12,227
26,2,2011,Pizza Express,Eating Out,56,171
26,2,2011,ATM Cash Withdrawal,General,20,151
26,2,2011,Cheam Service Station,,2,149
28,2,2011,South West Trains,Transport,26,123
28,2,2011,Caffe Nero,Eating Out,1,122
28,2,2011,The West Cornwall Pasty Company,Eating Out,4,118
1,3,2011,Rhino Sports salary,General,1700,1818
1,3,2011,The West Cornwall Pasty Company,Eating Out,6,1812
1,3,2011,ATM Cash Withdrawal,General,10,1802
2,3,2011,Caffe Nero,Eating Out,2,1800
2,3,2011,Pret A Manger,Eating Out,7,1793
3,3,2011,Pret A Manger,Eating Out,7,1786
3,3,2011,ATM Cash Withdrawal,General,20,1766
4,3,2011,Waitrose,Groceries,60,1706
4,3,2011,Costa Coffee,Eating Out,1,1705
5,3,2011,Civic Shop,,6,1699
6,3,2011,Pizza Express,Eating Out,37,1662
6,3,2011,ATM Cash Withdrawal,General,10,1652
7,3,2011,Cubit and West rent,Rent,550,1102
7,3,2011,South West Trains,Transport,29,1073
7,3,2011,Costa Coffee,Eating Out,2,1071
7,3,2011,McDonalds,Eating Out,7,1064
7,3,2011,ATM Cash Withdrawal,General,10,1054
8,3,2011,Starbucks Coffee,Eating Out,2,1052
8,3,2011,ATM Cash Withdrawal,General,10,1042
9,3,2011,Caffe Nero,Eating Out,2,1040
9,3,2011,Greggs,Eating Out,7,1033
10,3,2011,Cheam Service Station,,8,1025
11,3,2011,Sainsburys,Groceries,50,975
11,3,2011,Chicken Cottage,Eating Out,6,969
11,3,2011,Paying back Julie,,8,961
12,3,2011,Pizza Express,Eating Out,56,905
12,3,2011,ATM Cash Withdrawal,General,10,895
14,3,2011,South West Trains,Transport,29,866
14,3,2011,Starbucks Coffee,Eating Out,2,864
15,3,2011,BRGAS-Electricity,Bills,23,841
15,3,2011,BRGAS-Gas,Bills,39,802
15,3,2011,Costa Coffee,Eating Out,2,800
15,3,2011,Pret A Manger,Eating Out,4,796
15,3,2011,ATM Cash Withdrawal,General,20,776
16,3,2011,LBS Council Tax,Bills,50,726
17,3,2011,Subway,Eating Out,5,721
17,3,2011,ATM Cash Withdrawal,General,20,701
18,3,2011,ASDA,Groceries,65,636
18,3,2011,Costa Coffee,Eating Out,2,634
18,3,2011,Anglo restaurant,Eating Out,54,580
20,3,2011,VIRGIN MEDIA PYMTS,Bills,29,551
20,3,2011,ATM Cash Withdrawal,General,20,531
21,3,2011,South West Trains,Transport,37,494
21,3,2011,Costa Coffee,Eating Out,1,493
21,3,2011,McDonalds,Eating Out,4,489
22,3,2011,Wild Bean Cafe,Eating Out,2,487
22,3,2011,Subway,Eating Out,7,480
22,3,2011,ATM Cash Withdrawal,General,10,470
23,3,2011,The West Cornwall Pasty Company,Eating Out,6,464
24,3,2011,O2,Bills,35,429
24,3,2011,Caffe Nero,Eating Out,2,427
24,3,2011,McDonalds,Eating Out,4,423
25,3,2011,Tescos,Groceries,86,337
25,3,2011,Caffe Nero,Eating Out,2,335
25,3,2011,McDonalds,Eating Out,6,329
26,3,2011,Pizza Express,Eating Out,46,283
27,3,2011,Paying back Julie,,3,280
28,3,2011,South West Trains,Transport,28,252
28,3,2011,McDonalds,Eating Out,5,247
29,3,2011,Wild Bean Cafe,Eating Out,2,245
29,3,2011,Greggs,Eating Out,8,237
29,3,2011,ATM Cash Withdrawal,General,20,217
29,3,2011,Civic Shop,,8,209
30,3,2011,Costa Coffee,Eating Out,1,208
30,3,2011,Subway,Eating Out,6,202
31,3,2011,Costa Coffee,Eating Out,1,201
31,3,2011,Pret A Manger,Eating Out,4,197
1,4,2011,Rhino Sports salary,General,1700,1897
1,4,2011,Sainsburys,Groceries,69,1828
1,4,2011,Caffe Nero,Eating Out,2,1826
1,4,2011,Chicken Cottage,Eating Out,8,1818
2,4,2011,Pizza Express,Eating Out,27,1791
3,4,2011,Restaurant Gordon RamsayPortland Restaurant,Eating Out,41,1750
4,4,2011,South West Trains,Transport,27,1723
4,4,2011,Starbucks Coffee,Eating Out,2,1721
4,4,2011,Tool Shop,,9,1712
5,4,2011,Costa Coffee,Eating Out,2,1710
5,4,2011,The West Cornwall Pasty Company,Eating Out,5,1705
5,4,2011,Paying back James,,3,1702
6,4,2011,Caffe Nero,Eating Out,2,1700
6,4,2011,Greggs,Eating Out,4,1696
6,4,2011,ATM Cash Withdrawal,General,20,1676
7,4,2011,Cubit and West rent,Rent,550,1126
7,4,2011,Caffe Nero,Eating Out,2,1124
8,4,2011,Morrisons,Groceries,50,1074
8,4,2011,Starbucks Coffee,Eating Out,2,1072
8,4,2011,Tool Tec,,3,1069
9,4,2011,The Grand Pub,Eating Out,6,1063
9,4,2011,The Grand Pub,Eating Out,9,1054
9,4,2011,The Grand Pub,Eating Out,8,1046
9,4,2011,The Grand Pub,Eating Out,15,1031
9,4,2011,The Grand Pub,Eating Out,12,1019
9,4,2011,Restaurant Gordon RamsayPortland Restaurant,Eating Out,31,988
10,4,2011,Anglo restaurant,Eating Out,31,957
11,4,2011,South West Trains,Transport,25,932
11,4,2011,McDonalds,Eating Out,5,927
11,4,2011,ATM Cash Withdrawal,General,20,907
12,4,2011,Starbucks Coffee,Eating Out,2,905
12,4,2011,The West Cornwall Pasty Company,Eating Out,7,898
13,4,2011,Caffe Nero,Eating Out,2,896
13,4,2011,McDonalds,Eating Out,6,890
13,4,2011,ATM Cash Withdrawal,General,10,880
14,4,2011,Wild Bean Cafe,Eating Out,1,879
14,4,2011,Subway,Eating Out,4,875
14,4,2011,ATM Cash Withdrawal,General,10,865
15,4,2011,BRGAS-Electricity,Bills,28,837
15,4,2011,BRGAS-Gas,Bills,40,797
15,4,2011,Waitrose,Groceries,67,730
15,4,2011,Pret A Manger,Eating Out,5,725
15,4,2011,ATM Cash Withdrawal,General,10,715
16,4,2011,LBS Council Tax,Bills,50,665
16,4,2011,ATM Cash Withdrawal,General,10,655
18,4,2011,South West Trains,Transport,26,629
18,4,2011,Starbucks Coffee,Eating Out,1,628
18,4,2011,ATM Cash Withdrawal,General,10,618
19,4,2011,Caffe Nero,Eating Out,2,616
20,4,2011,VIRGIN MEDIA PYMTS,Bills,44,572
20,4,2011,Costa Coffee,Eating Out,2,570
20,4,2011,The West Cornwall Pasty Company,Eating Out,8,562
21,4,2011,Starbucks Coffee,Eating Out,2,560
22,4,2011,Sainsburys,Groceries,77,483
22,4,2011,Chicken Cottage,Eating Out,6,477
22,4,2011,ATM Cash Withdrawal,General,20,457
23,4,2011,Dominos Pizza,Eating Out,40,417
23,4,2011,ATM Cash Withdrawal,General,10,407
24,4,2011,O2,Bills,33,374
24,4,2011,Restaurant Gordon RamsayPortland Restaurant,Eating Out,31,343
25,4,2011,South West Trains,Transport,27,316
25,4,2011,Caffe Nero,Eating Out,1,315
26,4,2011,Starbucks Coffee,Eating Out,2,313
26,4,2011,The West Cornwall Pasty Company,Eating Out,5,308
27,4,2011,Wild Bean Cafe,Eating Out,1,307
27,4,2011,Chicken Cottage,Eating Out,5,302
28,4,2011,Starbucks Coffee,Eating Out,1,301
29,4,2011,Waitrose,Groceries,65,236
29,4,2011,Wild Bean Cafe,Eating Out,2,234
29,4,2011,Anglo restaurant,Eating Out,57,177
29,4,2011,ATM Cash Withdrawal,General,20,157
1,5,2011,Rhino Sports salary,General,1700,1857
1,5,2011,ATM Cash Withdrawal,General,10,1847
2,5,2011,South West Trains,Transport,32,1815
2,5,2011,Costa Coffee,Eating Out,1,1814
2,5,2011,Greggs,Eating Out,8,1806
2,5,2011,ATM Cash Withdrawal,General,20,1786
3,5,2011,Subway,Eating Out,6,1780
3,5,2011,ATM Cash Withdrawal,General,10,1770
4,5,2011,Costa Coffee,Eating Out,2,1768
4,5,2011,McDonalds,Eating Out,7,1761
5,5,2011,Caffe Nero,Eating Out,2,1759
6,5,2011,Sainsburys,Groceries,49,1710
6,5,2011,Starbucks Coffee,Eating Out,1,1709
6,5,2011,McDonalds,Eating Out,8,1701
6,5,2011,Scott's Restaurant,Eating Out,32,1669
7,5,2011,Cubit and West rent,Rent,550,1119
7,5,2011,Scott's Restaurant,Eating Out,37,1082
8,5,2011,Pizza Express,Eating Out,47,1035
8,5,2011,Tool Shop,,8,1027
9,5,2011,South West Trains,Transport,33,994
9,5,2011,Starbucks Coffee,Eating Out,2,992
9,5,2011,McDonalds,Eating Out,8,984
9,5,2011,Tool Tec,,9,975
10,5,2011,Caffe Nero,Eating Out,2,973
10,5,2011,The West Cornwall Pasty Company,Eating Out,5,968
10,5,2011,ATM Cash Withdrawal,General,10,958
11,5,2011,Costa Coffee,Eating Out,1,957
12,5,2011,Caffe Nero,Eating Out,1,956
12,5,2011,Chicken Cottage,Eating Out,6,950
13,5,2011,ASDA,Groceries,58,892
13,5,2011,Caffe Nero,Eating Out,1,891
13,5,2011,ATM Cash Withdrawal,General,10,881
15,5,2011,BRGAS-Electricity,Bills,24,857
15,5,2011,BRGAS-Gas,Bills,37,820
16,5,2011,LBS Council Tax,Bills,50,770
16,5,2011,South West Trains,Transport,27,743
16,5,2011,Costa Coffee,Eating Out,1,742
16,5,2011,Chicken Cottage,Eating Out,6,736
17,5,2011,Chicken Cottage,Eating Out,8,728
17,5,2011,ATM Cash Withdrawal,General,10,718
18,5,2011,McDonalds,Eating Out,7,711
19,5,2011,ATM Cash Withdrawal,General,20,691
20,5,2011,VIRGIN MEDIA PYMTS,Bills,59,632
20,5,2011,Tescos,Groceries,43,589
20,5,2011,Costa Coffee,Eating Out,2,587
20,5,2011,Greggs,Eating Out,7,580
20,5,2011,The Grand Pub,Eating Out,15,565
20,5,2011,The Grand Pub,Eating Out,10,555
20,5,2011,The Grand Pub,Eating Out,7,548
20,5,2011,The Grand Pub,Eating Out,6,542
20,5,2011,The Grand Pub,Eating Out,13,529
20,5,2011,The Grand Pub,Eating Out,16,513
20,5,2011,ATM Cash Withdrawal,General,20,493
23,5,2011,South West Trains,Transport,29,464
23,5,2011,Caffe Nero,Eating Out,1,463
23,5,2011,Greggs,Eating Out,4,459
23,5,2011,ATM Cash Withdrawal,General,20,439
24,5,2011,O2,Bills,37,402
24,5,2011,Costa Coffee,Eating Out,1,401
25,5,2011,Starbucks Coffee,Eating Out,1,400
25,5,2011,Subway,Eating Out,7,393
26,5,2011,Chicken Cottage,Eating Out,6,387
27,5,2011,Sainsburys,Groceries,42,345
27,5,2011,Starbucks Coffee,Eating Out,2,343
27,5,2011,Greggs,Eating Out,6,337
27,5,2011,ATM Cash Withdrawal,General,10,327
28,5,2011,Pizza Express,Eating Out,27,300
28,5,2011,Paying back James,,7,293
30,5,2011,South West Trains,Transport,27,266
30,5,2011,Caffe Nero,Eating Out,2,264
30,5,2011,Cheam Service Station,,1,263
31,5,2011,Starbucks Coffee,Eating Out,2,261
1,6,2011,Rhino Sports salary,General,1700,1961
1,6,2011,Wild Bean Cafe,Eating Out,1,1960
1,6,2011,Subway,Eating Out,8,1952
2,6,2011,Starbucks Coffee,Eating Out,2,1950
2,6,2011,The West Cornwall Pasty Company,Eating Out,7,1943
3,6,2011,ASDA,Groceries,76,1867
3,6,2011,Subway,Eating Out,5,1862
3,6,2011,Ministry of Sound ClubXOYO Club,Eating Out,7,1855
3,6,2011,Ministry of Sound ClubXOYO Club,Eating Out,9,1846
3,6,2011,Anglo restaurant,Eating Out,33,1813
3,6,2011,ATM Cash Withdrawal,General,10,1803
4,6,2011,ATM Cash Withdrawal,General,10,1793
5,6,2011,ATM Cash Withdrawal,General,10,1783
6,6,2011,South West Trains,Transport,34,1749
6,6,2011,Greggs,Eating Out,7,1742
6,6,2011,ATM Cash Withdrawal,General,20,1722
7,6,2011,Cubit and West rent,Rent,550,1172
7,6,2011,Starbucks Coffee,Eating Out,1,1171
8,6,2011,Wild Bean Cafe,Eating Out,1,1170
8,6,2011,Greggs,Eating Out,5,1165
8,6,2011,ATM Cash Withdrawal,General,20,1145
9,6,2011,Starbucks Coffee,Eating Out,1,1144
9,6,2011,ATM Cash Withdrawal,General,20,1124
10,6,2011,Tescos,Groceries,71,1053
10,6,2011,Costa Coffee,Eating Out,2,1051
10,6,2011,Restaurant Gordon RamsayPortland Restaurant,Eating Out,58,993
10,6,2011,ATM Cash Withdrawal,General,20,973
11,6,2011,Scott's Restaurant,Eating Out,29,944
12,6,2011,Anglo restaurant,Eating Out,44,900
13,6,2011,South West Trains,Transport,38,862
13,6,2011,Wild Bean Cafe,Eating Out,1,861
13,6,2011,Subway,Eating Out,4,857
14,6,2011,Costa Coffee,Eating Out,2,855
14,6,2011,Subway,Eating Out,7,848
15,6,2011,BRGAS-Electricity,Bills,36,812
15,6,2011,BRGAS-Gas,Bills,26,786
15,6,2011,Caffe Nero,Eating Out,2,784
16,6,2011,LBS Council Tax,Bills,50,734
16,6,2011,Greggs,Eating Out,5,729
17,6,2011,Sainsburys,Groceries,76,653
17,6,2011,Scott's Restaurant,Eating Out,36,617
17,6,2011,ATM Cash Withdrawal,General,10,607
18,6,2011,Heaven Club,Eating Out,6,601
18,6,2011,Heaven Club,Eating Out,13,588
18,6,2011,Restaurant Gordon RamsayPortland Restaurant,Eating Out,25,563
18,6,2011,ATM Cash Withdrawal,General,10,553
20,6,2011,VIRGIN MEDIA PYMTS,Bills,38,515
20,6,2011,South West Trains,Transport,38,477
20,6,2011,Starbucks Coffee,Eating Out,2,475
21,6,2011,Starbucks Coffee,Eating Out,1,474
21,6,2011,ATM Cash Withdrawal,General,20,454
22,6,2011,Greggs,Eating Out,8,446
23,6,2011,Greggs,Eating Out,8,438
23,6,2011,ATM Cash Withdrawal,General,20,418
24,6,2011,O2,Bills,30,388
24,6,2011,Waitrose,Groceries,78,310
24,6,2011,Greggs,Eating Out,7,303
24,6,2011,Scott's Restaurant,Eating Out,27,276
25,6,2011,Scott's Restaurant,Eating Out,39,237
26,6,2011,Pizza Express,Eating Out,29,208
27,6,2011,South West Trains,Transport,33,175
27,6,2011,Wild Bean Cafe,Eating Out,2,173
27,6,2011,McDonalds,Eating Out,6,167
28,6,2011,Wild Bean Cafe,Eating Out,2,165
28,6,2011,McDonalds,Eating Out,7,158
28,6,2011,ATM Cash Withdrawal,General,10,148
29,6,2011,Subway,Eating Out,4,144
29,6,2011,Tool Tec,,4,140
30,6,2011,Chicken Cottage,Eating Out,6,134
1,7,2011,Rhino Sports salary,General,1700,1834
1,7,2011,Waitrose,Groceries,54,1780
1,7,2011,Caffe Nero,Eating Out,2,1778
1,7,2011,McDonalds,Eating Out,5,1773
1,7,2011,Dominos Pizza,Eating Out,25,1748
2,7,2011,Pizza Express,Eating Out,38,1710
3,7,2011,ATM Cash Withdrawal,General,10,1700
4,7,2011,South West Trains,Transport,28,1672
4,7,2011,Caffe Nero,Eating Out,2,1670
4,7,2011,The West Cornwall Pasty Company,Eating Out,7,1663
5,7,2011,Wild Bean Cafe,Eating Out,2,1661
5,7,2011,ATM Cash Withdrawal,General,20,1641
5,7,2011,Paying back James,,3,1638
6,7,2011,Caffe Nero,Eating Out,2,1636
6,7,2011,The West Cornwall Pasty Company,Eating Out,6,1630
7,7,2011,Cubit and West rent,Rent,550,1080
7,7,2011,Caffe Nero,Eating Out,2,1078
7,7,2011,The West Cornwall Pasty Company,Eating Out,4,1074
7,7,2011,ATM Cash Withdrawal,General,20,1054
8,7,2011,Sainsburys,Groceries,55,999
8,7,2011,Starbucks Coffee,Eating Out,1,998
8,7,2011,Chicken Cottage,Eating Out,5,993
8,7,2011,ATM Cash Withdrawal,General,10,983
9,7,2011,Dominos Pizza,Eating Out,31,952
9,7,2011,ATM Cash Withdrawal,General,20,932
11,7,2011,South West Trains,Transport,32,900
11,7,2011,Subway,Eating Out,8,892
12,7,2011,Caffe Nero,Eating Out,2,890
13,7,2011,Wild Bean Cafe,Eating Out,2,888
14,7,2011,Wild Bean Cafe,Eating Out,1,887
14,7,2011,ATM Cash Withdrawal,General,20,867
15,7,2011,BRGAS-Electricity,Bills,21,846
15,7,2011,BRGAS-Gas,Bills,33,813
15,7,2011,ASDA,Groceries,45,768
15,7,2011,Caffe Nero,Eating Out,1,767
15,7,2011,Cheam Service Station,,6,761
16,7,2011,LBS Council Tax,Bills,50,711
17,7,2011,ATM Cash Withdrawal,General,20,691
18,7,2011,South West Trains,Transport,27,664
18,7,2011,Caffe Nero,Eating Out,2,662
19,7,2011,ATM Cash Withdrawal,General,10,652
20,7,2011,VIRGIN MEDIA PYMTS,Bills,46,606
20,7,2011,Wild Bean Cafe,Eating Out,2,604
21,7,2011,Starbucks Coffee,Eating Out,2,602
22,7,2011,Sainsburys,Groceries,42,560
22,7,2011,Wild Bean Cafe,Eating Out,2,558
22,7,2011,Greggs,Eating Out,8,550
23,7,2011,ATM Cash Withdrawal,General,10,540
24,7,2011,O2,Bills,31,509
24,7,2011,ATM Cash Withdrawal,General,10,499
25,7,2011,South West Trains,Transport,28,471
25,7,2011,Starbucks Coffee,Eating Out,1,470
26,7,2011,ATM Cash Withdrawal,General,20,450
27,7,2011,Subway,Eating Out,6,444
27,7,2011,ATM Cash Withdrawal,General,20,424
28,7,2011,Tool Tec,,1,423
29,7,2011,Sainsburys,Groceries,65,358
29,7,2011,Costa Coffee,Eating Out,1,357
29,7,2011,ATM Cash Withdrawal,General,10,347
30,7,2011,The Grand Pub,Eating Out,15,332
30,7,2011,The Grand Pub,Eating Out,6,326
30,7,2011,The Grand Pub,Eating Out,11,315
30,7,2011,The Grand Pub,Eating Out,14,301
30,7,2011,Anglo restaurant,Eating Out,31,270
30,7,2011,Tool Tec,,3,267
31,7,2011,ATM Cash Withdrawal,General,20,247
1,8,2011,Rhino Sports salary,General,1700,1947
1,8,2011,South West Trains,Transport,32,1915
1,8,2011,Costa Coffee,Eating Out,1,1914
1,8,2011,McDonalds,Eating Out,8,1906
2,8,2011,Costa Coffee,Eating Out,2,1904
3,8,2011,Wild Bean Cafe,Eating Out,1,1903
3,8,2011,Tool Shop,,7,1896
5,8,2011,Morrisons,Groceries,65,1831
5,8,2011,Wild Bean Cafe,Eating Out,1,1830
5,8,2011,Greggs,Eating Out,4,1826
5,8,2011,Civic Shop,,9,1817
7,8,2011,Cubit and West rent,Rent,550,1267
8,8,2011,South West Trains,Transport,32,1235
8,8,2011,Wild Bean Cafe,Eating Out,1,1234
8,8,2011,McDonalds,Eating Out,6,1228
9,8,2011,Wild Bean Cafe,Eating Out,2,1226
9,8,2011,McDonalds,Eating Out,6,1220
9,8,2011,ATM Cash Withdrawal,General,20,1200
10,8,2011,Caffe Nero,Eating Out,2,1198
11,8,2011,The West Cornwall Pasty Company,Eating Out,7,1191
11,8,2011,ATM Cash Withdrawal,General,20,1171
12,8,2011,Waitrose,Groceries,89,1082
12,8,2011,Costa Coffee,Eating Out,2,1080
15,8,2011,BRGAS-Electricity,Bills,36,1044
15,8,2011,BRGAS-Gas,Bills,37,1007
15,8,2011,South West Trains,Transport,32,975
15,8,2011,Wild Bean Cafe,Eating Out,2,973
15,8,2011,The West Cornwall Pasty Company,Eating Out,5,968
15,8,2011,ATM Cash Withdrawal,General,20,948
15,8,2011,Red Shop,,4,944
16,8,2011,LBS Council Tax,Bills,50,894
16,8,2011,Pret A Manger,Eating Out,5,889
16,8,2011,Red Shop,,6,883
17,8,2011,Greggs,Eating Out,4,879
17,8,2011,Paying back James,,4,875
18,8,2011,Pret A Manger,Eating Out,7,868
18,8,2011,ATM Cash Withdrawal,General,10,858
19,8,2011,Waitrose,Groceries,79,779
19,8,2011,Costa Coffee,Eating Out,1,778
19,8,2011,Greggs,Eating Out,6,772
19,8,2011,Heaven Club,Eating Out,14,758
19,8,2011,Heaven Club,Eating Out,8,750
19,8,2011,Heaven Club,Eating Out,12,738
19,8,2011,Heaven Club,Eating Out,16,722
19,8,2011,Heaven Club,Eating Out,11,711
19,8,2011,Heaven Club,Eating Out,8,703
19,8,2011,Tool Shop,,3,700
20,8,2011,VIRGIN MEDIA PYMTS,Bills,45,655
20,8,2011,Anglo restaurant,Eating Out,35,620
20,8,2011,ATM Cash Withdrawal,General,20,600
22,8,2011,South West Trains,Transport,34,566
22,8,2011,Starbucks Coffee,Eating Out,2,564
23,8,2011,Starbucks Coffee,Eating Out,2,562
23,8,2011,The West Cornwall Pasty Company,Eating Out,8,554
24,8,2011,O2,Bills,34,520
24,8,2011,Starbucks Coffee,Eating Out,1,519
24,8,2011,The West Cornwall Pasty Company,Eating Out,8,511
25,8,2011,Caffe Nero,Eating Out,2,509
25,8,2011,Pret A Manger,Eating Out,8,501
25,8,2011,ATM Cash Withdrawal,General,20,481
25,8,2011,Paying back Julie,,2,479
26,8,2011,ASDA,Groceries,71,408
26,8,2011,Starbucks Coffee,Eating Out,2,406
26,8,2011,Greggs,Eating Out,4,402
26,8,2011,Scott's Restaurant,Eating Out,39,363
27,8,2011,Scott's Restaurant,Eating Out,31,332
27,8,2011,Paying back James,,1,331
28,8,2011,Pizza Express,Eating Out,54,277
29,8,2011,South West Trains,Transport,32,245
29,8,2011,Starbucks Coffee,Eating Out,1,244
29,8,2011,Greggs,Eating Out,5,239
30,8,2011,McDonalds,Eating Out,7,232
31,8,2011,Starbucks Coffee,Eating Out,2,230
31,8,2011,Pret A Manger,Eating Out,5,225
1,9,2011,Rhino Sports salary,General,1700,1925
1,9,2011,Caffe Nero,Eating Out,1,1924
2,9,2011,ASDA,Groceries,50,1874
2,9,2011,Costa Coffee,Eating Out,2,1872
2,9,2011,Pret A Manger,Eating Out,7,1865
2,9,2011,Fabric Club,Eating Out,13,1852
2,9,2011,ATM Cash Withdrawal,General,20,1832
4,9,2011,Anglo restaurant,Eating Out,58,1774
5,9,2011,South West Trains,Transport,36,1738
5,9,2011,Costa Coffee,Eating Out,2,1736
5,9,2011,Paying back Julie,,3,1733
7,9,2011,Cubit and West rent,Rent,550,1183
7,9,2011,Caffe Nero,Eating Out,1,1182
7,9,2011,Greggs,Eating Out,8,1174
8,9,2011,Wild Bean Cafe,Eating Out,2,1172
9,9,2011,Waitrose,Groceries,87,1085
9,9,2011,Caffe Nero,Eating Out,2,1083
9,9,2011,Chicken Cottage,Eating Out,7,1076
10,9,2011,The Grand Pub,Eating Out,15,1061
10,9,2011,The Grand Pub,Eating Out,11,1050
10,9,2011,The Grand Pub,Eating Out,12,1038
10,9,2011,The Grand Pub,Eating Out,15,1023
10,9,2011,The Grand Pub,Eating Out,5,1018
11,9,2011,Pizza Express,Eating Out,59,959
11,9,2011,ATM Cash Withdrawal,General,20,939
12,9,2011,South West Trains,Transport,28,911
12,9,2011,Wild Bean Cafe,Eating Out,2,909
13,9,2011,Caffe Nero,Eating Out,2,907
13,9,2011,Pret A Manger,Eating Out,6,901
13,9,2011,ATM Cash Withdrawal,General,10,891
14,9,2011,Costa Coffee,Eating Out,2,889
14,9,2011,ATM Cash Withdrawal,General,10,879
15,9,2011,BRGAS-Electricity,Bills,31,848
15,9,2011,BRGAS-Gas,Bills,38,810
15,9,2011,Caffe Nero,Eating Out,2,808
15,9,2011,ATM Cash Withdrawal,General,20,788
16,9,2011,LBS Council Tax,Bills,50,738
16,9,2011,Morrisons,Groceries,60,678
16,9,2011,McDonalds,Eating Out,6,672
16,9,2011,Pizza Express,Eating Out,57,615
16,9,2011,ATM Cash Withdrawal,General,20,595
17,9,2011,Pizza Express,Eating Out,57,538
17,9,2011,Paying back Julie,,4,534
18,9,2011,Anglo restaurant,Eating Out,32,502
18,9,2011,Paying back James,,4,498
19,9,2011,South West Trains,Transport,27,471
19,9,2011,Starbucks Coffee,Eating Out,1,470
19,9,2011,Subway,Eating Out,6,464
20,9,2011,VIRGIN MEDIA PYMTS,Bills,33,431
20,9,2011,Starbucks Coffee,Eating Out,1,430
20,9,2011,Civic Shop,,9,421
21,9,2011,ATM Cash Withdrawal,General,20,401
21,9,2011,Paying back Julie,,2,399
22,9,2011,Starbucks Coffee,Eating Out,2,397
22,9,2011,ATM Cash Withdrawal,General,20,377
23,9,2011,ASDA,Groceries,59,318
23,9,2011,Caffe Nero,Eating Out,1,317
23,9,2011,The West Cornwall Pasty Company,Eating Out,6,311
23,9,2011,Heaven Club,Eating Out,15,296
23,9,2011,Heaven Club,Eating Out,7,289
23,9,2011,Heaven Club,Eating Out,15,274
23,9,2011,Restaurant Gordon RamsayPortland Restaurant,Eating Out,39,235
24,9,2011,O2,Bills,31,204
24,9,2011,Dominos Pizza,Eating Out,41,163
25,9,2011,Civic Shop,,4,159
26,9,2011,South West Trains,Transport,30,129
26,9,2011,Caffe Nero,Eating Out,1,128
26,9,2011,The West Cornwall Pasty Company,Eating Out,7,121
27,9,2011,Chicken Cottage,Eating Out,7,114
28,9,2011,Caffe Nero,Eating Out,2,112
28,9,2011,Pret A Manger,Eating Out,5,107
29,9,2011,Chicken Cottage,Eating Out,6,101
30,9,2011,Tescos,Groceries,48,53
30,9,2011,The West Cornwall Pasty Company,Eating Out,5,48
30,9,2011,Fabric Club,Eating Out,16,32
30,9,2011,Fabric Club,Eating Out,13,19
30,9,2011,Fabric Club,Eating Out,14,5
30,9,2011,Dominos Pizza,Eating Out,25,-20
1,10,2011,Rhino Sports salary,General,1700,1680
2,10,2011,Scott's Restaurant,Eating Out,54,1626
3,10,2011,South West Trains,Transport,29,1597
3,10,2011,Starbucks Coffee,Eating Out,1,1596
3,10,2011,Chicken Cottage,Eating Out,4,1592
4,10,2011,McDonalds,Eating Out,4,1588
5,10,2011,Tool Shop,,7,1581
6,10,2011,Starbucks Coffee,Eating Out,1,1580
7,10,2011,Cubit and West rent,Rent,550,1030
7,10,2011,Sainsburys,Groceries,42,988
10,10,2011,South West Trains,Transport,34,954
10,10,2011,Starbucks Coffee,Eating Out,1,953
10,10,2011,Pret A Manger,Eating Out,6,947
11,10,2011,Costa Coffee,Eating Out,2,945
11,10,2011,ATM Cash Withdrawal,General,10,935
12,10,2011,Caffe Nero,Eating Out,2,933
12,10,2011,The West Cornwall Pasty Company,Eating Out,8,925
12,10,2011,ATM Cash Withdrawal,General,20,905
13,10,2011,Caffe Nero,Eating Out,2,903
13,10,2011,Pret A Manger,Eating Out,5,898
14,10,2011,ASDA,Groceries,89,809
14,10,2011,Starbucks Coffee,Eating Out,2,807
14,10,2011,The West Cornwall Pasty Company,Eating Out,5,802
15,10,2011,BRGAS-Electricity,Bills,26,776
15,10,2011,BRGAS-Gas,Bills,23,753
15,10,2011,Restaurant Gordon RamsayPortland Restaurant,Eating Out,37,716
16,10,2011,LBS Council Tax,Bills,50,666
16,10,2011,Restaurant Gordon RamsayPortland Restaurant,Eating Out,48,618
16,10,2011,Cheam Service Station,,9,609
17,10,2011,South West Trains,Transport,32,577
17,10,2011,Wild Bean Cafe,Eating Out,1,576
17,10,2011,Pret A Manger,Eating Out,8,568
18,10,2011,Greggs,Eating Out,8,560
19,10,2011,Caffe Nero,Eating Out,2,558
19,10,2011,Greggs,Eating Out,5,553
19,10,2011,ATM Cash Withdrawal,General,20,533
19,10,2011,Cheam Service Station,,4,529
20,10,2011,VIRGIN MEDIA PYMTS,Bills,33,496
20,10,2011,Costa Coffee,Eating Out,2,494
20,10,2011,Pret A Manger,Eating Out,7,487
20,10,2011,ATM Cash Withdrawal,General,10,477
21,10,2011,ASDA,Groceries,68,409
21,10,2011,Caffe Nero,Eating Out,1,408
21,10,2011,Greggs,Eating Out,4,404
23,10,2011,ATM Cash Withdrawal,General,10,394
23,10,2011,Civic Shop,,2,392
24,10,2011,O2,Bills,38,354
24,10,2011,South West Trains,Transport,34,320
24,10,2011,Caffe Nero,Eating Out,2,318
24,10,2011,Subway,Eating Out,5,313
25,10,2011,Starbucks Coffee,Eating Out,2,311
25,10,2011,Chicken Cottage,Eating Out,8,303
26,10,2011,McDonalds,Eating Out,8,295
27,10,2011,Starbucks Coffee,Eating Out,2,293
27,10,2011,Cheam Service Station,,6,287
28,10,2011,Sainsburys,Groceries,67,220
28,10,2011,Starbucks Coffee,Eating Out,1,219
28,10,2011,The West Cornwall Pasty Company,Eating Out,8,211
28,10,2011,ATM Cash Withdrawal,General,10,201
30,10,2011,ATM Cash Withdrawal,General,10,191
31,10,2011,South West Trains,Transport,24,167
31,10,2011,Starbucks Coffee,Eating Out,2,165
1,11,2011,Rhino Sports salary,General,1700,1865
1,11,2011,Wild Bean Cafe,Eating Out,2,1863
2,11,2011,Starbucks Coffee,Eating Out,2,1861
2,11,2011,The West Cornwall Pasty Company,Eating Out,4,1857
3,11,2011,Starbucks Coffee,Eating Out,2,1855
4,11,2011,Sainsburys,Groceries,76,1779
4,11,2011,Paying back Julie,,2,1777
7,11,2011,Cubit and West rent,Rent,550,1227
7,11,2011,South West Trains,Transport,33,1194
7,11,2011,Wild Bean Cafe,Eating Out,1,1193
8,11,2011,Caffe Nero,Eating Out,2,1191
8,11,2011,Tool Shop,,3,1188
9,11,2011,McDonalds,Eating Out,7,1181
10,11,2011,Starbucks Coffee,Eating Out,2,1179
11,11,2011,Sainsburys,Groceries,45,1134
11,11,2011,Caffe Nero,Eating Out,2,1132
11,11,2011,Subway,Eating Out,8,1124
11,11,2011,The Grand Pub,Eating Out,10,1114
11,11,2011,Pizza Express,Eating Out,58,1056
11,11,2011,Cheam Service Station,,8,1048
14,11,2011,South West Trains,Transport,27,1021
14,11,2011,Wild Bean Cafe,Eating Out,1,1020
14,11,2011,The West Cornwall Pasty Company,Eating Out,4,1016
14,11,2011,ATM Cash Withdrawal,General,20,996
14,11,2011,Civic Shop,,6,990
15,11,2011,BRGAS-Electricity,Bills,38,952
15,11,2011,BRGAS-Gas,Bills,69,883
15,11,2011,Wild Bean Cafe,Eating Out,2,881
15,11,2011,McDonalds,Eating Out,5,876
15,11,2011,ATM Cash Withdrawal,General,10,866
16,11,2011,LBS Council Tax,Bills,50,816
16,11,2011,Costa Coffee,Eating Out,2,814
17,11,2011,Caffe Nero,Eating Out,1,813
17,11,2011,Greggs,Eating Out,5,808
18,11,2011,Waitrose,Groceries,60,748
18,11,2011,Caffe Nero,Eating Out,2,746
20,11,2011,VIRGIN MEDIA PYMTS,Bills,34,712
20,11,2011,Red Shop,,1,711
21,11,2011,South West Trains,Transport,33,678
21,11,2011,Caffe Nero,Eating Out,2,676
21,11,2011,McDonalds,Eating Out,5,671
21,11,2011,ATM Cash Withdrawal,General,10,661
22,11,2011,Costa Coffee,Eating Out,2,659
23,11,2011,Wild Bean Cafe,Eating Out,1,658
23,11,2011,McDonalds,Eating Out,5,653
24,11,2011,O2,Bills,33,620
24,11,2011,McDonalds,Eating Out,8,612
25,11,2011,ASDA,Groceries,61,551
25,11,2011,Wild Bean Cafe,Eating Out,2,549
26,11,2011,Fabric Club,Eating Out,14,535
26,11,2011,Fabric Club,Eating Out,12,523
26,11,2011,Fabric Club,Eating Out,16,507
26,11,2011,Fabric Club,Eating Out,7,500
26,11,2011,Fabric Club,Eating Out,13,487
26,11,2011,Fabric Club,Eating Out,14,473
27,11,2011,Anglo restaurant,Eating Out,47,426
27,11,2011,ATM Cash Withdrawal,General,10,416
27,11,2011,Red Shop,,5,411
28,11,2011,South West Trains,Transport,36,375
28,11,2011,Caffe Nero,Eating Out,1,374
28,11,2011,Greggs,Eating Out,8,366
29,11,2011,Costa Coffee,Eating Out,2,364
29,11,2011,ATM Cash Withdrawal,General,10,354
30,11,2011,ATM Cash Withdrawal,General,10,344
1,12,2011,Rhino Sports salary,General,1700,2044
2,12,2011,Waitrose,Groceries,46,1998
2,12,2011,Starbucks Coffee,Eating Out,1,1997
2,12,2011,Subway,Eating Out,7,1990
2,12,2011,Dominos Pizza,Eating Out,32,1958
2,12,2011,ATM Cash Withdrawal,General,10,1948
3,12,2011,ATM Cash Withdrawal,General,20,1928
4,12,2011,Restaurant Gordon RamsayPortland Restaurant,Eating Out,57,1871
4,12,2011,ATM Cash Withdrawal,General,10,1861
5,12,2011,South West Trains,Transport,35,1826
5,12,2011,Costa Coffee,Eating Out,1,1825
5,12,2011,Greggs,Eating Out,5,1820
7,12,2011,Cubit and West rent,Rent,550,1270
7,12,2011,Caffe Nero,Eating Out,1,1269
7,12,2011,Pret A Manger,Eating Out,8,1261
8,12,2011,Caffe Nero,Eating Out,1,1260
8,12,2011,Pret A Manger,Eating Out,6,1254
9,12,2011,Tescos,Groceries,51,1203
9,12,2011,Wild Bean Cafe,Eating Out,1,1202
9,12,2011,Subway,Eating Out,6,1196
10,12,2011,Dominos Pizza,Eating Out,24,1172
12,12,2011,South West Trains,Transport,37,1135
12,12,2011,Subway,Eating Out,6,1129
13,12,2011,Caffe Nero,Eating Out,2,1127
14,12,2011,Starbucks Coffee,Eating Out,1,1126
14,12,2011,Chicken Cottage,Eating Out,8,1118
15,12,2011,BRGAS-Electricity,Bills,39,1079
15,12,2011,BRGAS-Gas,Bills,27,1052
15,12,2011,Starbucks Coffee,Eating Out,2,1050
16,12,2011,LBS Council Tax,Bills,50,1000
16,12,2011,Morrisons,Groceries,57,943
16,12,2011,Starbucks Coffee,Eating Out,1,942
16,12,2011,The West Cornwall Pasty Company,Eating Out,4,938
17,12,2011,ATM Cash Withdrawal,General,10,928
19,12,2011,South West Trains,Transport,24,904
19,12,2011,Costa Coffee,Eating Out,2,902
19,12,2011,Greggs,Eating Out,4,898
19,12,2011,ATM Cash Withdrawal,General,10,888
20,12,2011,VIRGIN MEDIA PYMTS,Bills,48,840
20,12,2011,Starbucks Coffee,Eating Out,1,839
20,12,2011,ATM Cash Withdrawal,General,10,829
21,12,2011,Starbucks Coffee,Eating Out,1,828
21,12,2011,Subway,Eating Out,5,823
23,12,2011,Waitrose,Groceries,69,754
23,12,2011,Costa Coffee,Eating Out,2,752
23,12,2011,Chicken Cottage,Eating Out,7,745
24,12,2011,O2,Bills,34,711
25,12,2011,Civic Shop,,2,709
26,12,2011,South West Trains,Transport,38,671
26,12,2011,Costa Coffee,Eating Out,2,669
27,12,2011,Wild Bean Cafe,Eating Out,2,667
28,12,2011,Wild Bean Cafe,Eating Out,2,665
28,12,2011,The West Cornwall Pasty Company,Eating Out,7,658
29,12,2011,Starbucks Coffee,Eating Out,2,656
29,12,2011,Pret A Manger,Eating Out,5,651
29,12,2011,ATM Cash Withdrawal,General,10,641
30,12,2011,Sainsburys,Groceries,72,569
30,12,2011,Costa Coffee,Eating Out,2,567
30,12,2011,Restaurant Gordon RamsayPortland Restaurant,Eating Out,46,521
31,12,2011,ATM Cash Withdrawal,General,10,511
1,1,2012,Rhino Sports salary,General,1700,2211
1,1,2012,Scott's Restaurant,Eating Out,45,2166
1,1,2012,ATM Cash Withdrawal,General,10,2156
2,1,2012,South West Trains,Transport,36,2120
2,1,2012,Caffe Nero,Eating Out,2,2118
2,1,2012,The West Cornwall Pasty Company,Eating Out,5,2113
3,1,2012,Wild Bean Cafe,Eating Out,2,2111
3,1,2012,Pret A Manger,Eating Out,5,2106
3,1,2012,Tool Tec,,6,2100
4,1,2012,Costa Coffee,Eating Out,1,2099
5,1,2012,Wild Bean Cafe,Eating Out,2,2097
6,1,2012,ASDA,Groceries,57,2040
6,1,2012,Restaurant Gordon RamsayPortland Restaurant,Eating Out,46,1994
7,1,2012,Cubit and West rent,Rent,550,1444
8,1,2012,Restaurant Gordon RamsayPortland Restaurant,Eating Out,25,1419
9,1,2012,South West Trains,Transport,35,1384
9,1,2012,Costa Coffee,Eating Out,1,1383
9,1,2012,Chicken Cottage,Eating Out,5,1378
9,1,2012,ATM Cash Withdrawal,General,20,1358
10,1,2012,Caffe Nero,Eating Out,1,1357
10,1,2012,Chicken Cottage,Eating Out,8,1349
10,1,2012,ATM Cash Withdrawal,General,20,1329
11,1,2012,Starbucks Coffee,Eating Out,2,1327
11,1,2012,Pret A Manger,Eating Out,7,1320
11,1,2012,ATM Cash Withdrawal,General,10,1310
12,1,2012,Subway,Eating Out,6,1304
13,1,2012,ASDA,Groceries,85,1219
13,1,2012,Caffe Nero,Eating Out,2,1217
13,1,2012,Dominos Pizza,Eating Out,35,1182
15,1,2012,BRGAS-Electricity,Bills,46,1136
15,1,2012,BRGAS-Gas,Bills,49,1087
15,1,2012,Dominos Pizza,Eating Out,27,1060
15,1,2012,ATM Cash Withdrawal,General,10,1050
15,1,2012,Cheam Service Station,,1,1049
16,1,2012,LBS Council Tax,Bills,50,999
16,1,2012,South West Trains,Transport,31,968
16,1,2012,Costa Coffee,Eating Out,2,966
16,1,2012,Pret A Manger,Eating Out,5,961
17,1,2012,Starbucks Coffee,Eating Out,2,959
18,1,2012,Wild Bean Cafe,Eating Out,2,957
19,1,2012,Caffe Nero,Eating Out,2,955
19,1,2012,The West Cornwall Pasty Company,Eating Out,6,949
19,1,2012,ATM Cash Withdrawal,General,20,929
19,1,2012,Cheam Service Station,,6,923
20,1,2012,VIRGIN MEDIA PYMTS,Bills,29,894
20,1,2012,ASDA,Groceries,51,843
20,1,2012,Wild Bean Cafe,Eating Out,1,842
20,1,2012,The West Cornwall Pasty Company,Eating Out,6,836
20,1,2012,Heaven Club,Eating Out,14,822
20,1,2012,Heaven Club,Eating Out,16,806
20,1,2012,Heaven Club,Eating Out,14,792
20,1,2012,Heaven Club,Eating Out,13,779
23,1,2012,South West Trains,Transport,35,744
23,1,2012,Wild Bean Cafe,Eating Out,1,743
23,1,2012,Greggs,Eating Out,5,738
24,1,2012,O2,Bills,31,707
24,1,2012,Costa Coffee,Eating Out,2,705
24,1,2012,Subway,Eating Out,5,700
24,1,2012,ATM Cash Withdrawal,General,20,680
24,1,2012,Paying back Julie,,9,671
25,1,2012,Wild Bean Cafe,Eating Out,1,670
25,1,2012,Pret A Manger,Eating Out,8,662
26,1,2012,Costa Coffee,Eating Out,2,660
26,1,2012,Chicken Cottage,Eating Out,6,654
27,1,2012,Waitrose,Groceries,48,606
27,1,2012,Wild Bean Cafe,Eating Out,2,604
27,1,2012,Greggs,Eating Out,7,597
27,1,2012,Restaurant Gordon RamsayPortland Restaurant,Eating Out,36,561
27,1,2012,Tool Shop,,1,560
29,1,2012,Anglo restaurant,Eating Out,26,534
30,1,2012,South West Trains,Transport,27,507
30,1,2012,Pret A Manger,Eating Out,8,499
30,1,2012,ATM Cash Withdrawal,General,20,479
31,1,2012,Chicken Cottage,Eating Out,6,473
31,1,2012,ATM Cash Withdrawal,General,20,453
1,2,2012,Rhino Sports salary,General,1700,2153
1,2,2012,The West Cornwall Pasty Company,Eating Out,8,2145
1,2,2012,ATM Cash Withdrawal,General,20,2125
2,2,2012,The West Cornwall Pasty Company,Eating Out,4,2121
2,2,2012,ATM Cash Withdrawal,General,10,2111
3,2,2012,Tescos,Groceries,52,2059
3,2,2012,Subway,Eating Out,6,2053
3,2,2012,Dominos Pizza,Eating Out,39,2014
4,2,2012,ATM Cash Withdrawal,General,20,1994
5,2,2012,ATM Cash Withdrawal,General,10,1984
5,2,2012,Red Shop,,8,1976
6,2,2012,South West Trains,Transport,38,1938
6,2,2012,Wild Bean Cafe,Eating Out,2,1936
6,2,2012,McDonalds,Eating Out,6,1930
7,2,2012,Cubit and West rent,Rent,550,1380
7,2,2012,Starbucks Coffee,Eating Out,2,1378
7,2,2012,McDonalds,Eating Out,4,1374
7,2,2012,ATM Cash Withdrawal,General,20,1354
8,2,2012,Starbucks Coffee,Eating Out,2,1352
9,2,2012,Costa Coffee,Eating Out,2,1350
9,2,2012,McDonalds,Eating Out,8,1342
10,2,2012,Tescos,Groceries,57,1285
10,2,2012,The Grand Pub,Eating Out,5,1280
10,2,2012,The Grand Pub,Eating Out,12,1268
12,2,2012,Dominos Pizza,Eating Out,37,1231
13,2,2012,South West Trains,Transport,32,1199
13,2,2012,Subway,Eating Out,7,1192
15,2,2012,BRGAS-Electricity,Bills,40,1152
15,2,2012,BRGAS-Gas,Bills,43,1109
15,2,2012,Chicken Cottage,Eating Out,8,1101
15,2,2012,Civic Shop,,8,1093
16,2,2012,LBS Council Tax,Bills,50,1043
16,2,2012,Costa Coffee,Eating Out,2,1041
16,2,2012,Pret A Manger,Eating Out,7,1034
17,2,2012,ASDA,Groceries,86,948
17,2,2012,Costa Coffee,Eating Out,2,946
17,2,2012,The West Cornwall Pasty Company,Eating Out,5,941
17,2,2012,ATM Cash Withdrawal,General,20,921
20,2,2012,VIRGIN MEDIA PYMTS,Bills,43,878
20,2,2012,South West Trains,Transport,28,850
20,2,2012,Starbucks Coffee,Eating Out,1,849
20,2,2012,McDonalds,Eating Out,4,845
21,2,2012,Costa Coffee,Eating Out,2,843
22,2,2012,Caffe Nero,Eating Out,2,841
23,2,2012,Costa Coffee,Eating Out,1,840
24,2,2012,O2,Bills,36,804
24,2,2012,Waitrose,Groceries,75,729
24,2,2012,Wild Bean Cafe,Eating Out,1,728
24,2,2012,ATM Cash Withdrawal,General,10,718
25,2,2012,Restaurant Gordon RamsayPortland Restaurant,Eating Out,54,664
26,2,2012,ATM Cash Withdrawal,General,20,644
26,2,2012,Paying back Julie,,8,636
27,2,2012,South West Trains,Transport,33,603
27,2,2012,Costa Coffee,Eating Out,1,602
27,2,2012,Chicken Cottage,Eating Out,4,598
28,2,2012,Starbucks Coffee,Eating Out,2,596
28,2,2012,Cheam Service Station,,8,588
29,2,2012,Subway,Eating Out,7,581
1,3,2012,Rhino Sports salary,General,1700,2281
1,3,2012,Pret A Manger,Eating Out,8,2273
2,3,2012,Sainsburys,Groceries,52,2221
2,3,2012,Costa Coffee,Eating Out,1,2220
2,3,2012,Greggs,Eating Out,8,2212
3,3,2012,Pizza Express,Eating Out,56,2156
4,3,2012,Dominos Pizza,Eating Out,49,2107
5,3,2012,South West Trains,Transport,28,2079
5,3,2012,Starbucks Coffee,Eating Out,2,2077
6,3,2012,Caffe Nero,Eating Out,2,2075
6,3,2012,McDonalds,Eating Out,4,2071
7,3,2012,Cubit and West rent,Rent,550,1521
7,3,2012,Caffe Nero,Eating Out,2,1519
7,3,2012,The West Cornwall Pasty Company,Eating Out,5,1514
7,3,2012,ATM Cash Withdrawal,General,10,1504
8,3,2012,Wild Bean Cafe,Eating Out,2,1502
8,3,2012,Subway,Eating Out,8,1494
9,3,2012,Morrisons,Groceries,73,1421
9,3,2012,Starbucks Coffee,Eating Out,2,1419
9,3,2012,Scott's Restaurant,Eating Out,36,1383
12,3,2012,South West Trains,Transport,38,1345
12,3,2012,Starbucks Coffee,Eating Out,2,1343
12,3,2012,Subway,Eating Out,7,1336
13,3,2012,Costa Coffee,Eating Out,1,1335
13,3,2012,Greggs,Eating Out,4,1331
14,3,2012,Wild Bean Cafe,Eating Out,1,1330
14,3,2012,Pret A Manger,Eating Out,4,1326
15,3,2012,BRGAS-Electricity,Bills,44,1282
15,3,2012,BRGAS-Gas,Bills,43,1239
15,3,2012,Costa Coffee,Eating Out,1,1238
15,3,2012,Chicken Cottage,Eating Out,4,1234
15,3,2012,ATM Cash Withdrawal,General,20,1214
15,3,2012,Paying back James,,5,1209
16,3,2012,LBS Council Tax,Bills,50,1159
16,3,2012,Morrisons,Groceries,89,1070
16,3,2012,Wild Bean Cafe,Eating Out,2,1068
16,3,2012,Greggs,Eating Out,8,1060
16,3,2012,Dominos Pizza,Eating Out,49,1011
17,3,2012,Scott's Restaurant,Eating Out,56,955
17,3,2012,ATM Cash Withdrawal,General,10,945
18,3,2012,Pizza Express,Eating Out,44,901
19,3,2012,South West Trains,Transport,35,866
19,3,2012,The West Cornwall Pasty Company,Eating Out,6,860
19,3,2012,ATM Cash Withdrawal,General,20,840
20,3,2012,VIRGIN MEDIA PYMTS,Bills,41,799
20,3,2012,The West Cornwall Pasty Company,Eating Out,8,791
20,3,2012,Paying back Julie,,3,788
21,3,2012,Caffe Nero,Eating Out,2,786
22,3,2012,Wild Bean Cafe,Eating Out,2,784
22,3,2012,Subway,Eating Out,6,778
23,3,2012,Morrisons,Groceries,79,699
23,3,2012,Costa Coffee,Eating Out,1,698
23,3,2012,Dominos Pizza,Eating Out,49,649
24,3,2012,O2,Bills,38,611
25,3,2012,Scott's Restaurant,Eating Out,56,555
26,3,2012,South West Trains,Transport,33,522
26,3,2012,Starbucks Coffee,Eating Out,2,520
26,3,2012,Subway,Eating Out,4,516
26,3,2012,ATM Cash Withdrawal,General,10,506
27,3,2012,Wild Bean Cafe,Eating Out,2,504
27,3,2012,Pret A Manger,Eating Out,6,498
27,3,2012,Tool Shop,,1,497
28,3,2012,Caffe Nero,Eating Out,2,495
29,3,2012,Wild Bean Cafe,Eating Out,1,494
29,3,2012,Chicken Cottage,Eating Out,8,486
30,3,2012,Waitrose,Groceries,69,417
30,3,2012,Costa Coffee,Eating Out,2,415
31,3,2012,Anglo restaurant,Eating Out,48,367
1,4,2012,Rhino Sports salary,General,1700,2067
1,4,2012,Dominos Pizza,Eating Out,30,2037
2,4,2012,South West Trains,Transport,30,2007
2,4,2012,Costa Coffee,Eating Out,2,2005
2,4,2012,McDonalds,Eating Out,5,2000
3,4,2012,Wild Bean Cafe,Eating Out,2,1998
3,4,2012,Subway,Eating Out,5,1993
4,4,2012,Costa Coffee,Eating Out,2,1991
4,4,2012,ATM Cash Withdrawal,General,10,1981
5,4,2012,Caffe Nero,Eating Out,2,1979
5,4,2012,Chicken Cottage,Eating Out,7,1972
6,4,2012,ASDA,Groceries,54,1918
6,4,2012,Caffe Nero,Eating Out,2,1916
6,4,2012,Chicken Cottage,Eating Out,8,1908
6,4,2012,Restaurant Gordon RamsayPortland Restaurant,Eating Out,31,1877
6,4,2012,Tool Tec,,2,1875
7,4,2012,Cubit and West rent,Rent,550,1325
7,4,2012,The Grand Pub,Eating Out,11,1314
7,4,2012,The Grand Pub,Eating Out,13,1301
7,4,2012,The Grand Pub,Eating Out,8,1293
7,4,2012,The Grand Pub,Eating Out,5,1288
7,4,2012,ATM Cash Withdrawal,General,20,1268
9,4,2012,South West Trains,Transport,38,1230
9,4,2012,Starbucks Coffee,Eating Out,2,1228
9,4,2012,Subway,Eating Out,4,1224
10,4,2012,Pret A Manger,Eating Out,5,1219
10,4,2012,ATM Cash Withdrawal,General,10,1209
11,4,2012,Caffe Nero,Eating Out,1,1208
12,4,2012,Caffe Nero,Eating Out,1,1207
12,4,2012,McDonalds,Eating Out,8,1199
12,4,2012,ATM Cash Withdrawal,General,10,1189
13,4,2012,ASDA,Groceries,56,1133
13,4,2012,Caffe Nero,Eating Out,2,1131
13,4,2012,McDonalds,Eating Out,4,1127
13,4,2012,Restaurant Gordon RamsayPortland Restaurant,Eating Out,25,1102
13,4,2012,ATM Cash Withdrawal,General,20,1082
14,4,2012,Scott's Restaurant,Eating Out,56,1026
15,4,2012,BRGAS-Electricity,Bills,35,991
15,4,2012,BRGAS-Gas,Bills,40,951
16,4,2012,LBS Council Tax,Bills,50,901
16,4,2012,South West Trains,Transport,30,871
16,4,2012,Costa Coffee,Eating Out,1,870
16,4,2012,Greggs,Eating Out,8,862
17,4,2012,Costa Coffee,Eating Out,2,860
17,4,2012,Pret A Manger,Eating Out,7,853
17,4,2012,ATM Cash Withdrawal,General,20,833
18,4,2012,Caffe Nero,Eating Out,2,831
18,4,2012,Pret A Manger,Eating Out,5,826
18,4,2012,Paying back Julie,,7,819
19,4,2012,Costa Coffee,Eating Out,1,818
19,4,2012,Greggs,Eating Out,7,811
19,4,2012,ATM Cash Withdrawal,General,20,791
19,4,2012,Paying back Julie,,6,785
20,4,2012,VIRGIN MEDIA PYMTS,Bills,39,746
20,4,2012,Sainsburys,Groceries,59,687
20,4,2012,Caffe Nero,Eating Out,2,685
20,4,2012,Pret A Manger,Eating Out,8,677
20,4,2012,Scott's Restaurant,Eating Out,56,621
22,4,2012,Restaurant Gordon RamsayPortland Restaurant,Eating Out,41,580
23,4,2012,South West Trains,Transport,32,548
23,4,2012,Starbucks Coffee,Eating Out,2,546
23,4,2012,The West Cornwall Pasty Company,Eating Out,6,540
24,4,2012,O2,Bills,34,506
24,4,2012,The West Cornwall Pasty Company,Eating Out,5,501
24,4,2012,Tool Shop,,8,493
25,4,2012,Starbucks Coffee,Eating Out,1,492
26,4,2012,Wild Bean Cafe,Eating Out,2,490
26,4,2012,Subway,Eating Out,6,484
26,4,2012,Tool Shop,,6,478
27,4,2012,Waitrose,Groceries,86,392
27,4,2012,Wild Bean Cafe,Eating Out,2,390
27,4,2012,Greggs,Eating Out,4,386
27,4,2012,Pizza Express,Eating Out,50,336
29,4,2012,Scott's Restaurant,Eating Out,49,287
29,4,2012,Civic Shop,,8,279
30,4,2012,South West Trains,Transport,35,244
30,4,2012,McDonalds,Eating Out,4,240
30,4,2012,Cheam Service Station,,5,235
1,5,2012,Rhino Sports salary,General,1700,1935
1,5,2012,Pret A Manger,Eating Out,4,1931
2,5,2012,Caffe Nero,Eating Out,2,1929
2,5,2012,Chicken Cottage,Eating Out,6,1923
3,5,2012,Starbucks Coffee,Eating Out,1,1922
3,5,2012,Greggs,Eating Out,6,1916
4,5,2012,ASDA,Groceries,76,1840
4,5,2012,Wild Bean Cafe,Eating Out,2,1838
4,5,2012,Pizza Express,Eating Out,53,1785
4,5,2012,ATM Cash Withdrawal,General,20,1765
4,5,2012,Civic Shop,,4,1761
7,5,2012,Cubit and West rent,Rent,550,1211
7,5,2012,South West Trains,Transport,38,1173
8,5,2012,Costa Coffee,Eating Out,2,1171
8,5,2012,Chicken Cottage,Eating Out,6,1165
9,5,2012,Costa Coffee,Eating Out,1,1164
10,5,2012,Caffe Nero,Eating Out,2,1162
10,5,2012,Subway,Eating Out,6,1156
10,5,2012,Civic Shop,,7,1149
11,5,2012,Waitrose,Groceries,45,1104
11,5,2012,Wild Bean Cafe,Eating Out,2,1102
11,5,2012,Fabric Club,Eating Out,15,1087
11,5,2012,ATM Cash Withdrawal,General,20,1067
12,5,2012,Scott's Restaurant,Eating Out,39,1028
14,5,2012,South West Trains,Transport,34,994
14,5,2012,Costa Coffee,Eating Out,2,992
15,5,2012,BRGAS-Electricity,Bills,28,964
15,5,2012,BRGAS-Gas,Bills,31,933
15,5,2012,Greggs,Eating Out,8,925
15,5,2012,ATM Cash Withdrawal,General,20,905
16,5,2012,LBS Council Tax,Bills,50,855
16,5,2012,Caffe Nero,Eating Out,2,853
16,5,2012,McDonalds,Eating Out,8,845
17,5,2012,Wild Bean Cafe,Eating Out,2,843
18,5,2012,Sainsburys,Groceries,85,758
18,5,2012,Starbucks Coffee,Eating Out,2,756
20,5,2012,VIRGIN MEDIA PYMTS,Bills,36,720
20,5,2012,Anglo restaurant,Eating Out,35,685
20,5,2012,ATM Cash Withdrawal,General,10,675
20,5,2012,Tool Shop,,6,669
21,5,2012,South West Trains,Transport,25,644
21,5,2012,Pret A Manger,Eating Out,8,636
22,5,2012,Starbucks Coffee,Eating Out,1,635
22,5,2012,McDonalds,Eating Out,6,629
22,5,2012,Paying back James,,8,621
23,5,2012,Caffe Nero,Eating Out,2,619
23,5,2012,ATM Cash Withdrawal,General,20,599
24,5,2012,O2,Bills,35,564
24,5,2012,Costa Coffee,Eating Out,2,562
24,5,2012,Chicken Cottage,Eating Out,6,556
25,5,2012,Morrisons,Groceries,84,472
25,5,2012,Costa Coffee,Eating Out,2,470
25,5,2012,Greggs,Eating Out,8,462
25,5,2012,Pizza Express,Eating Out,57,405
25,5,2012,Cheam Service Station,,9,396
26,5,2012,Scott's Restaurant,Eating Out,33,363
26,5,2012,ATM Cash Withdrawal,General,20,343
27,5,2012,Tool Tec,,8,335
28,5,2012,South West Trains,Transport,30,305
29,5,2012,Costa Coffee,Eating Out,1,304
29,5,2012,Chicken Cottage,Eating Out,5,299
30,5,2012,Costa Coffee,Eating Out,1,298
31,5,2012,Starbucks Coffee,Eating Out,2,296
31,5,2012,Subway,Eating Out,6,290
31,5,2012,Paying back Julie,,7,283
1,6,2012,Rhino Sports salary,General,1700,1983
1,6,2012,Morrisons,Groceries,76,1907
1,6,2012,Subway,Eating Out,6,1901
1,6,2012,Scott's Restaurant,Eating Out,29,1872
2,6,2012,Dominos Pizza,Eating Out,40,1832
2,6,2012,ATM Cash Withdrawal,General,10,1822
3,6,2012,ATM Cash Withdrawal,General,10,1812
4,6,2012,South West Trains,Transport,37,1775
4,6,2012,Greggs,Eating Out,6,1769
5,6,2012,Caffe Nero,Eating Out,2,1767
5,6,2012,Pret A Manger,Eating Out,5,1762
6,6,2012,Wild Bean Cafe,Eating Out,2,1760
7,6,2012,Cubit and West rent,Rent,550,1210
8,6,2012,Morrisons,Groceries,44,1166
8,6,2012,Caffe Nero,Eating Out,1,1165
8,6,2012,Subway,Eating Out,8,1157
8,6,2012,Fabric Club,Eating Out,14,1143
8,6,2012,Fabric Club,Eating Out,15,1128
8,6,2012,Fabric Club,Eating Out,7,1121
8,6,2012,ATM Cash Withdrawal,General,20,1101
8,6,2012,Tool Tec,,1,1100
9,6,2012,Heaven Club,Eating Out,5,1095
9,6,2012,Heaven Club,Eating Out,14,1081
9,6,2012,Heaven Club,Eating Out,11,1070
9,6,2012,Heaven Club,Eating Out,12,1058
9,6,2012,Heaven Club,Eating Out,7,1051
9,6,2012,Heaven Club,Eating Out,7,1044
10,6,2012,ATM Cash Withdrawal,General,20,1024
11,6,2012,South West Trains,Transport,26,998
11,6,2012,Caffe Nero,Eating Out,2,996
11,6,2012,Greggs,Eating Out,8,988
12,6,2012,Costa Coffee,Eating Out,1,987
13,6,2012,Costa Coffee,Eating Out,2,985
13,6,2012,Pret A Manger,Eating Out,5,980
15,6,2012,BRGAS-Electricity,Bills,30,950
15,6,2012,BRGAS-Gas,Bills,36,914
15,6,2012,Morrisons,Groceries,50,864
15,6,2012,Costa Coffee,Eating Out,1,863
15,6,2012,Greggs,Eating Out,7,856
15,6,2012,Restaurant Gordon RamsayPortland Restaurant,Eating Out,58,798
15,6,2012,ATM Cash Withdrawal,General,20,778
16,6,2012,LBS Council Tax,Bills,50,728
16,6,2012,ATM Cash Withdrawal,General,10,718
16,6,2012,Cheam Service Station,,9,709
17,6,2012,Civic Shop,,3,706
18,6,2012,South West Trains,Transport,37,669
18,6,2012,Caffe Nero,Eating Out,1,668
18,6,2012,McDonalds,Eating Out,7,661
18,6,2012,ATM Cash Withdrawal,General,10,651
18,6,2012,Civic Shop,,7,644
19,6,2012,Caffe Nero,Eating Out,2,642
19,6,2012,Subway,Eating Out,6,636
20,6,2012,VIRGIN MEDIA PYMTS,Bills,43,593
20,6,2012,Wild Bean Cafe,Eating Out,2,591
20,6,2012,McDonalds,Eating Out,5,586
20,6,2012,Tool Tec,,8,578
21,6,2012,Costa Coffee,Eating Out,1,577
21,6,2012,Greggs,Eating Out,6,571
21,6,2012,ATM Cash Withdrawal,General,20,551
22,6,2012,ASDA,Groceries,70,481
22,6,2012,Starbucks Coffee,Eating Out,1,480
22,6,2012,ATM Cash Withdrawal,General,10,470
24,6,2012,O2,Bills,31,439
25,6,2012,South West Trains,Transport,36,403
25,6,2012,Costa Coffee,Eating Out,2,401
25,6,2012,Civic Shop,,8,393
26,6,2012,Costa Coffee,Eating Out,2,391
26,6,2012,McDonalds,Eating Out,7,384
27,6,2012,Wild Bean Cafe,Eating Out,2,382
27,6,2012,Greggs,Eating Out,4,378
28,6,2012,Wild Bean Cafe,Eating Out,2,376
29,6,2012,Sainsburys,Groceries,46,330
29,6,2012,Costa Coffee,Eating Out,2,328
29,6,2012,Pret A Manger,Eating Out,5,323
29,6,2012,Anglo restaurant,Eating Out,55,268
29,6,2012,ATM Cash Withdrawal,General,20,248
30,6,2012,Ministry of Sound ClubXOYO Club,Eating Out,8,240
30,6,2012,Ministry of Sound ClubXOYO Club,Eating Out,15,225
30,6,2012,Ministry of Sound ClubXOYO Club,Eating Out,7,218
30,6,2012,Ministry of Sound ClubXOYO Club,Eating Out,7,211
30,6,2012,Anglo restaurant,Eating Out,48,163
30,6,2012,Paying back James,,9,154
1,7,2012,Rhino Sports salary,General,1700,1854
1,7,2012,Dominos Pizza,Eating Out,26,1828
1,7,2012,Tool Shop,,6,1822
2,7,2012,South West Trains,Transport,33,1789
2,7,2012,Starbucks Coffee,Eating Out,2,1787
3,7,2012,Wild Bean Cafe,Eating Out,2,1785
3,7,2012,Pret A Manger,Eating Out,8,1777
3,7,2012,ATM Cash Withdrawal,General,10,1767
4,7,2012,Greggs,Eating Out,8,1759
4,7,2012,Tool Tec,,5,1754
5,7,2012,Wild Bean Cafe,Eating Out,2,1752
5,7,2012,Chicken Cottage,Eating Out,4,1748
6,7,2012,Tescos,Groceries,83,1665
6,7,2012,Caffe Nero,Eating Out,1,1664
6,7,2012,Restaurant Gordon RamsayPortland Restaurant,Eating Out,49,1615
6,7,2012,ATM Cash Withdrawal,General,20,1595
7,7,2012,Cubit and West rent,Rent,550,1045
8,7,2012,Dominos Pizza,Eating Out,28,1017
9,7,2012,South West Trains,Transport,29,988
9,7,2012,Caffe Nero,Eating Out,2,986
10,7,2012,Wild Bean Cafe,Eating Out,1,985
10,7,2012,Greggs,Eating Out,5,980
10,7,2012,Tool Shop,,5,975
11,7,2012,Costa Coffee,Eating Out,2,973
11,7,2012,Pret A Manger,Eating Out,6,967
11,7,2012,ATM Cash Withdrawal,General,10,957
11,7,2012,Tool Shop,,2,955
12,7,2012,Costa Coffee,Eating Out,2,953
12,7,2012,The West Cornwall Pasty Company,Eating Out,4,949
13,7,2012,Waitrose,Groceries,80,869
13,7,2012,Starbucks Coffee,Eating Out,1,868
13,7,2012,Chicken Cottage,Eating Out,8,860
13,7,2012,ATM Cash Withdrawal,General,20,840
14,7,2012,Dominos Pizza,Eating Out,43,797
14,7,2012,ATM Cash Withdrawal,General,20,777
15,7,2012,BRGAS-Electricity,Bills,23,754
15,7,2012,BRGAS-Gas,Bills,30,724
16,7,2012,LBS Council Tax,Bills,50,674
16,7,2012,South West Trains,Transport,35,639
17,7,2012,Caffe Nero,Eating Out,1,638
17,7,2012,ATM Cash Withdrawal,General,20,618
17,7,2012,Red Shop,,2,616
18,7,2012,Wild Bean Cafe,Eating Out,2,614
18,7,2012,Pret A Manger,Eating Out,8,606
19,7,2012,Wild Bean Cafe,Eating Out,1,605
20,7,2012,VIRGIN MEDIA PYMTS,Bills,31,574
20,7,2012,Waitrose,Groceries,87,487
20,7,2012,Wild Bean Cafe,Eating Out,2,485
20,7,2012,McDonalds,Eating Out,8,477
20,7,2012,ATM Cash Withdrawal,General,10,467
23,7,2012,South West Trains,Transport,27,440
23,7,2012,Pret A Manger,Eating Out,8,432
23,7,2012,Tool Tec,,9,423
24,7,2012,O2,Bills,34,389
24,7,2012,Caffe Nero,Eating Out,2,387
25,7,2012,Starbucks Coffee,Eating Out,2,385
25,7,2012,Greggs,Eating Out,6,379
26,7,2012,Wild Bean Cafe,Eating Out,1,378
27,7,2012,ASDA,Groceries,42,336
27,7,2012,Caffe Nero,Eating Out,2,334
27,7,2012,Pret A Manger,Eating Out,5,329
27,7,2012,Pizza Express,Eating Out,53,276
30,7,2012,South West Trains,Transport,38,238
30,7,2012,Greggs,Eating Out,6,232
30,7,2012,ATM Cash Withdrawal,General,10,222
31,7,2012,Chicken Cottage,Eating Out,7,215
1,8,2012,Rhino Sports salary,General,1700,1915
1,8,2012,Costa Coffee,Eating Out,2,1913
2,8,2012,Costa Coffee,Eating Out,1,1912
2,8,2012,Greggs,Eating Out,6,1906
3,8,2012,Morrisons,Groceries,71,1835
3,8,2012,McDonalds,Eating Out,8,1827
3,8,2012,Anglo restaurant,Eating Out,37,1790
3,8,2012,ATM Cash Withdrawal,General,20,1770
4,8,2012,Tool Tec,,4,1766
5,8,2012,Anglo restaurant,Eating Out,59,1707
5,8,2012,ATM Cash Withdrawal,General,20,1687
5,8,2012,Paying back James,,1,1686
6,8,2012,South West Trains,Transport,37,1649
6,8,2012,The West Cornwall Pasty Company,Eating Out,5,1644
7,8,2012,Cubit and West rent,Rent,550,1094
7,8,2012,Wild Bean Cafe,Eating Out,2,1092
7,8,2012,Chicken Cottage,Eating Out,5,1087
8,8,2012,Wild Bean Cafe,Eating Out,1,1086
8,8,2012,Chicken Cottage,Eating Out,4,1082
9,8,2012,Starbucks Coffee,Eating Out,2,1080
9,8,2012,Pret A Manger,Eating Out,4,1076
10,8,2012,Sainsburys,Groceries,66,1010
10,8,2012,Costa Coffee,Eating Out,1,1009
10,8,2012,Subway,Eating Out,5,1004
10,8,2012,ATM Cash Withdrawal,General,20,984
11,8,2012,Fabric Club,Eating Out,9,975
11,8,2012,Fabric Club,Eating Out,7,968
11,8,2012,Fabric Club,Eating Out,16,952
11,8,2012,Fabric Club,Eating Out,11,941
11,8,2012,Fabric Club,Eating Out,10,931
12,8,2012,Pizza Express,Eating Out,38,893
13,8,2012,South West Trains,Transport,35,858
13,8,2012,Caffe Nero,Eating Out,1,857
13,8,2012,ATM Cash Withdrawal,General,10,847
14,8,2012,Costa Coffee,Eating Out,2,845
14,8,2012,Subway,Eating Out,6,839
14,8,2012,ATM Cash Withdrawal,General,10,829
15,8,2012,BRGAS-Electricity,Bills,28,801
15,8,2012,BRGAS-Gas,Bills,28,773
15,8,2012,Wild Bean Cafe,Eating Out,1,772
15,8,2012,The West Cornwall Pasty Company,Eating Out,5,767
15,8,2012,Paying back James,,6,761
16,8,2012,LBS Council Tax,Bills,50,711
16,8,2012,Starbucks Coffee,Eating Out,1,710
16,8,2012,McDonalds,Eating Out,7,703
16,8,2012,Paying back James,,3,700
17,8,2012,Sainsburys,Groceries,57,643
17,8,2012,Scott's Restaurant,Eating Out,49,594
18,8,2012,Anglo restaurant,Eating Out,51,543
20,8,2012,VIRGIN MEDIA PYMTS,Bills,48,495
20,8,2012,South West Trains,Transport,24,471
20,8,2012,Wild Bean Cafe,Eating Out,1,470
20,8,2012,McDonalds,Eating Out,7,463
21,8,2012,Costa Coffee,Eating Out,1,462
21,8,2012,Chicken Cottage,Eating Out,4,458
22,8,2012,ATM Cash Withdrawal,General,10,448
23,8,2012,Starbucks Coffee,Eating Out,2,446
23,8,2012,ATM Cash Withdrawal,General,20,426
24,8,2012,O2,Bills,36,390
24,8,2012,Tescos,Groceries,67,323
24,8,2012,Caffe Nero,Eating Out,1,322
25,8,2012,Dominos Pizza,Eating Out,55,267
25,8,2012,Tool Shop,,9,258
27,8,2012,South West Trains,Transport,33,225
27,8,2012,Caffe Nero,Eating Out,1,224
27,8,2012,McDonalds,Eating Out,7,217
28,8,2012,Greggs,Eating Out,5,212
29,8,2012,Costa Coffee,Eating Out,2,210
29,8,2012,Paying back James,,6,204
30,8,2012,Caffe Nero,Eating Out,2,202
31,8,2012,Tescos,Groceries,45,157
31,8,2012,Caffe Nero,Eating Out,2,155
31,8,2012,Subway,Eating Out,7,148
31,8,2012,Heaven Club,Eating Out,13,135
31,8,2012,Heaven Club,Eating Out,15,120
31,8,2012,Heaven Club,Eating Out,11,109
31,8,2012,Heaven Club,Eating Out,13,96
31,8,2012,Restaurant Gordon RamsayPortland Restaurant,Eating Out,46,50
1,9,2012,Rhino Sports salary,General,1700,1750
1,9,2012,Restaurant Gordon RamsayPortland Restaurant,Eating Out,41,1709
2,9,2012,Restaurant Gordon RamsayPortland Restaurant,Eating Out,24,1685
2,9,2012,ATM Cash Withdrawal,General,20,1665
3,9,2012,South West Trains,Transport,29,1636
3,9,2012,Wild Bean Cafe,Eating Out,2,1634
3,9,2012,Pret A Manger,Eating Out,6,1628
3,9,2012,ATM Cash Withdrawal,General,10,1618
4,9,2012,McDonalds,Eating Out,4,1614
5,9,2012,Costa Coffee,Eating Out,1,1613
6,9,2012,The West Cornwall Pasty Company,Eating Out,6,1607
6,9,2012,ATM Cash Withdrawal,General,10,1597
7,9,2012,Cubit and West rent,Rent,550,1047
7,9,2012,ASDA,Groceries,66,981
7,9,2012,Costa Coffee,Eating Out,2,979
8,9,2012,ATM Cash Withdrawal,General,10,969
8,9,2012,Civic Shop,,9,960
9,9,2012,ATM Cash Withdrawal,General,10,950
10,9,2012,South West Trains,Transport,26,924
10,9,2012,Starbucks Coffee,Eating Out,2,922
10,9,2012,Subway,Eating Out,8,914
10,9,2012,ATM Cash Withdrawal,General,10,904
11,9,2012,Costa Coffee,Eating Out,2,902
11,9,2012,The West Cornwall Pasty Company,Eating Out,6,896
11,9,2012,Red Shop,,6,890
12,9,2012,Starbucks Coffee,Eating Out,1,889
12,9,2012,Chicken Cottage,Eating Out,8,881
13,9,2012,Subway,Eating Out,6,875
14,9,2012,Waitrose,Groceries,44,831
14,9,2012,Caffe Nero,Eating Out,2,829
14,9,2012,Chicken Cottage,Eating Out,6,823
14,9,2012,Red Shop,,5,818
15,9,2012,BRGAS-Electricity,Bills,35,783
15,9,2012,BRGAS-Gas,Bills,32,751
15,9,2012,Red Shop,,6,745
16,9,2012,LBS Council Tax,Bills,50,695
17,9,2012,South West Trains,Transport,36,659
17,9,2012,Caffe Nero,Eating Out,2,657
17,9,2012,Pret A Manger,Eating Out,4,653
17,9,2012,ATM Cash Withdrawal,General,10,643
18,9,2012,Caffe Nero,Eating Out,2,641
18,9,2012,The West Cornwall Pasty Company,Eating Out,6,635
18,9,2012,ATM Cash Withdrawal,General,20,615
19,9,2012,Caffe Nero,Eating Out,1,614
19,9,2012,McDonalds,Eating Out,6,608
20,9,2012,VIRGIN MEDIA PYMTS,Bills,38,570
20,9,2012,Wild Bean Cafe,Eating Out,1,569
20,9,2012,Chicken Cottage,Eating Out,8,561
20,9,2012,ATM Cash Withdrawal,General,10,551
21,9,2012,Waitrose,Groceries,85,466
21,9,2012,Caffe Nero,Eating Out,2,464
21,9,2012,Greggs,Eating Out,5,459
21,9,2012,The Grand Pub,Eating Out,12,447
21,9,2012,The Grand Pub,Eating Out,6,441
21,9,2012,The Grand Pub,Eating Out,10,431
21,9,2012,The Grand Pub,Eating Out,10,421
23,9,2012,Anglo restaurant,Eating Out,44,377
24,9,2012,O2,Bills,33,344
24,9,2012,South West Trains,Transport,33,311
24,9,2012,Starbucks Coffee,Eating Out,2,309
24,9,2012,The West Cornwall Pasty Company,Eating Out,4,305
24,9,2012,ATM Cash Withdrawal,General,10,295
25,9,2012,Costa Coffee,Eating Out,2,293
25,9,2012,Subway,Eating Out,7,286
25,9,2012,ATM Cash Withdrawal,General,20,266
26,9,2012,Wild Bean Cafe,Eating Out,2,264
27,9,2012,Costa Coffee,Eating Out,2,262
28,9,2012,Tescos,Groceries,63,199
28,9,2012,Starbucks Coffee,Eating Out,2,197
28,9,2012,The West Cornwall Pasty Company,Eating Out,4,193
28,9,2012,ATM Cash Withdrawal,General,20,173
29,9,2012,Ministry of Sound ClubXOYO Club,Eating Out,6,167
29,9,2012,Ministry of Sound ClubXOYO Club,Eating Out,11,156
29,9,2012,Ministry of Sound ClubXOYO Club,Eating Out,11,145
29,9,2012,Ministry of Sound ClubXOYO Club,Eating Out,5,140
29,9,2012,Ministry of Sound ClubXOYO Club,Eating Out,11,129
29,9,2012,Ministry of Sound ClubXOYO Club,Eating Out,6,123
29,9,2012,Pizza Express,Eating Out,37,86
1,10,2012,Rhino Sports salary,General,1700,1786
1,10,2012,South West Trains,Transport,27,1759
1,10,2012,Costa Coffee,Eating Out,2,1757
1,10,2012,Greggs,Eating Out,5,1752
1,10,2012,Paying back James,,6,1746
2,10,2012,Wild Bean Cafe,Eating Out,2,1744
2,10,2012,The West Cornwall Pasty Company,Eating Out,6,1738
3,10,2012,Wild Bean Cafe,Eating Out,1,1737
3,10,2012,McDonalds,Eating Out,6,1731
4,10,2012,Subway,Eating Out,7,1724
5,10,2012,Tescos,Groceries,42,1682
5,10,2012,Wild Bean Cafe,Eating Out,1,1681
5,10,2012,Heaven Club,Eating Out,5,1676
5,10,2012,Heaven Club,Eating Out,10,1666
5,10,2012,Heaven Club,Eating Out,13,1653
5,10,2012,Heaven Club,Eating Out,16,1637
5,10,2012,Heaven Club,Eating Out,11,1626
6,10,2012,Scott's Restaurant,Eating Out,53,1573
7,10,2012,Cubit and West rent,Rent,550,1023
7,10,2012,Pizza Express,Eating Out,54,969
7,10,2012,ATM Cash Withdrawal,General,10,959
8,10,2012,South West Trains,Transport,29,930
8,10,2012,Starbucks Coffee,Eating Out,2,928
8,10,2012,The West Cornwall Pasty Company,Eating Out,5,923
9,10,2012,Starbucks Coffee,Eating Out,1,922
9,10,2012,Chicken Cottage,Eating Out,6,916
10,10,2012,Costa Coffee,Eating Out,1,915
10,10,2012,McDonalds,Eating Out,6,909
10,10,2012,ATM Cash Withdrawal,General,10,899
11,10,2012,Costa Coffee,Eating Out,2,897
11,10,2012,ATM Cash Withdrawal,General,20,877
12,10,2012,Tescos,Groceries,66,811
12,10,2012,Costa Coffee,Eating Out,2,809
12,10,2012,McDonalds,Eating Out,8,801
13,10,2012,Scott's Restaurant,Eating Out,25,776
13,10,2012,ATM Cash Withdrawal,General,10,766
15,10,2012,BRGAS-Electricity,Bills,36,730
15,10,2012,BRGAS-Gas,Bills,21,709
15,10,2012,South West Trains,Transport,37,672
15,10,2012,Wild Bean Cafe,Eating Out,1,671
16,10,2012,LBS Council Tax,Bills,50,621
16,10,2012,Wild Bean Cafe,Eating Out,2,619
17,10,2012,Starbucks Coffee,Eating Out,2,617
17,10,2012,Greggs,Eating Out,5,612
18,10,2012,Wild Bean Cafe,Eating Out,2,610
18,10,2012,ATM Cash Withdrawal,General,20,590
18,10,2012,Cheam Service Station,,9,581
19,10,2012,Morrisons,Groceries,43,538
19,10,2012,Costa Coffee,Eating Out,2,536
19,10,2012,Ministry of Sound ClubXOYO Club,Eating Out,10,526
19,10,2012,Ministry of Sound ClubXOYO Club,Eating Out,13,513
19,10,2012,Ministry of Sound ClubXOYO Club,Eating Out,10,503
19,10,2012,Ministry of Sound ClubXOYO Club,Eating Out,10,493
20,10,2012,VIRGIN MEDIA PYMTS,Bills,41,452
20,10,2012,Tool Shop,,4,448
22,10,2012,South West Trains,Transport,37,411
22,10,2012,Caffe Nero,Eating Out,2,409
22,10,2012,Greggs,Eating Out,5,404
22,10,2012,Paying back Julie,,2,402
23,10,2012,Starbucks Coffee,Eating Out,1,401
23,10,2012,Pret A Manger,Eating Out,8,393
23,10,2012,ATM Cash Withdrawal,General,20,373
23,10,2012,Paying back Julie,,2,371
24,10,2012,O2,Bills,36,335
24,10,2012,Caffe Nero,Eating Out,2,333
24,10,2012,Subway,Eating Out,7,326
24,10,2012,Tool Shop,,9,317
25,10,2012,Wild Bean Cafe,Eating Out,2,315
25,10,2012,Subway,Eating Out,6,309
26,10,2012,Sainsburys,Groceries,43,266
26,10,2012,Costa Coffee,Eating Out,1,265
26,10,2012,McDonalds,Eating Out,6,259
26,10,2012,Pizza Express,Eating Out,24,235
27,10,2012,ATM Cash Withdrawal,General,10,225
28,10,2012,Pizza Express,Eating Out,47,178
28,10,2012,ATM Cash Withdrawal,General,20,158
29,10,2012,South West Trains,Transport,29,129
29,10,2012,Starbucks Coffee,Eating Out,2,127
29,10,2012,McDonalds,Eating Out,7,120
30,10,2012,Costa Coffee,Eating Out,1,119
31,10,2012,Wild Bean Cafe,Eating Out,2,117
31,10,2012,The West Cornwall Pasty Company,Eating Out,4,113
31,10,2012,Cheam Service Station,,9,104
1,11,2012,Rhino Sports salary,General,1700,1804
1,11,2012,Starbucks Coffee,Eating Out,2,1802
1,11,2012,Paying back James,,5,1797
2,11,2012,Waitrose,Groceries,53,1744
2,11,2012,Caffe Nero,Eating Out,2,1742
2,11,2012,Dominos Pizza,Eating Out,48,1694
2,11,2012,ATM Cash Withdrawal,General,10,1684
3,11,2012,Anglo restaurant,Eating Out,54,1630
3,11,2012,Tool Shop,,4,1626
4,11,2012,Anglo restaurant,Eating Out,33,1593
5,11,2012,South West Trains,Transport,36,1557
5,11,2012,Costa Coffee,Eating Out,1,1556
6,11,2012,Wild Bean Cafe,Eating Out,2,1554
6,11,2012,Chicken Cottage,Eating Out,5,1549
7,11,2012,Cubit and West rent,Rent,550,999
7,11,2012,Starbucks Coffee,Eating Out,1,998
7,11,2012,Subway,Eating Out,8,990
8,11,2012,Wild Bean Cafe,Eating Out,1,989
8,11,2012,Subway,Eating Out,7,982
8,11,2012,ATM Cash Withdrawal,General,20,962
9,11,2012,ASDA,Groceries,88,874
9,11,2012,Starbucks Coffee,Eating Out,1,873
9,11,2012,Anglo restaurant,Eating Out,50,823
10,11,2012,Restaurant Gordon RamsayPortland Restaurant,Eating Out,53,770
11,11,2012,Anglo restaurant,Eating Out,55,715
11,11,2012,ATM Cash Withdrawal,General,10,705
12,11,2012,South West Trains,Transport,38,667
12,11,2012,Costa Coffee,Eating Out,2,665
12,11,2012,Chicken Cottage,Eating Out,6,659
12,11,2012,ATM Cash Withdrawal,General,10,649
13,11,2012,Starbucks Coffee,Eating Out,1,648
14,11,2012,Starbucks Coffee,Eating Out,2,646
15,11,2012,BRGAS-Electricity,Bills,94,552
15,11,2012,BRGAS-Gas,Bills,46,506
15,11,2012,Greggs,Eating Out,4,502
16,11,2012,LBS Council Tax,Bills,50,452
16,11,2012,Morrisons,Groceries,80,372
16,11,2012,Costa Coffee,Eating Out,2,370
19,11,2012,South West Trains,Transport,28,342
19,11,2012,Costa Coffee,Eating Out,2,340
19,11,2012,Greggs,Eating Out,7,333
19,11,2012,ATM Cash Withdrawal,General,20,313
20,11,2012,VIRGIN MEDIA PYMTS,Bills,41,272
20,11,2012,Caffe Nero,Eating Out,2,270
20,11,2012,The West Cornwall Pasty Company,Eating Out,8,262
20,11,2012,ATM Cash Withdrawal,General,20,242
21,11,2012,Caffe Nero,Eating Out,2,240
21,11,2012,The West Cornwall Pasty Company,Eating Out,8,232
21,11,2012,ATM Cash Withdrawal,General,20,212
22,11,2012,Caffe Nero,Eating Out,2,210
22,11,2012,Subway,Eating Out,7,203
22,11,2012,ATM Cash Withdrawal,General,10,193
22,11,2012,Red Shop,,9,184
23,11,2012,Tescos,Groceries,61,123
23,11,2012,Greggs,Eating Out,6,117
24,11,2012,O2,Bills,34,83
24,11,2012,Ministry of Sound ClubXOYO Club,Eating Out,8,75
24,11,2012,Ministry of Sound ClubXOYO Club,Eating Out,10,65
24,11,2012,Ministry of Sound ClubXOYO Club,Eating Out,16,49
24,11,2012,Ministry of Sound ClubXOYO Club,Eating Out,7,42
24,11,2012,Restaurant Gordon RamsayPortland Restaurant,Eating Out,34,8
25,11,2012,Scott's Restaurant,Eating Out,44,-36
26,11,2012,South West Trains,Transport,24,-60
26,11,2012,Starbucks Coffee,Eating Out,1,-61
26,11,2012,Pret A Manger,Eating Out,8,-69
27,11,2012,Starbucks Coffee,Eating Out,2,-71
27,11,2012,ATM Cash Withdrawal,General,10,-81
28,11,2012,Costa Coffee,Eating Out,2,-83
29,11,2012,Greggs,Eating Out,5,-88
29,11,2012,ATM Cash Withdrawal,General,20,-108
29,11,2012,Red Shop,,5,-113
30,11,2012,ASDA,Groceries,50,-163
30,11,2012,Pret A Manger,Eating Out,6,-169
30,11,2012,Scott's Restaurant,Eating Out,58,-227
1,12,2012,Rhino Sports salary,General,1700,1473
3,12,2012,South West Trains,Transport,29,1444
3,12,2012,Caffe Nero,Eating Out,1,1443
3,12,2012,Greggs,Eating Out,8,1435
3,12,2012,ATM Cash Withdrawal,General,10,1425
4,12,2012,Costa Coffee,Eating Out,2,1423
5,12,2012,Caffe Nero,Eating Out,2,1421
6,12,2012,Wild Bean Cafe,Eating Out,1,1420
7,12,2012,Cubit and West rent,Rent,550,870
7,12,2012,Tescos,Groceries,57,813
7,12,2012,Costa Coffee,Eating Out,1,812
7,12,2012,Subway,Eating Out,5,807
8,12,2012,Pizza Express,Eating Out,29,778
8,12,2012,ATM Cash Withdrawal,General,20,758
10,12,2012,South West Trains,Transport,33,725
10,12,2012,Starbucks Coffee,Eating Out,2,723
13,12,2012,The West Cornwall Pasty Company,Eating Out,8,715
14,12,2012,Morrisons,Groceries,60,655
14,12,2012,Anglo restaurant,Eating Out,27,628
15,12,2012,BRGAS-Electricity,Bills,21,607
15,12,2012,BRGAS-Gas,Bills,22,585
15,12,2012,Scott's Restaurant,Eating Out,54,531
16,12,2012,LBS Council Tax,Bills,50,481
17,12,2012,South West Trains,Transport,37,444
18,12,2012,Caffe Nero,Eating Out,2,442
19,12,2012,Wild Bean Cafe,Eating Out,2,440
19,12,2012,The West Cornwall Pasty Company,Eating Out,4,436
20,12,2012,VIRGIN MEDIA PYMTS,Bills,29,407
20,12,2012,McDonalds,Eating Out,6,401
20,12,2012,ATM Cash Withdrawal,General,20,381
20,12,2012,Cheam Service Station,,2,379
21,12,2012,Sainsburys,Groceries,88,291
21,12,2012,Chicken Cottage,Eating Out,8,283
21,12,2012,Dominos Pizza,Eating Out,34,249
22,12,2012,ATM Cash Withdrawal,General,10,239
23,12,2012,Anglo restaurant,Eating Out,52,187
23,12,2012,ATM Cash Withdrawal,General,10,177
24,12,2012,O2,Bills,31,146
24,12,2012,South West Trains,Transport,37,109
24,12,2012,Wild Bean Cafe,Eating Out,2,107
25,12,2012,Subway,Eating Out,5,102
25,12,2012,ATM Cash Withdrawal,General,20,82
26,12,2012,McDonalds,Eating Out,5,77
26,12,2012,Civic Shop,,8,69
27,12,2012,Costa Coffee,Eating Out,2,67
28,12,2012,ASDA,Groceries,73,-6
28,12,2012,Costa Coffee,Eating Out,2,-8
28,12,2012,McDonalds,Eating Out,5,-13
28,12,2012,Restaurant Gordon RamsayPortland Restaurant,Eating Out,26,-39
29,12,2012,Scott's Restaurant,Eating Out,25,-64
30,12,2012,Dominos Pizza,Eating Out,32,-96
31,12,2012,South West Trains,Transport,24,-120
31,12,2012,Wild Bean Cafe,Eating Out,2,-122
31,12,2012,Chicken Cottage,Eating Out,7,-129
1,1,2013,Rhino Sports salary,General,1700,1571
1,1,2013,ATM Cash Withdrawal,General,10,1561
2,1,2013,Costa Coffee,Eating Out,2,1559
3,1,2013,Pret A Manger,Eating Out,5,1554
3,1,2013,ATM Cash Withdrawal,General,10,1544
4,1,2013,Tescos,Groceries,63,1481
4,1,2013,Starbucks Coffee,Eating Out,1,1480
4,1,2013,Pret A Manger,Eating Out,4,1476
7,1,2013,Cubit and West rent,Rent,550,926
7,1,2013,South West Trains,Transport,26,900
7,1,2013,Chicken Cottage,Eating Out,7,893
8,1,2013,Costa Coffee,Eating Out,1,892
8,1,2013,Subway,Eating Out,4,888
8,1,2013,Tool Shop,,5,883
9,1,2013,Wild Bean Cafe,Eating Out,1,882
9,1,2013,Subway,Eating Out,5,877
9,1,2013,ATM Cash Withdrawal,General,20,857
10,1,2013,Starbucks Coffee,Eating Out,2,855
10,1,2013,Greggs,Eating Out,6,849
11,1,2013,Tescos,Groceries,84,765
11,1,2013,Starbucks Coffee,Eating Out,1,764
11,1,2013,Red Shop,,6,758
12,1,2013,Pizza Express,Eating Out,37,721
12,1,2013,ATM Cash Withdrawal,General,10,711
13,1,2013,Scott's Restaurant,Eating Out,38,673
14,1,2013,South West Trains,Transport,28,645
14,1,2013,Starbucks Coffee,Eating Out,2,643
14,1,2013,ATM Cash Withdrawal,General,10,633
15,1,2013,BRGAS-Electricity,Bills,31,602
15,1,2013,BRGAS-Gas,Bills,73,529
15,1,2013,Caffe Nero,Eating Out,2,527
16,1,2013,LBS Council Tax,Bills,50,477
16,1,2013,Caffe Nero,Eating Out,2,475
16,1,2013,Greggs,Eating Out,6,469
16,1,2013,ATM Cash Withdrawal,General,10,459
17,1,2013,Costa Coffee,Eating Out,2,457
17,1,2013,Subway,Eating Out,5,452
17,1,2013,ATM Cash Withdrawal,General,20,432
18,1,2013,Tescos,Groceries,86,346
18,1,2013,Caffe Nero,Eating Out,2,344
19,1,2013,Dominos Pizza,Eating Out,59,285
20,1,2013,VIRGIN MEDIA PYMTS,Bills,38,247
20,1,2013,ATM Cash Withdrawal,General,10,237
21,1,2013,South West Trains,Transport,26,211
21,1,2013,Caffe Nero,Eating Out,2,209
21,1,2013,ATM Cash Withdrawal,General,20,189
22,1,2013,Costa Coffee,Eating Out,1,188
23,1,2013,Costa Coffee,Eating Out,2,186
23,1,2013,Chicken Cottage,Eating Out,6,180
23,1,2013,ATM Cash Withdrawal,General,10,170
24,1,2013,O2,Bills,37,133
24,1,2013,Starbucks Coffee,Eating Out,2,131
24,1,2013,Subway,Eating Out,6,125
25,1,2013,Sainsburys,Groceries,79,46
25,1,2013,Costa Coffee,Eating Out,2,44
25,1,2013,Scott's Restaurant,Eating Out,55,-11
26,1,2013,Restaurant Gordon RamsayPortland Restaurant,Eating Out,42,-53
28,1,2013,South West Trains,Transport,25,-78
28,1,2013,Costa Coffee,Eating Out,1,-79
28,1,2013,Pret A Manger,Eating Out,7,-86
29,1,2013,Wild Bean Cafe,Eating Out,1,-87
30,1,2013,Starbucks Coffee,Eating Out,1,-88
31,1,2013,Starbucks Coffee,Eating Out,1,-89
1,2,2013,Rhino Sports salary,General,1700,1611
1,2,2013,Sainsburys,Groceries,73,1538
1,2,2013,Caffe Nero,Eating Out,2,1536
1,2,2013,McDonalds,Eating Out,7,1529
1,2,2013,Restaurant Gordon RamsayPortland Restaurant,Eating Out,59,1470
2,2,2013,ATM Cash Withdrawal,General,20,1450
3,2,2013,Pizza Express,Eating Out,32,1418
4,2,2013,South West Trains,Transport,32,1386
4,2,2013,Costa Coffee,Eating Out,2,1384
4,2,2013,Chicken Cottage,Eating Out,8,1376
4,2,2013,ATM Cash Withdrawal,General,20,1356
5,2,2013,Starbucks Coffee,Eating Out,2,1354
5,2,2013,Greggs,Eating Out,4,1350
6,2,2013,Costa Coffee,Eating Out,1,1349
6,2,2013,ATM Cash Withdrawal,General,20,1329
7,2,2013,Cubit and West rent,Rent,550,779
7,2,2013,Costa Coffee,Eating Out,2,777
7,2,2013,Subway,Eating Out,4,773
8,2,2013,ASDA,Groceries,74,699
8,2,2013,Costa Coffee,Eating Out,2,697
9,2,2013,Scott's Restaurant,Eating Out,34,663
10,2,2013,ATM Cash Withdrawal,General,20,643
10,2,2013,Paying back Julie,,2,641
11,2,2013,South West Trains,Transport,37,604
11,2,2013,The West Cornwall Pasty Company,Eating Out,8,596
11,2,2013,ATM Cash Withdrawal,General,10,586
11,2,2013,Tool Shop,,4,582
12,2,2013,Starbucks Coffee,Eating Out,1,581
12,2,2013,Civic Shop,,9,572
13,2,2013,Caffe Nero,Eating Out,2,570
13,2,2013,McDonalds,Eating Out,7,563
14,2,2013,Greggs,Eating Out,5,558
14,2,2013,ATM Cash Withdrawal,General,10,548
14,2,2013,Paying back Julie,,8,540
15,2,2013,BRGAS-Electricity,Bills,23,517
15,2,2013,BRGAS-Gas,Bills,40,477
15,2,2013,Morrisons,Groceries,78,399
15,2,2013,Starbucks Coffee,Eating Out,2,397
15,2,2013,Subway,Eating Out,7,390
16,2,2013,LBS Council Tax,Bills,50,340
16,2,2013,The Grand Pub,Eating Out,6,334
16,2,2013,The Grand Pub,Eating Out,12,322
17,2,2013,ATM Cash Withdrawal,General,20,302
18,2,2013,South West Trains,Transport,37,265
18,2,2013,Wild Bean Cafe,Eating Out,2,263
18,2,2013,The West Cornwall Pasty Company,Eating Out,8,255
18,2,2013,ATM Cash Withdrawal,General,20,235
19,2,2013,Costa Coffee,Eating Out,2,233
19,2,2013,The West Cornwall Pasty Company,Eating Out,6,227
19,2,2013,ATM Cash Withdrawal,General,20,207
20,2,2013,VIRGIN MEDIA PYMTS,Bills,58,149
20,2,2013,Starbucks Coffee,Eating Out,2,147
20,2,2013,McDonalds,Eating Out,4,143
20,2,2013,ATM Cash Withdrawal,General,10,133
21,2,2013,Caffe Nero,Eating Out,2,131
21,2,2013,Tool Tec,,8,123
22,2,2013,ASDA,Groceries,44,79
22,2,2013,Starbucks Coffee,Eating Out,2,77
22,2,2013,Chicken Cottage,Eating Out,5,72
23,2,2013,ATM Cash Withdrawal,General,20,52
24,2,2013,O2,Bills,35,17
25,2,2013,South West Trains,Transport,27,-10
25,2,2013,Starbucks Coffee,Eating Out,2,-12
25,2,2013,The West Cornwall Pasty Company,Eating Out,4,-16
26,2,2013,Starbucks Coffee,Eating Out,1,-17
26,2,2013,Pret A Manger,Eating Out,6,-23
27,2,2013,Caffe Nero,Eating Out,2,-25
27,2,2013,McDonalds,Eating Out,5,-30
27,2,2013,ATM Cash Withdrawal,General,10,-40
27,2,2013,Tool Shop,,1,-41
28,2,2013,Caffe Nero,Eating Out,2,-43
1,3,2013,Rhino Sports salary,General,1700,1657
1,3,2013,Tescos,Groceries,54,1603
1,3,2013,Wild Bean Cafe,Eating Out,2,1601
1,3,2013,Anglo restaurant,Eating Out,52,1549
1,3,2013,Cheam Service Station,,8,1541
2,3,2013,Restaurant Gordon RamsayPortland Restaurant,Eating Out,36,1505
4,3,2013,South West Trains,Transport,25,1480
4,3,2013,Costa Coffee,Eating Out,1,1479
4,3,2013,Red Shop,,5,1474
5,3,2013,Caffe Nero,Eating Out,2,1472
5,3,2013,McDonalds,Eating Out,4,1468
5,3,2013,ATM Cash Withdrawal,General,20,1448
6,3,2013,Costa Coffee,Eating Out,1,1447
6,3,2013,The West Cornwall Pasty Company,Eating Out,7,1440
7,3,2013,Cubit and West rent,Rent,550,890
7,3,2013,Wild Bean Cafe,Eating Out,1,889
7,3,2013,Red Shop,,9,880
8,3,2013,Morrisons,Groceries,54,826
8,3,2013,Wild Bean Cafe,Eating Out,2,824
8,3,2013,Heaven Club,Eating Out,10,814
8,3,2013,Heaven Club,Eating Out,5,809
8,3,2013,Scott's Restaurant,Eating Out,44,765
10,3,2013,ATM Cash Withdrawal,General,20,745
11,3,2013,South West Trains,Transport,24,721
11,3,2013,Costa Coffee,Eating Out,2,719
11,3,2013,Paying back Julie,,4,715
12,3,2013,Wild Bean Cafe,Eating Out,1,714
12,3,2013,Pret A Manger,Eating Out,8,706
13,3,2013,Costa Coffee,Eating Out,1,705
13,3,2013,Pret A Manger,Eating Out,5,700
14,3,2013,Costa Coffee,Eating Out,2,698
15,3,2013,BRGAS-Electricity,Bills,38,660
15,3,2013,BRGAS-Gas,Bills,40,620
15,3,2013,Sainsburys,Groceries,62,558
15,3,2013,Costa Coffee,Eating Out,2,556
15,3,2013,Restaurant Gordon RamsayPortland Restaurant,Eating Out,49,507
16,3,2013,LBS Council Tax,Bills,50,457
16,3,2013,Dominos Pizza,Eating Out,48,409
17,3,2013,Dominos Pizza,Eating Out,32,377
17,3,2013,ATM Cash Withdrawal,General,10,367
18,3,2013,South West Trains,Transport,30,337
18,3,2013,Starbucks Coffee,Eating Out,2,335
18,3,2013,Chicken Cottage,Eating Out,5,330
19,3,2013,Caffe Nero,Eating Out,2,328
19,3,2013,Pret A Manger,Eating Out,5,323
20,3,2013,VIRGIN MEDIA PYMTS,Bills,33,290
20,3,2013,Caffe Nero,Eating Out,2,288
20,3,2013,McDonalds,Eating Out,7,281
20,3,2013,Paying back James,,5,276
21,3,2013,Starbucks Coffee,Eating Out,1,275
21,3,2013,ATM Cash Withdrawal,General,10,265
21,3,2013,Cheam Service Station,,3,262
22,3,2013,ASDA,Groceries,56,206
22,3,2013,Wild Bean Cafe,Eating Out,1,205
22,3,2013,Pizza Express,Eating Out,48,157
24,3,2013,O2,Bills,35,122
25,3,2013,South West Trains,Transport,37,85
25,3,2013,Caffe Nero,Eating Out,1,84
25,3,2013,Chicken Cottage,Eating Out,5,79
26,3,2013,Pret A Manger,Eating Out,6,73
28,3,2013,Wild Bean Cafe,Eating Out,2,71
28,3,2013,Pret A Manger,Eating Out,4,67
28,3,2013,ATM Cash Withdrawal,General,20,47
29,3,2013,Tescos,Groceries,47,0
29,3,2013,Starbucks Coffee,Eating Out,2,-2
29,3,2013,Anglo restaurant,Eating Out,29,-31
29,3,2013,Paying back James,,9,-40
30,3,2013,Scott's Restaurant,Eating Out,53,-93
31,3,2013,Dominos Pizza,Eating Out,40,-133
31,3,2013,Paying back James,,8,-141
1,4,2013,Rhino Sports salary,General,1700,1559
1,4,2013,South West Trains,Transport,28,1531
1,4,2013,Costa Coffee,Eating Out,1,1530
2,4,2013,Costa Coffee,Eating Out,1,1529
2,4,2013,McDonalds,Eating Out,5,1524
3,4,2013,Costa Coffee,Eating Out,1,1523
3,4,2013,McDonalds,Eating Out,5,1518
3,4,2013,ATM Cash Withdrawal,General,10,1508
4,4,2013,Wild Bean Cafe,Eating Out,2,1506
5,4,2013,Waitrose,Groceries,85,1421
5,4,2013,Heaven Club,Eating Out,14,1407
5,4,2013,Heaven Club,Eating Out,7,1400
5,4,2013,Heaven Club,Eating Out,6,1394
5,4,2013,Heaven Club,Eating Out,6,1388
6,4,2013,Tool Shop,,5,1383
7,4,2013,Cubit and West rent,Rent,550,833
7,4,2013,Anglo restaurant,Eating Out,26,807
7,4,2013,ATM Cash Withdrawal,General,20,787
8,4,2013,South West Trains,Transport,38,749
8,4,2013,Caffe Nero,Eating Out,2,747
8,4,2013,McDonalds,Eating Out,7,740
9,4,2013,Starbucks Coffee,Eating Out,2,738
9,4,2013,The West Cornwall Pasty Company,Eating Out,6,732
10,4,2013,Starbucks Coffee,Eating Out,2,730
10,4,2013,The West Cornwall Pasty Company,Eating Out,7,723
10,4,2013,ATM Cash Withdrawal,General,10,713
11,4,2013,Caffe Nero,Eating Out,2,711
11,4,2013,McDonalds,Eating Out,8,703
12,4,2013,Sainsburys,Groceries,46,657
12,4,2013,Wild Bean Cafe,Eating Out,1,656
15,4,2013,BRGAS-Electricity,Bills,23,633
15,4,2013,BRGAS-Gas,Bills,27,606
15,4,2013,South West Trains,Transport,38,568
15,4,2013,Wild Bean Cafe,Eating Out,2,566
15,4,2013,Greggs,Eating Out,7,559
15,4,2013,ATM Cash Withdrawal,General,20,539
16,4,2013,LBS Council Tax,Bills,50,489
16,4,2013,Costa Coffee,Eating Out,2,487
16,4,2013,The West Cornwall Pasty Company,Eating Out,5,482
16,4,2013,Tool Tec,,1,481
17,4,2013,Starbucks Coffee,Eating Out,2,479
17,4,2013,Subway,Eating Out,4,475
18,4,2013,Starbucks Coffee,Eating Out,1,474
18,4,2013,McDonalds,Eating Out,7,467
19,4,2013,Tescos,Groceries,53,414
19,4,2013,Starbucks Coffee,Eating Out,2,412
19,4,2013,Greggs,Eating Out,5,407
19,4,2013,Fabric Club,Eating Out,9,398
19,4,2013,Fabric Club,Eating Out,12,386
19,4,2013,Scott's Restaurant,Eating Out,52,334
20,4,2013,VIRGIN MEDIA PYMTS,Bills,42,292
20,4,2013,Pizza Express,Eating Out,38,254
22,4,2013,South West Trains,Transport,30,224
22,4,2013,Starbucks Coffee,Eating Out,2,222
22,4,2013,McDonalds,Eating Out,7,215
22,4,2013,ATM Cash Withdrawal,General,10,205
22,4,2013,Civic Shop,,7,198
23,4,2013,Wild Bean Cafe,Eating Out,1,197
23,4,2013,Subway,Eating Out,8,189
24,4,2013,O2,Bills,37,152
24,4,2013,Pret A Manger,Eating Out,4,148
24,4,2013,ATM Cash Withdrawal,General,20,128
24,4,2013,Paying back Julie,,3,125
25,4,2013,Starbucks Coffee,Eating Out,1,124
25,4,2013,McDonalds,Eating Out,5,119
26,4,2013,ASDA,Groceries,44,75
26,4,2013,Wild Bean Cafe,Eating Out,2,73
26,4,2013,Greggs,Eating Out,7,66
26,4,2013,Pizza Express,Eating Out,33,33
27,4,2013,Scott's Restaurant,Eating Out,29,4
27,4,2013,ATM Cash Withdrawal,General,20,-16
28,4,2013,Scott's Restaurant,Eating Out,50,-66
29,4,2013,South West Trains,Transport,31,-97
29,4,2013,Wild Bean Cafe,Eating Out,2,-99
29,4,2013,Subway,Eating Out,5,-104
30,4,2013,Starbucks Coffee,Eating Out,2,-106
30,4,2013,The West Cornwall Pasty Company,Eating Out,7,-113
1,5,2013,Rhino Sports salary,General,1700,1587
1,5,2013,Wild Bean Cafe,Eating Out,2,1585
1,5,2013,ATM Cash Withdrawal,General,10,1575
2,5,2013,Costa Coffee,Eating Out,1,1574
2,5,2013,ATM Cash Withdrawal,General,20,1554
3,5,2013,Tescos,Groceries,72,1482
3,5,2013,Caffe Nero,Eating Out,2,1480
3,5,2013,Greggs,Eating Out,7,1473
3,5,2013,Dominos Pizza,Eating Out,24,1449
5,5,2013,ATM Cash Withdrawal,General,20,1429
6,5,2013,South West Trains,Transport,33,1396
7,5,2013,Cubit and West rent,Rent,550,846
7,5,2013,Caffe Nero,Eating Out,2,844
7,5,2013,ATM Cash Withdrawal,General,10,834
8,5,2013,McDonalds,Eating Out,7,827
9,5,2013,Caffe Nero,Eating Out,1,826
9,5,2013,Greggs,Eating Out,6,820
10,5,2013,ASDA,Groceries,89,731
10,5,2013,Wild Bean Cafe,Eating Out,1,730
10,5,2013,Fabric Club,Eating Out,6,724
10,5,2013,Fabric Club,Eating Out,13,711
10,5,2013,Fabric Club,Eating Out,9,702
10,5,2013,Fabric Club,Eating Out,15,687
11,5,2013,Ministry of Sound ClubXOYO Club,Eating Out,11,676
11,5,2013,Ministry of Sound ClubXOYO Club,Eating Out,10,666
11,5,2013,Ministry of Sound ClubXOYO Club,Eating Out,14,652
11,5,2013,Ministry of Sound ClubXOYO Club,Eating Out,10,642
11,5,2013,Ministry of Sound ClubXOYO Club,Eating Out,10,632
11,5,2013,Ministry of Sound ClubXOYO Club,Eating Out,16,616
11,5,2013,Anglo restaurant,Eating Out,35,581
12,5,2013,ATM Cash Withdrawal,General,10,571
13,5,2013,South West Trains,Transport,31,540
13,5,2013,Caffe Nero,Eating Out,2,538
13,5,2013,ATM Cash Withdrawal,General,10,528
14,5,2013,Starbucks Coffee,Eating Out,2,526
15,5,2013,BRGAS-Electricity,Bills,33,493
15,5,2013,BRGAS-Gas,Bills,38,455
15,5,2013,Caffe Nero,Eating Out,2,453
15,5,2013,Subway,Eating Out,8,445
16,5,2013,LBS Council Tax,Bills,50,395
16,5,2013,Costa Coffee,Eating Out,2,393
16,5,2013,Red Shop,,4,389
17,5,2013,Morrisons,Groceries,62,327
18,5,2013,Restaurant Gordon RamsayPortland Restaurant,Eating Out,39,288
19,5,2013,ATM Cash Withdrawal,General,10,278
20,5,2013,VIRGIN MEDIA PYMTS,Bills,58,220
20,5,2013,South West Trains,Transport,29,191
20,5,2013,Wild Bean Cafe,Eating Out,2,189
20,5,2013,Chicken Cottage,Eating Out,6,183
20,5,2013,ATM Cash Withdrawal,General,10,173
21,5,2013,The West Cornwall Pasty Company,Eating Out,8,165
21,5,2013,Tool Tec,,1,164
22,5,2013,Starbucks Coffee,Eating Out,2,162
22,5,2013,McDonalds,Eating Out,8,154
23,5,2013,Wild Bean Cafe,Eating Out,2,152
23,5,2013,Pret A Manger,Eating Out,8,144
24,5,2013,O2,Bills,32,112
24,5,2013,Tescos,Groceries,80,32
24,5,2013,Starbucks Coffee,Eating Out,1,31
25,5,2013,Anglo restaurant,Eating Out,31,0
25,5,2013,Red Shop,,8,-8
26,5,2013,Scott's Restaurant,Eating Out,43,-51
27,5,2013,South West Trains,Transport,28,-79
27,5,2013,Caffe Nero,Eating Out,2,-81
27,5,2013,Greggs,Eating Out,5,-86
27,5,2013,ATM Cash Withdrawal,General,20,-106
28,5,2013,Starbucks Coffee,Eating Out,2,-108
29,5,2013,Costa Coffee,Eating Out,1,-109
29,5,2013,ATM Cash Withdrawal,General,10,-119
31,5,2013,Sainsburys,Groceries,46,-165
31,5,2013,Caffe Nero,Eating Out,2,-167
31,5,2013,Fabric Club,Eating Out,14,-181
31,5,2013,Dominos Pizza,Eating Out,59,-240
1,6,2013,Rhino Sports salary,General,1700,1460
1,6,2013,Anglo restaurant,Eating Out,28,1432
1,6,2013,ATM Cash Withdrawal,General,10,1422
2,6,2013,Scott's Restaurant,Eating Out,32,1390
3,6,2013,South West Trains,Transport,31,1359
3,6,2013,Starbucks Coffee,Eating Out,2,1357
3,6,2013,The West Cornwall Pasty Company,Eating Out,6,1351
4,6,2013,Starbucks Coffee,Eating Out,2,1349
4,6,2013,Greggs,Eating Out,7,1342
5,6,2013,Pret A Manger,Eating Out,5,1337
6,6,2013,Starbucks Coffee,Eating Out,2,1335
6,6,2013,Greggs,Eating Out,6,1329
7,6,2013,Cubit and West rent,Rent,550,779
7,6,2013,ASDA,Groceries,60,719
7,6,2013,Wild Bean Cafe,Eating Out,1,718
7,6,2013,McDonalds,Eating Out,6,712
7,6,2013,Anglo restaurant,Eating Out,33,679
8,6,2013,Anglo restaurant,Eating Out,30,649
10,6,2013,South West Trains,Transport,34,615
10,6,2013,The West Cornwall Pasty Company,Eating Out,6,609
11,6,2013,Caffe Nero,Eating Out,1,608
11,6,2013,The West Cornwall Pasty Company,Eating Out,5,603
12,6,2013,Caffe Nero,Eating Out,2,601
12,6,2013,McDonalds,Eating Out,5,596
12,6,2013,ATM Cash Withdrawal,General,20,576
13,6,2013,ATM Cash Withdrawal,General,20,556
14,6,2013,Morrisons,Groceries,81,475
14,6,2013,Costa Coffee,Eating Out,1,474
14,6,2013,Greggs,Eating Out,7,467
14,6,2013,Pizza Express,Eating Out,58,409
15,6,2013,BRGAS-Electricity,Bills,24,385
15,6,2013,BRGAS-Gas,Bills,39,346
15,6,2013,Ministry of Sound ClubXOYO Club,Eating Out,15,331
16,6,2013,LBS Council Tax,Bills,50,281
16,6,2013,ATM Cash Withdrawal,General,20,261
17,6,2013,South West Trains,Transport,24,237
17,6,2013,Civic Shop,,7,230
18,6,2013,Starbucks Coffee,Eating Out,2,228
19,6,2013,Starbucks Coffee,Eating Out,2,226
19,6,2013,McDonalds,Eating Out,5,221
20,6,2013,VIRGIN MEDIA PYMTS,Bills,37,184
20,6,2013,Caffe Nero,Eating Out,2,182
21,6,2013,Waitrose,Groceries,59,123
21,6,2013,ATM Cash Withdrawal,General,20,103
21,6,2013,Paying back Julie,,4,99
22,6,2013,Paying back James,,2,97
24,6,2013,O2,Bills,32,65
24,6,2013,South West Trains,Transport,25,40
24,6,2013,Wild Bean Cafe,Eating Out,2,38
24,6,2013,Greggs,Eating Out,8,30
24,6,2013,ATM Cash Withdrawal,General,10,20
25,6,2013,Costa Coffee,Eating Out,2,18
25,6,2013,Pret A Manger,Eating Out,4,14
26,6,2013,Pret A Manger,Eating Out,6,8
27,6,2013,Costa Coffee,Eating Out,1,7
28,6,2013,Waitrose,Groceries,86,-79
28,6,2013,Caffe Nero,Eating Out,2,-81
28,6,2013,Chicken Cottage,Eating Out,8,-89
28,6,2013,Scott's Restaurant,Eating Out,26,-115
28,6,2013,ATM Cash Withdrawal,General,20,-135
29,6,2013,ATM Cash Withdrawal,General,10,-145
1,7,2013,Rhino Sports salary,General,1700,1555
1,7,2013,South West Trains,Transport,36,1519
1,7,2013,Caffe Nero,Eating Out,1,1518
1,7,2013,Greggs,Eating Out,7,1511
1,7,2013,ATM Cash Withdrawal,General,10,1501
2,7,2013,ATM Cash Withdrawal,General,20,1481
2,7,2013,Paying back James,,7,1474
3,7,2013,Subway,Eating Out,8,1466
3,7,2013,ATM Cash Withdrawal,General,20,1446
4,7,2013,Costa Coffee,Eating Out,2,1444
4,7,2013,Chicken Cottage,Eating Out,6,1438
5,7,2013,Sainsburys,Groceries,88,1350
5,7,2013,Chicken Cottage,Eating Out,5,1345
6,7,2013,Fabric Club,Eating Out,10,1335
6,7,2013,Fabric Club,Eating Out,15,1320
7,7,2013,Cubit and West rent,Rent,550,770
8,7,2013,South West Trains,Transport,31,739
8,7,2013,Subway,Eating Out,8,731
8,7,2013,ATM Cash Withdrawal,General,20,711
9,7,2013,Chicken Cottage,Eating Out,5,706
10,7,2013,Wild Bean Cafe,Eating Out,2,704
11,7,2013,Wild Bean Cafe,Eating Out,1,703
12,7,2013,ASDA,Groceries,82,621
12,7,2013,Caffe Nero,Eating Out,2,619
12,7,2013,Pizza Express,Eating Out,50,569
12,7,2013,ATM Cash Withdrawal,General,20,549
15,7,2013,BRGAS-Electricity,Bills,44,505
15,7,2013,BRGAS-Gas,Bills,43,462
15,7,2013,South West Trains,Transport,31,431
15,7,2013,Greggs,Eating Out,5,426
16,7,2013,LBS Council Tax,Bills,50,376
16,7,2013,Caffe Nero,Eating Out,1,375
16,7,2013,Greggs,Eating Out,4,371
16,7,2013,ATM Cash Withdrawal,General,10,361
17,7,2013,Wild Bean Cafe,Eating Out,2,359
17,7,2013,Greggs,Eating Out,5,354
18,7,2013,Costa Coffee,Eating Out,1,353
19,7,2013,ASDA,Groceries,89,264
19,7,2013,Caffe Nero,Eating Out,1,263
19,7,2013,Chicken Cottage,Eating Out,6,257
19,7,2013,Fabric Club,Eating Out,6,251
19,7,2013,Fabric Club,Eating Out,13,238
19,7,2013,Fabric Club,Eating Out,16,222
19,7,2013,Fabric Club,Eating Out,12,210
19,7,2013,Fabric Club,Eating Out,16,194
20,7,2013,VIRGIN MEDIA PYMTS,Bills,42,152
22,7,2013,South West Trains,Transport,27,125
22,7,2013,Wild Bean Cafe,Eating Out,2,123
23,7,2013,Costa Coffee,Eating Out,1,122
24,7,2013,O2,Bills,36,86
24,7,2013,Caffe Nero,Eating Out,2,84
24,7,2013,Pret A Manger,Eating Out,6,78
24,7,2013,ATM Cash Withdrawal,General,10,68
25,7,2013,Pret A Manger,Eating Out,8,60
25,7,2013,ATM Cash Withdrawal,General,10,50
26,7,2013,Morrisons,Groceries,76,-26
26,7,2013,Fabric Club,Eating Out,10,-36
27,7,2013,Pizza Express,Eating Out,43,-79
27,7,2013,ATM Cash Withdrawal,General,20,-99
28,7,2013,ATM Cash Withdrawal,General,20,-119
29,7,2013,South West Trains,Transport,24,-143
29,7,2013,Costa Coffee,Eating Out,1,-144
29,7,2013,Greggs,Eating Out,5,-149
30,7,2013,Starbucks Coffee,Eating Out,1,-150
31,7,2013,Starbucks Coffee,Eating Out,1,-151
31,7,2013,Subway,Eating Out,6,-157
1,8,2013,Rhino Sports salary,General,1700,1543
1,8,2013,Starbucks Coffee,Eating Out,2,1541
1,8,2013,Chicken Cottage,Eating Out,4,1537
2,8,2013,Sainsburys,Groceries,86,1451
2,8,2013,Costa Coffee,Eating Out,2,1449
2,8,2013,Pret A Manger,Eating Out,8,1441
5,8,2013,South West Trains,Transport,35,1406
5,8,2013,Costa Coffee,Eating Out,2,1404
6,8,2013,Starbucks Coffee,Eating Out,2,1402
6,8,2013,Cheam Service Station,,7,1395
7,8,2013,Cubit and West rent,Rent,550,845
7,8,2013,Starbucks Coffee,Eating Out,2,843
7,8,2013,Chicken Cottage,Eating Out,8,835
8,8,2013,Costa Coffee,Eating Out,1,834
8,8,2013,Tool Tec,,3,831
9,8,2013,Tescos,Groceries,81,750
9,8,2013,Caffe Nero,Eating Out,2,748
9,8,2013,The West Cornwall Pasty Company,Eating Out,7,741
9,8,2013,Heaven Club,Eating Out,14,727
9,8,2013,Dominos Pizza,Eating Out,30,697
9,8,2013,ATM Cash Withdrawal,General,20,677
9,8,2013,Cheam Service Station,,7,670
10,8,2013,Pizza Express,Eating Out,44,626
11,8,2013,Dominos Pizza,Eating Out,25,601
12,8,2013,South West Trains,Transport,33,568
12,8,2013,Costa Coffee,Eating Out,1,567
12,8,2013,Chicken Cottage,Eating Out,6,561
13,8,2013,Wild Bean Cafe,Eating Out,2,559
13,8,2013,The West Cornwall Pasty Company,Eating Out,8,551
13,8,2013,Paying back James,,7,544
14,8,2013,Caffe Nero,Eating Out,1,543
14,8,2013,McDonalds,Eating Out,5,538
15,8,2013,BRGAS-Electricity,Bills,38,500
15,8,2013,BRGAS-Gas,Bills,32,468
15,8,2013,Wild Bean Cafe,Eating Out,1,467
15,8,2013,Subway,Eating Out,8,459
15,8,2013,ATM Cash Withdrawal,General,20,439
16,8,2013,LBS Council Tax,Bills,50,389
16,8,2013,Morrisons,Groceries,50,339
16,8,2013,Costa Coffee,Eating Out,2,337
16,8,2013,Greggs,Eating Out,7,330
16,8,2013,ATM Cash Withdrawal,General,10,320
17,8,2013,Restaurant Gordon RamsayPortland Restaurant,Eating Out,37,283
18,8,2013,Paying back James,,8,275
19,8,2013,South West Trains,Transport,38,237
20,8,2013,VIRGIN MEDIA PYMTS,Bills,58,179
20,8,2013,Costa Coffee,Eating Out,2,177
20,8,2013,ATM Cash Withdrawal,General,20,157
22,8,2013,Chicken Cottage,Eating Out,8,149
22,8,2013,Red Shop,,6,143
23,8,2013,ASDA,Groceries,51,92
23,8,2013,Wild Bean Cafe,Eating Out,1,91
23,8,2013,McDonalds,Eating Out,8,83
24,8,2013,O2,Bills,35,48
24,8,2013,ATM Cash Withdrawal,General,20,28
25,8,2013,Pizza Express,Eating Out,32,-4
26,8,2013,South West Trains,Transport,24,-28
26,8,2013,Starbucks Coffee,Eating Out,2,-30
27,8,2013,Starbucks Coffee,Eating Out,2,-32
27,8,2013,ATM Cash Withdrawal,General,10,-42
28,8,2013,Caffe Nero,Eating Out,2,-44
28,8,2013,The West Cornwall Pasty Company,Eating Out,4,-48
29,8,2013,Caffe Nero,Eating Out,1,-49
29,8,2013,McDonalds,Eating Out,7,-56
30,8,2013,Sainsburys,Groceries,54,-110
30,8,2013,McDonalds,Eating Out,4,-114
30,8,2013,Pizza Express,Eating Out,39,-153
31,8,2013,Anglo restaurant,Eating Out,25,-178
1,9,2013,Rhino Sports salary,General,1700,1522
1,9,2013,ATM Cash Withdrawal,General,10,1512
2,9,2013,South West Trains,Transport,24,1488
3,9,2013,Chicken Cottage,Eating Out,7,1481
4,9,2013,Costa Coffee,Eating Out,1,1480
4,9,2013,Chicken Cottage,Eating Out,8,1472
5,9,2013,Starbucks Coffee,Eating Out,2,1470
5,9,2013,Chicken Cottage,Eating Out,6,1464
6,9,2013,Sainsburys,Groceries,42,1422
6,9,2013,The West Cornwall Pasty Company,Eating Out,4,1418
6,9,2013,Scott's Restaurant,Eating Out,44,1374
7,9,2013,Cubit and West rent,Rent,550,824
7,9,2013,Ministry of Sound ClubXOYO Club,Eating Out,7,817
7,9,2013,Ministry of Sound ClubXOYO Club,Eating Out,6,811
7,9,2013,Ministry of Sound ClubXOYO Club,Eating Out,6,805
7,9,2013,Ministry of Sound ClubXOYO Club,Eating Out,7,798
8,9,2013,Dominos Pizza,Eating Out,29,769
8,9,2013,ATM Cash Withdrawal,General,20,749
9,9,2013,South West Trains,Transport,25,724
9,9,2013,Caffe Nero,Eating Out,2,722
9,9,2013,Paying back James,,6,716
11,9,2013,Greggs,Eating Out,5,711
11,9,2013,ATM Cash Withdrawal,General,20,691
12,9,2013,Chicken Cottage,Eating Out,5,686
13,9,2013,Morrisons,Groceries,84,602
13,9,2013,Costa Coffee,Eating Out,1,601
13,9,2013,Greggs,Eating Out,7,594
14,9,2013,Anglo restaurant,Eating Out,51,543
14,9,2013,ATM Cash Withdrawal,General,10,533
15,9,2013,BRGAS-Electricity,Bills,30,503
15,9,2013,BRGAS-Gas,Bills,22,481
15,9,2013,Dominos Pizza,Eating Out,57,424
15,9,2013,ATM Cash Withdrawal,General,20,404
15,9,2013,Cheam Service Station,,4,400
16,9,2013,LBS Council Tax,Bills,50,350
16,9,2013,South West Trains,Transport,25,325
16,9,2013,Starbucks Coffee,Eating Out,2,323
16,9,2013,Chicken Cottage,Eating Out,6,317
16,9,2013,ATM Cash Withdrawal,General,10,307
17,9,2013,Greggs,Eating Out,7,300
17,9,2013,ATM Cash Withdrawal,General,10,290
19,9,2013,Starbucks Coffee,Eating Out,1,289
20,9,2013,VIRGIN MEDIA PYMTS,Bills,55,234
20,9,2013,Morrisons,Groceries,65,169
20,9,2013,Starbucks Coffee,Eating Out,1,168
20,9,2013,Dominos Pizza,Eating Out,37,131
20,9,2013,Civic Shop,,1,130
21,9,2013,ATM Cash Withdrawal,General,10,120
22,9,2013,Dominos Pizza,Eating Out,40,80
23,9,2013,South West Trains,Transport,27,53
23,9,2013,Wild Bean Cafe,Eating Out,2,51
23,9,2013,Subway,Eating Out,4,47
23,9,2013,Tool Tec,,1,46
24,9,2013,O2,Bills,36,10
26,9,2013,Caffe Nero,Eating Out,2,8
26,9,2013,McDonalds,Eating Out,6,2
27,9,2013,Sainsburys,Groceries,42,-40
27,9,2013,Caffe Nero,Eating Out,2,-42
27,9,2013,Pret A Manger,Eating Out,8,-50
27,9,2013,The Grand Pub,Eating Out,13,-63
27,9,2013,Paying back Julie,,5,-68
30,9,2013,South West Trains,Transport,32,-100
30,9,2013,Subway,Eating Out,7,-107
1,10,2013,Rhino Sports salary,General,1700,1593
1,10,2013,Subway,Eating Out,4,1589
2,10,2013,Costa Coffee,Eating Out,2,1587
3,10,2013,Costa Coffee,Eating Out,2,1585
3,10,2013,Pret A Manger,Eating Out,5,1580
4,10,2013,Tescos,Groceries,68,1512
4,10,2013,Caffe Nero,Eating Out,2,1510
4,10,2013,Dominos Pizza,Eating Out,42,1468
5,10,2013,Dominos Pizza,Eating Out,30,1438
7,10,2013,Cubit and West rent,Rent,550,888
7,10,2013,South West Trains,Transport,29,859
7,10,2013,Costa Coffee,Eating Out,2,857
7,10,2013,Subway,Eating Out,6,851
7,10,2013,ATM Cash Withdrawal,General,10,841
8,10,2013,Costa Coffee,Eating Out,1,840
9,10,2013,Starbucks Coffee,Eating Out,1,839
9,10,2013,Greggs,Eating Out,8,831
10,10,2013,Starbucks Coffee,Eating Out,2,829
11,10,2013,Morrisons,Groceries,56,773
11,10,2013,The West Cornwall Pasty Company,Eating Out,5,768
11,10,2013,Dominos Pizza,Eating Out,26,742
11,10,2013,ATM Cash Withdrawal,General,20,722
12,10,2013,The Grand Pub,Eating Out,16,706
12,10,2013,The Grand Pub,Eating Out,14,692
12,10,2013,The Grand Pub,Eating Out,5,687
12,10,2013,The Grand Pub,Eating Out,9,678
12,10,2013,ATM Cash Withdrawal,General,10,668
12,10,2013,Tool Tec,,5,663
13,10,2013,Red Shop,,9,654
14,10,2013,South West Trains,Transport,37,617
14,10,2013,Wild Bean Cafe,Eating Out,2,615
15,10,2013,BRGAS-Electricity,Bills,33,582
15,10,2013,BRGAS-Gas,Bills,34,548
15,10,2013,Starbucks Coffee,Eating Out,2,546
16,10,2013,LBS Council Tax,Bills,50,496
16,10,2013,Greggs,Eating Out,6,490
17,10,2013,Greggs,Eating Out,5,485
18,10,2013,Waitrose,Groceries,52,433
18,10,2013,Wild Bean Cafe,Eating Out,2,431
18,10,2013,The West Cornwall Pasty Company,Eating Out,4,427
18,10,2013,ATM Cash Withdrawal,General,20,407
19,10,2013,Dominos Pizza,Eating Out,55,352
20,10,2013,VIRGIN MEDIA PYMTS,Bills,49,303
20,10,2013,ATM Cash Withdrawal,General,10,293
21,10,2013,South West Trains,Transport,33,260
21,10,2013,Costa Coffee,Eating Out,1,259
21,10,2013,ATM Cash Withdrawal,General,20,239
21,10,2013,Civic Shop,,3,236
22,10,2013,Pret A Manger,Eating Out,4,232
23,10,2013,Wild Bean Cafe,Eating Out,2,230
23,10,2013,McDonalds,Eating Out,8,222
24,10,2013,O2,Bills,38,184
24,10,2013,Wild Bean Cafe,Eating Out,2,182
25,10,2013,Waitrose,Groceries,51,131
25,10,2013,Costa Coffee,Eating Out,2,129
25,10,2013,Greggs,Eating Out,6,123
25,10,2013,Dominos Pizza,Eating Out,26,97
26,10,2013,Fabric Club,Eating Out,5,92
26,10,2013,Fabric Club,Eating Out,10,82
26,10,2013,Anglo restaurant,Eating Out,50,32
27,10,2013,Pizza Express,Eating Out,38,-6
28,10,2013,South West Trains,Transport,28,-34
28,10,2013,Costa Coffee,Eating Out,2,-36
29,10,2013,Costa Coffee,Eating Out,1,-37
29,10,2013,Subway,Eating Out,6,-43
29,10,2013,Tool Shop,,1,-44
30,10,2013,Costa Coffee,Eating Out,1,-45
1,11,2013,Rhino Sports salary,General,1700,1655
1,11,2013,ASDA,Groceries,66,1589
1,11,2013,Costa Coffee,Eating Out,2,1587
1,11,2013,The West Cornwall Pasty Company,Eating Out,8,1579
1,11,2013,Pizza Express,Eating Out,32,1547
2,11,2013,Pizza Express,Eating Out,42,1505
4,11,2013,South West Trains,Transport,36,1469
4,11,2013,Wild Bean Cafe,Eating Out,1,1468
4,11,2013,The West Cornwall Pasty Company,Eating Out,6,1462
6,11,2013,Costa Coffee,Eating Out,2,1460
6,11,2013,Pret A Manger,Eating Out,7,1453
7,11,2013,Cubit and West rent,Rent,550,903
7,11,2013,Chicken Cottage,Eating Out,6,897
8,11,2013,Waitrose,Groceries,72,825
8,11,2013,Pret A Manger,Eating Out,8,817
10,11,2013,Dominos Pizza,Eating Out,33,784
11,11,2013,South West Trains,Transport,36,748
11,11,2013,Costa Coffee,Eating Out,1,747
12,11,2013,Starbucks Coffee,Eating Out,2,745
13,11,2013,Caffe Nero,Eating Out,2,743
13,11,2013,Greggs,Eating Out,8,735
14,11,2013,Caffe Nero,Eating Out,1,734
15,11,2013,BRGAS-Electricity,Bills,46,688
15,11,2013,BRGAS-Gas,Bills,30,658
15,11,2013,ASDA,Groceries,74,584
15,11,2013,Caffe Nero,Eating Out,2,582
15,11,2013,Chicken Cottage,Eating Out,6,576
15,11,2013,Restaurant Gordon RamsayPortland Restaurant,Eating Out,59,517
16,11,2013,LBS Council Tax,Bills,50,467
17,11,2013,Pizza Express,Eating Out,24,443
18,11,2013,South West Trains,Transport,25,418
18,11,2013,Starbucks Coffee,Eating Out,1,417
18,11,2013,Subway,Eating Out,5,412
19,11,2013,Wild Bean Cafe,Eating Out,2,410
20,11,2013,VIRGIN MEDIA PYMTS,Bills,59,351
20,11,2013,Caffe Nero,Eating Out,1,350
21,11,2013,Costa Coffee,Eating Out,1,349
21,11,2013,McDonalds,Eating Out,6,343
22,11,2013,ASDA,Groceries,42,301
22,11,2013,Pizza Express,Eating Out,53,248
23,11,2013,ATM Cash Withdrawal,General,10,238
24,11,2013,O2,Bills,34,204
24,11,2013,Anglo restaurant,Eating Out,30,174
24,11,2013,ATM Cash Withdrawal,General,20,154
24,11,2013,Tool Shop,,4,150
25,11,2013,South West Trains,Transport,26,124
25,11,2013,Caffe Nero,Eating Out,2,122
25,11,2013,Greggs,Eating Out,7,115
25,11,2013,ATM Cash Withdrawal,General,10,105
26,11,2013,Costa Coffee,Eating Out,2,103
26,11,2013,ATM Cash Withdrawal,General,10,93
27,11,2013,Costa Coffee,Eating Out,2,91
27,11,2013,Pret A Manger,Eating Out,5,86
28,11,2013,Wild Bean Cafe,Eating Out,2,84
28,11,2013,ATM Cash Withdrawal,General,20,64
29,11,2013,Tescos,Groceries,65,-1
29,11,2013,Costa Coffee,Eating Out,2,-3
29,11,2013,Subway,Eating Out,6,-9
30,11,2013,The Grand Pub,Eating Out,10,-19
30,11,2013,The Grand Pub,Eating Out,15,-34
30,11,2013,The Grand Pub,Eating Out,10,-44
30,11,2013,Dominos Pizza,Eating Out,24,-68
1,12,2013,Rhino Sports salary,General,1700,1632
1,12,2013,Restaurant Gordon RamsayPortland Restaurant,Eating Out,43,1589
2,12,2013,South West Trains,Transport,28,1561
2,12,2013,Starbucks Coffee,Eating Out,2,1559
3,12,2013,Starbucks Coffee,Eating Out,1,1558
3,12,2013,Pret A Manger,Eating Out,5,1553
4,12,2013,Chicken Cottage,Eating Out,7,1546
5,12,2013,Costa Coffee,Eating Out,1,1545
5,12,2013,The West Cornwall Pasty Company,Eating Out,6,1539
6,12,2013,Tescos,Groceries,47,1492
6,12,2013,Caffe Nero,Eating Out,1,1491
6,12,2013,Pret A Manger,Eating Out,5,1486
6,12,2013,Scott's Restaurant,Eating Out,52,1434
7,12,2013,Cubit and West rent,Rent,550,884
7,12,2013,Restaurant Gordon RamsayPortland Restaurant,Eating Out,36,848
8,12,2013,Dominos Pizza,Eating Out,41,807
9,12,2013,South West Trains,Transport,24,783
9,12,2013,Starbucks Coffee,Eating Out,1,782
9,12,2013,Greggs,Eating Out,6,776
9,12,2013,ATM Cash Withdrawal,General,10,766
10,12,2013,The West Cornwall Pasty Company,Eating Out,6,760
11,12,2013,Costa Coffee,Eating Out,2,758
11,12,2013,Chicken Cottage,Eating Out,7,751
11,12,2013,ATM Cash Withdrawal,General,10,741
12,12,2013,Wild Bean Cafe,Eating Out,1,740
12,12,2013,The West Cornwall Pasty Company,Eating Out,5,735
13,12,2013,Waitrose,Groceries,71,664
13,12,2013,Costa Coffee,Eating Out,2,662
13,12,2013,The West Cornwall Pasty Company,Eating Out,6,656
13,12,2013,ATM Cash Withdrawal,General,20,636
14,12,2013,Ministry of Sound ClubXOYO Club,Eating Out,9,627
14,12,2013,Ministry of Sound ClubXOYO Club,Eating Out,5,622
14,12,2013,Ministry of Sound ClubXOYO Club,Eating Out,16,606
14,12,2013,Ministry of Sound ClubXOYO Club,Eating Out,6,600
14,12,2013,Pizza Express,Eating Out,25,575
15,12,2013,BRGAS-Electricity,Bills,44,531
15,12,2013,BRGAS-Gas,Bills,32,499
16,12,2013,LBS Council Tax,Bills,50,449
16,12,2013,South West Trains,Transport,37,412
16,12,2013,Subway,Eating Out,7,405
17,12,2013,Starbucks Coffee,Eating Out,1,404
17,12,2013,The West Cornwall Pasty Company,Eating Out,5,399
18,12,2013,The West Cornwall Pasty Company,Eating Out,7,392
18,12,2013,ATM Cash Withdrawal,General,10,382
19,12,2013,Caffe Nero,Eating Out,2,380
19,12,2013,Subway,Eating Out,4,376
19,12,2013,ATM Cash Withdrawal,General,10,366
20,12,2013,VIRGIN MEDIA PYMTS,Bills,38,328
20,12,2013,Morrisons,Groceries,56,272
20,12,2013,Greggs,Eating Out,7,265
20,12,2013,Pizza Express,Eating Out,52,213
20,12,2013,ATM Cash Withdrawal,General,10,203
21,12,2013,Heaven Club,Eating Out,14,189
21,12,2013,Anglo restaurant,Eating Out,44,145
21,12,2013,ATM Cash Withdrawal,General,20,125
23,12,2013,South West Trains,Transport,30,95
23,12,2013,Caffe Nero,Eating Out,2,93
23,12,2013,Pret A Manger,Eating Out,4,89
24,12,2013,O2,Bills,30,59
25,12,2013,Caffe Nero,Eating Out,2,57
25,12,2013,Greggs,Eating Out,7,50
26,12,2013,Costa Coffee,Eating Out,2,48
26,12,2013,Greggs,Eating Out,5,43
27,12,2013,Waitrose,Groceries,46,-3
27,12,2013,Costa Coffee,Eating Out,2,-5
27,12,2013,Pret A Manger,Eating Out,6,-11
27,12,2013,ATM Cash Withdrawal,General,10,-21
29,12,2013,Paying back Julie,,5,-26
30,12,2013,South West Trains,Transport,37,-63
30,12,2013,Costa Coffee,Eating Out,2,-65
30,12,2013,Subway,Eating Out,5,-70
30,12,2013,ATM Cash Withdrawal,General,20,-90
31,12,2013,McDonalds,Eating Out,5,-95
31,12,2013,Cheam Service Station,,1,-96
1,1,2014,Rhino Sports salary,General,1700,1604
1,1,2014,Starbucks Coffee,Eating Out,1,1603
1,1,2014,ATM Cash Withdrawal,General,20,1583
1,1,2014,Civic Shop,,3,1580
2,1,2014,Caffe Nero,Eating Out,1,1579
2,1,2014,The West Cornwall Pasty Company,Eating Out,4,1575
2,1,2014,Red Shop,,4,1571
3,1,2014,Tescos,Groceries,59,1512
3,1,2014,Chicken Cottage,Eating Out,8,1504
3,1,2014,Anglo restaurant,Eating Out,49,1455
6,1,2014,South West Trains,Transport,36,1419
6,1,2014,Wild Bean Cafe,Eating Out,2,1417
6,1,2014,The West Cornwall Pasty Company,Eating Out,4,1413
7,1,2014,Cubit and West rent,Rent,550,863
7,1,2014,The West Cornwall Pasty Company,Eating Out,6,857
7,1,2014,ATM Cash Withdrawal,General,10,847
8,1,2014,Wild Bean Cafe,Eating Out,2,845
8,1,2014,The West Cornwall Pasty Company,Eating Out,7,838
8,1,2014,Red Shop,,4,834
9,1,2014,Starbucks Coffee,Eating Out,2,832
9,1,2014,ATM Cash Withdrawal,General,20,812
10,1,2014,ASDA,Groceries,69,743
10,1,2014,The West Cornwall Pasty Company,Eating Out,7,736
10,1,2014,ATM Cash Withdrawal,General,20,716
11,1,2014,Tool Shop,,7,709
12,1,2014,Tool Tec,,8,701
13,1,2014,South West Trains,Transport,28,673
13,1,2014,Starbucks Coffee,Eating Out,2,671
14,1,2014,Starbucks Coffee,Eating Out,2,669
14,1,2014,Greggs,Eating Out,7,662
14,1,2014,ATM Cash Withdrawal,General,10,652
15,1,2014,BRGAS-Electricity,Bills,47,605
15,1,2014,BRGAS-Gas,Bills,76,529
16,1,2014,LBS Council Tax,Bills,50,479
16,1,2014,Costa Coffee,Eating Out,1,478
16,1,2014,The West Cornwall Pasty Company,Eating Out,7,471
16,1,2014,ATM Cash Withdrawal,General,10,461
16,1,2014,Civic Shop,,1,460
17,1,2014,Tescos,Groceries,73,387
17,1,2014,Starbucks Coffee,Eating Out,2,385
17,1,2014,Chicken Cottage,Eating Out,4,381
17,1,2014,Tool Shop,,1,380
20,1,2014,VIRGIN MEDIA PYMTS,Bills,55,325
20,1,2014,South West Trains,Transport,27,298
20,1,2014,Caffe Nero,Eating Out,2,296
20,1,2014,The West Cornwall Pasty Company,Eating Out,4,292
21,1,2014,Costa Coffee,Eating Out,2,290
21,1,2014,Subway,Eating Out,8,282
21,1,2014,ATM Cash Withdrawal,General,20,262
22,1,2014,Costa Coffee,Eating Out,1,261
22,1,2014,ATM Cash Withdrawal,General,20,241
23,1,2014,Costa Coffee,Eating Out,2,239
23,1,2014,The West Cornwall Pasty Company,Eating Out,4,235
24,1,2014,O2,Bills,35,200
24,1,2014,ASDA,Groceries,89,111
24,1,2014,The West Cornwall Pasty Company,Eating Out,5,106
26,1,2014,ATM Cash Withdrawal,General,20,86
27,1,2014,South West Trains,Transport,37,49
27,1,2014,The West Cornwall Pasty Company,Eating Out,6,43
27,1,2014,ATM Cash Withdrawal,General,20,23
28,1,2014,ATM Cash Withdrawal,General,20,3
29,1,2014,Costa Coffee,Eating Out,1,2
30,1,2014,Costa Coffee,Eating Out,2,0
31,1,2014,Waitrose,Groceries,54,-54
31,1,2014,Costa Coffee,Eating Out,1,-55
31,1,2014,Paying back James,,7,-62
1,2,2014,Rhino Sports salary,General,1700,1638
2,2,2014,Pizza Express,Eating Out,35,1603
3,2,2014,South West Trains,Transport,26,1577
3,2,2014,Starbucks Coffee,Eating Out,2,1575
3,2,2014,Paying back James,,3,1572
4,2,2014,Chicken Cottage,Eating Out,5,1567
5,2,2014,Starbucks Coffee,Eating Out,1,1566
5,2,2014,Chicken Cottage,Eating Out,8,1558
5,2,2014,ATM Cash Withdrawal,General,10,1548
6,2,2014,Starbucks Coffee,Eating Out,2,1546
6,2,2014,Subway,Eating Out,8,1538
6,2,2014,ATM Cash Withdrawal,General,20,1518
7,2,2014,Cubit and West rent,Rent,550,968
7,2,2014,Waitrose,Groceries,74,894
7,2,2014,Caffe Nero,Eating Out,1,893
7,2,2014,Heaven Club,Eating Out,5,888
7,2,2014,Heaven Club,Eating Out,6,882
7,2,2014,Heaven Club,Eating Out,5,877
7,2,2014,Heaven Club,Eating Out,16,861
7,2,2014,Heaven Club,Eating Out,12,849
7,2,2014,Heaven Club,Eating Out,14,835
7,2,2014,ATM Cash Withdrawal,General,10,825
8,2,2014,Red Shop,,6,819
9,2,2014,Tool Shop,,9,810
10,2,2014,South West Trains,Transport,33,777
10,2,2014,Starbucks Coffee,Eating Out,1,776
11,2,2014,Wild Bean Cafe,Eating Out,2,774
11,2,2014,McDonalds,Eating Out,6,768
12,2,2014,Subway,Eating Out,6,762
13,2,2014,McDonalds,Eating Out,4,758
14,2,2014,Waitrose,Groceries,76,682
14,2,2014,Costa Coffee,Eating Out,2,680
14,2,2014,Anglo restaurant,Eating Out,36,644
15,2,2014,BRGAS-Electricity,Bills,43,601
15,2,2014,BRGAS-Gas,Bills,41,560
16,2,2014,LBS Council Tax,Bills,50,510
17,2,2014,South West Trains,Transport,35,475
17,2,2014,Starbucks Coffee,Eating Out,2,473
17,2,2014,ATM Cash Withdrawal,General,20,453
18,2,2014,Starbucks Coffee,Eating Out,1,452
18,2,2014,The West Cornwall Pasty Company,Eating Out,5,447
19,2,2014,Costa Coffee,Eating Out,2,445
19,2,2014,ATM Cash Withdrawal,General,10,435
20,2,2014,VIRGIN MEDIA PYMTS,Bills,43,392
20,2,2014,Greggs,Eating Out,5,387
21,2,2014,Waitrose,Groceries,65,322
22,2,2014,Tool Shop,,9,313
24,2,2014,O2,Bills,37,276
24,2,2014,South West Trains,Transport,25,251
24,2,2014,Caffe Nero,Eating Out,1,250
24,2,2014,The West Cornwall Pasty Company,Eating Out,7,243
24,2,2014,ATM Cash Withdrawal,General,10,233
25,2,2014,Starbucks Coffee,Eating Out,2,231
25,2,2014,McDonalds,Eating Out,5,226
25,2,2014,ATM Cash Withdrawal,General,10,216
26,2,2014,Caffe Nero,Eating Out,2,214
26,2,2014,Subway,Eating Out,6,208
27,2,2014,Wild Bean Cafe,Eating Out,2,206
28,2,2014,ASDA,Groceries,48,158
28,2,2014,Starbucks Coffee,Eating Out,2,156
28,2,2014,The West Cornwall Pasty Company,Eating Out,4,152
28,2,2014,Cheam Service Station,,4,148
1,3,2014,Rhino Sports salary,General,1700,1848
1,3,2014,Ministry of Sound ClubXOYO Club,Eating Out,14,1834
1,3,2014,Ministry of Sound ClubXOYO Club,Eating Out,15,1819
3,3,2014,South West Trains,Transport,33,1786
3,3,2014,Starbucks Coffee,Eating Out,2,1784
3,3,2014,Greggs,Eating Out,4,1780
4,3,2014,Costa Coffee,Eating Out,1,1779
5,3,2014,Caffe Nero,Eating Out,2,1777
6,3,2014,Costa Coffee,Eating Out,2,1775
6,3,2014,Pret A Manger,Eating Out,8,1767
6,3,2014,Tool Shop,,1,1766
7,3,2014,Cubit and West rent,Rent,550,1216
7,3,2014,Sainsburys,Groceries,79,1137
7,3,2014,Costa Coffee,Eating Out,2,1135
7,3,2014,Greggs,Eating Out,7,1128
7,3,2014,Restaurant Gordon RamsayPortland Restaurant,Eating Out,33,1095
7,3,2014,Tool Shop,,3,1092
9,3,2014,Dominos Pizza,Eating Out,55,1037
9,3,2014,ATM Cash Withdrawal,General,20,1017
10,3,2014,South West Trains,Transport,31,986
10,3,2014,Caffe Nero,Eating Out,2,984
10,3,2014,Chicken Cottage,Eating Out,6,978
11,3,2014,Caffe Nero,Eating Out,1,977
11,3,2014,McDonalds,Eating Out,5,972
11,3,2014,Civic Shop,,7,965
12,3,2014,Starbucks Coffee,Eating Out,1,964
12,3,2014,McDonalds,Eating Out,4,960
12,3,2014,ATM Cash Withdrawal,General,10,950
13,3,2014,Wild Bean Cafe,Eating Out,1,949
14,3,2014,Tescos,Groceries,66,883
14,3,2014,Costa Coffee,Eating Out,2,881
14,3,2014,Chicken Cottage,Eating Out,5,876
14,3,2014,Pizza Express,Eating Out,46,830
15,3,2014,BRGAS-Electricity,Bills,29,801
15,3,2014,BRGAS-Gas,Bills,22,779
15,3,2014,ATM Cash Withdrawal,General,20,759
16,3,2014,LBS Council Tax,Bills,50,709
16,3,2014,Pizza Express,Eating Out,35,674
17,3,2014,South West Trains,Transport,25,649
17,3,2014,Starbucks Coffee,Eating Out,2,647
17,3,2014,The West Cornwall Pasty Company,Eating Out,7,640
18,3,2014,Wild Bean Cafe,Eating Out,2,638
18,3,2014,ATM Cash Withdrawal,General,10,628
19,3,2014,Caffe Nero,Eating Out,2,626
19,3,2014,McDonalds,Eating Out,7,619
20,3,2014,VIRGIN MEDIA PYMTS,Bills,35,584
20,3,2014,Costa Coffee,Eating Out,2,582
20,3,2014,Pret A Manger,Eating Out,5,577
21,3,2014,Morrisons,Groceries,53,524
21,3,2014,Wild Bean Cafe,Eating Out,2,522
21,3,2014,Subway,Eating Out,4,518
22,3,2014,Fabric Club,Eating Out,6,512
22,3,2014,Fabric Club,Eating Out,7,505
22,3,2014,Fabric Club,Eating Out,14,491
22,3,2014,Fabric Club,Eating Out,13,478
22,3,2014,ATM Cash Withdrawal,General,20,458
23,3,2014,ATM Cash Withdrawal,General,10,448
24,3,2014,O2,Bills,31,417
24,3,2014,South West Trains,Transport,26,391
24,3,2014,Wild Bean Cafe,Eating Out,2,389
24,3,2014,Subway,Eating Out,6,383
25,3,2014,Caffe Nero,Eating Out,1,382
25,3,2014,Civic Shop,,3,379
26,3,2014,Wild Bean Cafe,Eating Out,2,377
26,3,2014,Chicken Cottage,Eating Out,5,372
26,3,2014,ATM Cash Withdrawal,General,20,352
27,3,2014,Caffe Nero,Eating Out,2,350
27,3,2014,Greggs,Eating Out,7,343
28,3,2014,Tescos,Groceries,42,301
28,3,2014,McDonalds,Eating Out,5,296
28,3,2014,Scott's Restaurant,Eating Out,25,271
29,3,2014,The Grand Pub,Eating Out,7,264
29,3,2014,The Grand Pub,Eating Out,15,249
29,3,2014,The Grand Pub,Eating Out,16,233
29,3,2014,Anglo restaurant,Eating Out,25,208
29,3,2014,ATM Cash Withdrawal,General,10,198
30,3,2014,Dominos Pizza,Eating Out,42,156
30,3,2014,ATM Cash Withdrawal,General,20,136
31,3,2014,South West Trains,Transport,33,103
31,3,2014,Caffe Nero,Eating Out,1,102
31,3,2014,McDonalds,Eating Out,4,98
1,4,2014,Rhino Sports salary,General,1700,1798
1,4,2014,ATM Cash Withdrawal,General,10,1788
2,4,2014,Caffe Nero,Eating Out,2,1786
3,4,2014,McDonalds,Eating Out,4,1782
4,4,2014,Waitrose,Groceries,45,1737
4,4,2014,The West Cornwall Pasty Company,Eating Out,8,1729
7,4,2014,Cubit and West rent,Rent,550,1179
7,4,2014,South West Trains,Transport,24,1155
7,4,2014,Subway,Eating Out,4,1151
8,4,2014,Wild Bean Cafe,Eating Out,2,1149
8,4,2014,Chicken Cottage,Eating Out,4,1145
9,4,2014,Wild Bean Cafe,Eating Out,1,1144
9,4,2014,Pret A Manger,Eating Out,7,1137
10,4,2014,Costa Coffee,Eating Out,2,1135
10,4,2014,ATM Cash Withdrawal,General,20,1115
10,4,2014,Tool Shop,,5,1110
11,4,2014,Morrisons,Groceries,85,1025
11,4,2014,Wild Bean Cafe,Eating Out,2,1023
11,4,2014,Greggs,Eating Out,6,1017
13,4,2014,Pizza Express,Eating Out,32,985
13,4,2014,ATM Cash Withdrawal,General,10,975
14,4,2014,South West Trains,Transport,33,942
14,4,2014,Caffe Nero,Eating Out,2,940
14,4,2014,Greggs,Eating Out,5,935
15,4,2014,BRGAS-Electricity,Bills,32,903
15,4,2014,BRGAS-Gas,Bills,24,879
15,4,2014,Wild Bean Cafe,Eating Out,2,877
16,4,2014,LBS Council Tax,Bills,50,827
16,4,2014,Wild Bean Cafe,Eating Out,1,826
16,4,2014,McDonalds,Eating Out,4,822
17,4,2014,McDonalds,Eating Out,6,816
17,4,2014,ATM Cash Withdrawal,General,20,796
18,4,2014,Tescos,Groceries,70,726
18,4,2014,Caffe Nero,Eating Out,2,724
18,4,2014,ATM Cash Withdrawal,General,10,714
18,4,2014,Paying back Julie,,2,712
19,4,2014,The Grand Pub,Eating Out,7,705
19,4,2014,The Grand Pub,Eating Out,8,697
19,4,2014,The Grand Pub,Eating Out,13,684
19,4,2014,The Grand Pub,Eating Out,9,675
19,4,2014,The Grand Pub,Eating Out,12,663
20,4,2014,VIRGIN MEDIA PYMTS,Bills,53,610
20,4,2014,Dominos Pizza,Eating Out,36,574
21,4,2014,South West Trains,Transport,29,545
21,4,2014,Starbucks Coffee,Eating Out,1,544
21,4,2014,McDonalds,Eating Out,5,539
21,4,2014,ATM Cash Withdrawal,General,20,519
22,4,2014,Caffe Nero,Eating Out,1,518
23,4,2014,Wild Bean Cafe,Eating Out,2,516
23,4,2014,Chicken Cottage,Eating Out,6,510
24,4,2014,O2,Bills,33,477
24,4,2014,Wild Bean Cafe,Eating Out,2,475
24,4,2014,Greggs,Eating Out,7,468
24,4,2014,ATM Cash Withdrawal,General,10,458
25,4,2014,ASDA,Groceries,75,383
25,4,2014,Wild Bean Cafe,Eating Out,2,381
25,4,2014,Pret A Manger,Eating Out,5,376
26,4,2014,Restaurant Gordon RamsayPortland Restaurant,Eating Out,33,343
28,4,2014,South West Trains,Transport,29,314
28,4,2014,Greggs,Eating Out,5,309
28,4,2014,ATM Cash Withdrawal,General,20,289
29,4,2014,Wild Bean Cafe,Eating Out,2,287
29,4,2014,Chicken Cottage,Eating Out,6,281
30,4,2014,Caffe Nero,Eating Out,2,279
30,4,2014,ATM Cash Withdrawal,General,10,269
1,5,2014,Rhino Sports salary,General,1700,1969
1,5,2014,Wild Bean Cafe,Eating Out,1,1968
2,5,2014,Tescos,Groceries,45,1923
2,5,2014,Costa Coffee,Eating Out,2,1921
3,5,2014,ATM Cash Withdrawal,General,20,1901
4,5,2014,Scott's Restaurant,Eating Out,53,1848
4,5,2014,ATM Cash Withdrawal,General,20,1828
5,5,2014,South West Trains,Transport,29,1799
5,5,2014,Greggs,Eating Out,5,1794
6,5,2014,Costa Coffee,Eating Out,1,1793
6,5,2014,Greggs,Eating Out,8,1785
7,5,2014,Cubit and West rent,Rent,550,1235
7,5,2014,Caffe Nero,Eating Out,1,1234
8,5,2014,Starbucks Coffee,Eating Out,2,1232
8,5,2014,Greggs,Eating Out,4,1228
9,5,2014,Morrisons,Groceries,60,1168
9,5,2014,Starbucks Coffee,Eating Out,2,1166
9,5,2014,Greggs,Eating Out,7,1159
9,5,2014,ATM Cash Withdrawal,General,10,1149
10,5,2014,Anglo restaurant,Eating Out,48,1101
12,5,2014,South West Trains,Transport,27,1074
12,5,2014,Caffe Nero,Eating Out,2,1072
12,5,2014,ATM Cash Withdrawal,General,20,1052
13,5,2014,Starbucks Coffee,Eating Out,2,1050
13,5,2014,McDonalds,Eating Out,8,1042
13,5,2014,ATM Cash Withdrawal,General,20,1022
14,5,2014,Caffe Nero,Eating Out,2,1020
15,5,2014,BRGAS-Electricity,Bills,26,994
15,5,2014,BRGAS-Gas,Bills,23,971
15,5,2014,The West Cornwall Pasty Company,Eating Out,6,965
16,5,2014,LBS Council Tax,Bills,50,915
16,5,2014,ASDA,Groceries,72,843
16,5,2014,Costa Coffee,Eating Out,1,842
16,5,2014,McDonalds,Eating Out,6,836
16,5,2014,ATM Cash Withdrawal,General,20,816
17,5,2014,Dominos Pizza,Eating Out,45,771
18,5,2014,Anglo restaurant,Eating Out,58,713
18,5,2014,ATM Cash Withdrawal,General,10,703
19,5,2014,South West Trains,Transport,26,677
19,5,2014,Starbucks Coffee,Eating Out,1,676
19,5,2014,ATM Cash Withdrawal,General,10,666
20,5,2014,VIRGIN MEDIA PYMTS,Bills,28,638
20,5,2014,Greggs,Eating Out,7,631
21,5,2014,Chicken Cottage,Eating Out,5,626
21,5,2014,ATM Cash Withdrawal,General,10,616
22,5,2014,Costa Coffee,Eating Out,1,615
23,5,2014,Morrisons,Groceries,51,564
23,5,2014,Starbucks Coffee,Eating Out,2,562
23,5,2014,McDonalds,Eating Out,8,554
23,5,2014,Scott's Restaurant,Eating Out,42,512
23,5,2014,Tool Tec,,1,511
24,5,2014,O2,Bills,30,481
24,5,2014,Dominos Pizza,Eating Out,53,428
25,5,2014,Anglo restaurant,Eating Out,52,376
26,5,2014,South West Trains,Transport,31,345
26,5,2014,Caffe Nero,Eating Out,2,343
26,5,2014,Pret A Manger,Eating Out,7,336
26,5,2014,ATM Cash Withdrawal,General,20,316
27,5,2014,Costa Coffee,Eating Out,2,314
27,5,2014,Subway,Eating Out,4,310
28,5,2014,Starbucks Coffee,Eating Out,1,309
28,5,2014,Subway,Eating Out,4,305
29,5,2014,Costa Coffee,Eating Out,1,304
29,5,2014,The West Cornwall Pasty Company,Eating Out,6,298
30,5,2014,Morrisons,Groceries,45,253
30,5,2014,Starbucks Coffee,Eating Out,2,251
30,5,2014,Restaurant Gordon RamsayPortland Restaurant,Eating Out,56,195
30,5,2014,ATM Cash Withdrawal,General,20,175
31,5,2014,ATM Cash Withdrawal,General,20,155
1,6,2014,Rhino Sports salary,General,1700,1855
2,6,2014,South West Trains,Transport,32,1823
2,6,2014,Wild Bean Cafe,Eating Out,2,1821
3,6,2014,Starbucks Coffee,Eating Out,2,1819
3,6,2014,ATM Cash Withdrawal,General,20,1799
4,6,2014,Wild Bean Cafe,Eating Out,2,1797
4,6,2014,McDonalds,Eating Out,6,1791
5,6,2014,Caffe Nero,Eating Out,1,1790
5,6,2014,Pret A Manger,Eating Out,7,1783
5,6,2014,ATM Cash Withdrawal,General,20,1763
6,6,2014,ASDA,Groceries,55,1708
6,6,2014,Starbucks Coffee,Eating Out,2,1706
6,6,2014,Pizza Express,Eating Out,56,1650
7,6,2014,Cubit and West rent,Rent,550,1100
7,6,2014,Fabric Club,Eating Out,16,1084
7,6,2014,Fabric Club,Eating Out,16,1068
7,6,2014,Fabric Club,Eating Out,9,1059
8,6,2014,Dominos Pizza,Eating Out,39,1020
8,6,2014,ATM Cash Withdrawal,General,10,1010
8,6,2014,Civic Shop,,7,1003
9,6,2014,South West Trains,Transport,24,979
9,6,2014,Starbucks Coffee,Eating Out,2,977
9,6,2014,Greggs,Eating Out,4,973
9,6,2014,ATM Cash Withdrawal,General,10,963
10,6,2014,Costa Coffee,Eating Out,2,961
10,6,2014,Greggs,Eating Out,6,955
11,6,2014,Wild Bean Cafe,Eating Out,2,953
11,6,2014,Pret A Manger,Eating Out,7,946
11,6,2014,ATM Cash Withdrawal,General,10,936
12,6,2014,McDonalds,Eating Out,6,930
12,6,2014,ATM Cash Withdrawal,General,10,920
13,6,2014,Waitrose,Groceries,80,840
13,6,2014,The West Cornwall Pasty Company,Eating Out,7,833
14,6,2014,ATM Cash Withdrawal,General,10,823
14,6,2014,Paying back James,,8,815
15,6,2014,BRGAS-Electricity,Bills,36,779
15,6,2014,BRGAS-Gas,Bills,22,757
15,6,2014,Pizza Express,Eating Out,54,703
16,6,2014,LBS Council Tax,Bills,50,653
16,6,2014,South West Trains,Transport,38,615
16,6,2014,The West Cornwall Pasty Company,Eating Out,8,607
17,6,2014,Costa Coffee,Eating Out,2,605
17,6,2014,ATM Cash Withdrawal,General,20,585
18,6,2014,Starbucks Coffee,Eating Out,1,584
18,6,2014,Pret A Manger,Eating Out,7,577
19,6,2014,Wild Bean Cafe,Eating Out,2,575
19,6,2014,McDonalds,Eating Out,7,568
20,6,2014,VIRGIN MEDIA PYMTS,Bills,38,530
20,6,2014,Sainsburys,Groceries,87,443
20,6,2014,Caffe Nero,Eating Out,2,441
20,6,2014,Subway,Eating Out,4,437
20,6,2014,Anglo restaurant,Eating Out,27,410
22,6,2014,Dominos Pizza,Eating Out,42,368
23,6,2014,South West Trains,Transport,24,344
23,6,2014,Costa Coffee,Eating Out,2,342
23,6,2014,The West Cornwall Pasty Company,Eating Out,7,335
24,6,2014,O2,Bills,31,304
24,6,2014,Costa Coffee,Eating Out,1,303
24,6,2014,Chicken Cottage,Eating Out,5,298
25,6,2014,Caffe Nero,Eating Out,1,297
25,6,2014,ATM Cash Withdrawal,General,20,277
26,6,2014,McDonalds,Eating Out,7,270
27,6,2014,Morrisons,Groceries,59,211
27,6,2014,Costa Coffee,Eating Out,2,209
27,6,2014,Greggs,Eating Out,6,203
29,6,2014,ATM Cash Withdrawal,General,20,183
30,6,2014,South West Trains,Transport,32,151
30,6,2014,Costa Coffee,Eating Out,2,149
30,6,2014,Greggs,Eating Out,8,141
30,6,2014,ATM Cash Withdrawal,General,10,131
1,7,2014,Rhino Sports salary,General,1700,1831
1,7,2014,Caffe Nero,Eating Out,1,1830
1,7,2014,Greggs,Eating Out,7,1823
2,7,2014,Chicken Cottage,Eating Out,7,1816
2,7,2014,Paying back James,,6,1810
3,7,2014,Costa Coffee,Eating Out,2,1808
3,7,2014,Subway,Eating Out,5,1803
4,7,2014,Tescos,Groceries,65,1738
4,7,2014,Wild Bean Cafe,Eating Out,2,1736
4,7,2014,Anglo restaurant,Eating Out,31,1705
6,7,2014,ATM Cash Withdrawal,General,10,1695
7,7,2014,Cubit and West rent,Rent,550,1145
7,7,2014,South West Trains,Transport,33,1112
7,7,2014,Subway,Eating Out,4,1108
8,7,2014,Wild Bean Cafe,Eating Out,1,1107
9,7,2014,Costa Coffee,Eating Out,2,1105
9,7,2014,Chicken Cottage,Eating Out,4,1101
9,7,2014,ATM Cash Withdrawal,General,10,1091
10,7,2014,ATM Cash Withdrawal,General,20,1071
11,7,2014,ASDA,Groceries,72,999
11,7,2014,Wild Bean Cafe,Eating Out,1,998
11,7,2014,Greggs,Eating Out,4,994
11,7,2014,Scott's Restaurant,Eating Out,34,960
11,7,2014,ATM Cash Withdrawal,General,10,950
12,7,2014,ATM Cash Withdrawal,General,20,930
14,7,2014,South West Trains,Transport,26,904
14,7,2014,The West Cornwall Pasty Company,Eating Out,8,896
15,7,2014,BRGAS-Electricity,Bills,37,859
15,7,2014,BRGAS-Gas,Bills,34,825
15,7,2014,Costa Coffee,Eating Out,2,823
15,7,2014,Subway,Eating Out,4,819
16,7,2014,LBS Council Tax,Bills,50,769
16,7,2014,Chicken Cottage,Eating Out,8,761
17,7,2014,Wild Bean Cafe,Eating Out,1,760
17,7,2014,Greggs,Eating Out,5,755
18,7,2014,Morrisons,Groceries,42,713
18,7,2014,Caffe Nero,Eating Out,2,711
18,7,2014,Restaurant Gordon RamsayPortland Restaurant,Eating Out,54,657
18,7,2014,ATM Cash Withdrawal,General,20,637
20,7,2014,VIRGIN MEDIA PYMTS,Bills,51,586
20,7,2014,ATM Cash Withdrawal,General,20,566
21,7,2014,South West Trains,Transport,31,535
21,7,2014,Caffe Nero,Eating Out,1,534
21,7,2014,Chicken Cottage,Eating Out,8,526
21,7,2014,ATM Cash Withdrawal,General,10,516
22,7,2014,Pret A Manger,Eating Out,5,511
22,7,2014,ATM Cash Withdrawal,General,20,491
23,7,2014,Pret A Manger,Eating Out,7,484
24,7,2014,O2,Bills,31,453
24,7,2014,Caffe Nero,Eating Out,1,452
25,7,2014,Morrisons,Groceries,79,373
25,7,2014,Wild Bean Cafe,Eating Out,2,371
25,7,2014,Anglo restaurant,Eating Out,51,320
25,7,2014,ATM Cash Withdrawal,General,10,310
26,7,2014,Fabric Club,Eating Out,14,296
26,7,2014,Fabric Club,Eating Out,13,283
26,7,2014,Fabric Club,Eating Out,14,269
26,7,2014,Fabric Club,Eating Out,14,255
27,7,2014,ATM Cash Withdrawal,General,20,235
28,7,2014,South West Trains,Transport,33,202
28,7,2014,Starbucks Coffee,Eating Out,2,200
28,7,2014,ATM Cash Withdrawal,General,20,180
29,7,2014,Caffe Nero,Eating Out,1,179
29,7,2014,ATM Cash Withdrawal,General,10,169
30,7,2014,Starbucks Coffee,Eating Out,2,167
30,7,2014,Chicken Cottage,Eating Out,7,160
31,7,2014,Wild Bean Cafe,Eating Out,2,158
31,7,2014,ATM Cash Withdrawal,General,20,138
1,8,2014,Rhino Sports salary,General,1700,1838
1,8,2014,Morrisons,Groceries,61,1777
1,8,2014,Costa Coffee,Eating Out,1,1776
1,8,2014,McDonalds,Eating Out,5,1771
1,8,2014,Anglo restaurant,Eating Out,47,1724
3,8,2014,Anglo restaurant,Eating Out,39,1685
4,8,2014,South West Trains,Transport,30,1655
5,8,2014,Starbucks Coffee,Eating Out,1,1654
6,8,2014,Wild Bean Cafe,Eating Out,2,1652
6,8,2014,Greggs,Eating Out,4,1648
7,8,2014,Cubit and West rent,Rent,550,1098
7,8,2014,Wild Bean Cafe,Eating Out,1,1097
7,8,2014,The West Cornwall Pasty Company,Eating Out,5,1092
8,8,2014,Morrisons,Groceries,87,1005
8,8,2014,Wild Bean Cafe,Eating Out,2,1003
8,8,2014,Fabric Club,Eating Out,5,998
9,8,2014,ATM Cash Withdrawal,General,20,978
11,8,2014,South West Trains,Transport,36,942
11,8,2014,Costa Coffee,Eating Out,2,940
11,8,2014,Pret A Manger,Eating Out,5,935
12,8,2014,Wild Bean Cafe,Eating Out,1,934
13,8,2014,Starbucks Coffee,Eating Out,1,933
13,8,2014,ATM Cash Withdrawal,General,10,923
14,8,2014,Greggs,Eating Out,5,918
15,8,2014,BRGAS-Electricity,Bills,31,887
15,8,2014,BRGAS-Gas,Bills,36,851
15,8,2014,Sainsburys,Groceries,77,774
15,8,2014,Starbucks Coffee,Eating Out,2,772
15,8,2014,The West Cornwall Pasty Company,Eating Out,5,767
15,8,2014,Scott's Restaurant,Eating Out,49,718
16,8,2014,LBS Council Tax,Bills,50,668
17,8,2014,Scott's Restaurant,Eating Out,30,638
18,8,2014,South West Trains,Transport,30,608
18,8,2014,Costa Coffee,Eating Out,2,606
19,8,2014,Wild Bean Cafe,Eating Out,2,604
20,8,2014,VIRGIN MEDIA PYMTS,Bills,31,573
20,8,2014,Costa Coffee,Eating Out,1,572
20,8,2014,Pret A Manger,Eating Out,7,565
21,8,2014,Costa Coffee,Eating Out,2,563
21,8,2014,Pret A Manger,Eating Out,6,557
22,8,2014,Sainsburys,Groceries,88,469
22,8,2014,The Grand Pub,Eating Out,5,464
22,8,2014,The Grand Pub,Eating Out,9,455
22,8,2014,The Grand Pub,Eating Out,6,449
22,8,2014,The Grand Pub,Eating Out,11,438
22,8,2014,The Grand Pub,Eating Out,5,433
22,8,2014,The Grand Pub,Eating Out,16,417
23,8,2014,Heaven Club,Eating Out,16,401
23,8,2014,Heaven Club,Eating Out,7,394
23,8,2014,Heaven Club,Eating Out,14,380
23,8,2014,Heaven Club,Eating Out,12,368
23,8,2014,Heaven Club,Eating Out,10,358
23,8,2014,Heaven Club,Eating Out,7,351
24,8,2014,O2,Bills,32,319
24,8,2014,Scott's Restaurant,Eating Out,30,289
24,8,2014,Tool Tec,,5,284
25,8,2014,South West Trains,Transport,34,250
25,8,2014,Wild Bean Cafe,Eating Out,2,248
26,8,2014,Starbucks Coffee,Eating Out,2,246
26,8,2014,Paying back Julie,,3,243
27,8,2014,Caffe Nero,Eating Out,2,241
28,8,2014,Starbucks Coffee,Eating Out,2,239
28,8,2014,The West Cornwall Pasty Company,Eating Out,8,231
29,8,2014,Morrisons,Groceries,77,154
29,8,2014,The West Cornwall Pasty Company,Eating Out,8,146
29,8,2014,Fabric Club,Eating Out,11,135
29,8,2014,Fabric Club,Eating Out,7,128
29,8,2014,Fabric Club,Eating Out,15,113
29,8,2014,Fabric Club,Eating Out,10,103
29,8,2014,Fabric Club,Eating Out,6,97
29,8,2014,ATM Cash Withdrawal,General,20,77
30,8,2014,Restaurant Gordon RamsayPortland Restaurant,Eating Out,25,52
31,8,2014,Scott's Restaurant,Eating Out,51,1
31,8,2014,Tool Tec,,2,-1
1,9,2014,Rhino Sports salary,General,1700,1699
1,9,2014,South West Trains,Transport,32,1667
1,9,2014,Caffe Nero,Eating Out,2,1665
1,9,2014,Greggs,Eating Out,5,1660
2,9,2014,Costa Coffee,Eating Out,1,1659
3,9,2014,The West Cornwall Pasty Company,Eating Out,6,1653
4,9,2014,Starbucks Coffee,Eating Out,2,1651
4,9,2014,Pret A Manger,Eating Out,7,1644
5,9,2014,Tescos,Groceries,77,1567
5,9,2014,Caffe Nero,Eating Out,1,1566
5,9,2014,McDonalds,Eating Out,7,1559
5,9,2014,Restaurant Gordon RamsayPortland Restaurant,Eating Out,57,1502
5,9,2014,ATM Cash Withdrawal,General,10,1492
6,9,2014,Heaven Club,Eating Out,6,1486
6,9,2014,Heaven Club,Eating Out,13,1473
6,9,2014,Heaven Club,Eating Out,12,1461
6,9,2014,ATM Cash Withdrawal,General,10,1451
7,9,2014,Cubit and West rent,Rent,550,901
7,9,2014,ATM Cash Withdrawal,General,20,881
8,9,2014,South West Trains,Transport,32,849
8,9,2014,Costa Coffee,Eating Out,1,848
8,9,2014,ATM Cash Withdrawal,General,10,838
9,9,2014,Caffe Nero,Eating Out,1,837
10,9,2014,ATM Cash Withdrawal,General,10,827
11,9,2014,Greggs,Eating Out,8,819
11,9,2014,ATM Cash Withdrawal,General,20,799
12,9,2014,Morrisons,Groceries,81,718
12,9,2014,Wild Bean Cafe,Eating Out,1,717
12,9,2014,The West Cornwall Pasty Company,Eating Out,7,710
12,9,2014,Restaurant Gordon RamsayPortland Restaurant,Eating Out,49,661
13,9,2014,Ministry of Sound ClubXOYO Club,Eating Out,12,649
13,9,2014,Ministry of Sound ClubXOYO Club,Eating Out,5,644
13,9,2014,ATM Cash Withdrawal,General,10,634
15,9,2014,BRGAS-Electricity,Bills,35,599
15,9,2014,BRGAS-Gas,Bills,33,566
15,9,2014,South West Trains,Transport,32,534
15,9,2014,Starbucks Coffee,Eating Out,2,532
15,9,2014,The West Cornwall Pasty Company,Eating Out,5,527
16,9,2014,LBS Council Tax,Bills,50,477
16,9,2014,Starbucks Coffee,Eating Out,2,475
17,9,2014,Subway,Eating Out,8,467
17,9,2014,ATM Cash Withdrawal,General,10,457
18,9,2014,Starbucks Coffee,Eating Out,2,455
19,9,2014,ASDA,Groceries,79,376
20,9,2014,VIRGIN MEDIA PYMTS,Bills,59,317
22,9,2014,South West Trains,Transport,29,288
22,9,2014,Wild Bean Cafe,Eating Out,1,287
22,9,2014,Subway,Eating Out,8,279
23,9,2014,ATM Cash Withdrawal,General,10,269
24,9,2014,O2,Bills,38,231
24,9,2014,The West Cornwall Pasty Company,Eating Out,4,227
25,9,2014,Caffe Nero,Eating Out,1,226
25,9,2014,The West Cornwall Pasty Company,Eating Out,4,222
26,9,2014,Waitrose,Groceries,52,170
26,9,2014,Costa Coffee,Eating Out,2,168
26,9,2014,Scott's Restaurant,Eating Out,56,112
26,9,2014,Paying back Julie,,7,105
29,9,2014,South West Trains,Transport,24,81
30,9,2014,Caffe Nero,Eating Out,2,79
30,9,2014,The West Cornwall Pasty Company,Eating Out,8,71
1,10,2014,Rhino Sports salary,General,1700,1771
1,10,2014,Costa Coffee,Eating Out,2,1769
1,10,2014,Subway,Eating Out,5,1764
1,10,2014,Civic Shop,,8,1756
2,10,2014,Starbucks Coffee,Eating Out,1,1755
2,10,2014,Pret A Manger,Eating Out,7,1748
3,10,2014,Waitrose,Groceries,62,1686
3,10,2014,Wild Bean Cafe,Eating Out,1,1685
3,10,2014,McDonalds,Eating Out,4,1681
3,10,2014,Heaven Club,Eating Out,16,1665
3,10,2014,Heaven Club,Eating Out,5,1660
3,10,2014,Heaven Club,Eating Out,9,1651
4,10,2014,Pizza Express,Eating Out,41,1610
4,10,2014,ATM Cash Withdrawal,General,20,1590
5,10,2014,Dominos Pizza,Eating Out,51,1539
6,10,2014,South West Trains,Transport,25,1514
6,10,2014,Costa Coffee,Eating Out,2,1512
6,10,2014,Chicken Cottage,Eating Out,4,1508
7,10,2014,Cubit and West rent,Rent,550,958
7,10,2014,Costa Coffee,Eating Out,2,956
7,10,2014,Chicken Cottage,Eating Out,7,949
8,10,2014,Starbucks Coffee,Eating Out,2,947
8,10,2014,McDonalds,Eating Out,6,941
9,10,2014,Caffe Nero,Eating Out,2,939
9,10,2014,Greggs,Eating Out,4,935
10,10,2014,ASDA,Groceries,45,890
10,10,2014,Wild Bean Cafe,Eating Out,1,889
10,10,2014,Greggs,Eating Out,5,884
11,10,2014,ATM Cash Withdrawal,General,20,864
12,10,2014,Pizza Express,Eating Out,28,836
12,10,2014,Tool Shop,,2,834
13,10,2014,South West Trains,Transport,29,805
13,10,2014,Subway,Eating Out,8,797
14,10,2014,Chicken Cottage,Eating Out,7,790
14,10,2014,ATM Cash Withdrawal,General,20,770
15,10,2014,BRGAS-Electricity,Bills,23,747
15,10,2014,BRGAS-Gas,Bills,39,708
15,10,2014,Caffe Nero,Eating Out,1,707
16,10,2014,LBS Council Tax,Bills,50,657
16,10,2014,Caffe Nero,Eating Out,2,655
16,10,2014,McDonalds,Eating Out,8,647
16,10,2014,ATM Cash Withdrawal,General,10,637
17,10,2014,Sainsburys,Groceries,74,563
17,10,2014,Chicken Cottage,Eating Out,8,555
20,10,2014,VIRGIN MEDIA PYMTS,Bills,32,523
20,10,2014,South West Trains,Transport,33,490
20,10,2014,Costa Coffee,Eating Out,2,488
20,10,2014,Greggs,Eating Out,4,484
21,10,2014,Caffe Nero,Eating Out,2,482
22,10,2014,Tool Tec,,6,476
23,10,2014,McDonalds,Eating Out,5,471
24,10,2014,O2,Bills,33,438
24,10,2014,ASDA,Groceries,48,390
24,10,2014,McDonalds,Eating Out,5,385
24,10,2014,Restaurant Gordon RamsayPortland Restaurant,Eating Out,57,328
26,10,2014,ATM Cash Withdrawal,General,10,318
27,10,2014,South West Trains,Transport,36,282
27,10,2014,Costa Coffee,Eating Out,2,280
27,10,2014,The West Cornwall Pasty Company,Eating Out,4,276
28,10,2014,Caffe Nero,Eating Out,1,275
29,10,2014,ATM Cash Withdrawal,General,20,255
30,10,2014,Wild Bean Cafe,Eating Out,1,254
30,10,2014,Tool Shop,,4,250
31,10,2014,Tescos,Groceries,71,179
31,10,2014,Chicken Cottage,Eating Out,6,173
31,10,2014,ATM Cash Withdrawal,General,10,163
1,11,2014,Rhino Sports salary,General,1700,1863
3,11,2014,South West Trains,Transport,34,1829
3,11,2014,Costa Coffee,Eating Out,2,1827
3,11,2014,Subway,Eating Out,6,1821
3,11,2014,ATM Cash Withdrawal,General,20,1801
3,11,2014,Red Shop,,8,1793
4,11,2014,Pret A Manger,Eating Out,7,1786
5,11,2014,McDonalds,Eating Out,5,1781
5,11,2014,Civic Shop,,9,1772
6,11,2014,Caffe Nero,Eating Out,2,1770
6,11,2014,Greggs,Eating Out,4,1766
7,11,2014,Cubit and West rent,Rent,550,1216
7,11,2014,Waitrose,Groceries,58,1158
7,11,2014,Wild Bean Cafe,Eating Out,2,1156
7,11,2014,Pret A Manger,Eating Out,6,1150
8,11,2014,ATM Cash Withdrawal,General,20,1130
9,11,2014,ATM Cash Withdrawal,General,20,1110
10,11,2014,South West Trains,Transport,37,1073
10,11,2014,Costa Coffee,Eating Out,1,1072
10,11,2014,Subway,Eating Out,4,1068
11,11,2014,Caffe Nero,Eating Out,2,1066
11,11,2014,Greggs,Eating Out,5,1061
11,11,2014,ATM Cash Withdrawal,General,20,1041
12,11,2014,Costa Coffee,Eating Out,2,1039
12,11,2014,Tool Tec,,5,1034
14,11,2014,Tescos,Groceries,80,954
14,11,2014,Starbucks Coffee,Eating Out,2,952
14,11,2014,The West Cornwall Pasty Company,Eating Out,6,946
14,11,2014,Fabric Club,Eating Out,11,935
14,11,2014,Scott's Restaurant,Eating Out,30,905
14,11,2014,ATM Cash Withdrawal,General,20,885
14,11,2014,Paying back Julie,,9,876
15,11,2014,BRGAS-Electricity,Bills,79,797
15,11,2014,BRGAS-Gas,Bills,42,755
16,11,2014,LBS Council Tax,Bills,50,705
16,11,2014,Anglo restaurant,Eating Out,53,652
17,11,2014,South West Trains,Transport,24,628
17,11,2014,Costa Coffee,Eating Out,2,626
17,11,2014,Subway,Eating Out,8,618
18,11,2014,Costa Coffee,Eating Out,2,616
18,11,2014,ATM Cash Withdrawal,General,10,606
18,11,2014,Paying back Julie,,9,597
19,11,2014,Costa Coffee,Eating Out,2,595
19,11,2014,Chicken Cottage,Eating Out,8,587
19,11,2014,ATM Cash Withdrawal,General,10,577
19,11,2014,Civic Shop,,1,576
20,11,2014,VIRGIN MEDIA PYMTS,Bills,36,540
20,11,2014,Subway,Eating Out,7,533
21,11,2014,ASDA,Groceries,53,480
21,11,2014,Greggs,Eating Out,6,474
21,11,2014,The Grand Pub,Eating Out,14,460
22,11,2014,Restaurant Gordon RamsayPortland Restaurant,Eating Out,40,420
22,11,2014,ATM Cash Withdrawal,General,20,400
23,11,2014,Scott's Restaurant,Eating Out,39,361
24,11,2014,O2,Bills,36,325
24,11,2014,South West Trains,Transport,28,297
24,11,2014,Caffe Nero,Eating Out,1,296
24,11,2014,Chicken Cottage,Eating Out,4,292
25,11,2014,Greggs,Eating Out,5,287
25,11,2014,ATM Cash Withdrawal,General,10,277
25,11,2014,Tool Shop,,3,274
26,11,2014,Costa Coffee,Eating Out,1,273
26,11,2014,Chicken Cottage,Eating Out,6,267
26,11,2014,ATM Cash Withdrawal,General,20,247
27,11,2014,Caffe Nero,Eating Out,1,246
27,11,2014,Subway,Eating Out,5,241
28,11,2014,Waitrose,Groceries,52,189
28,11,2014,Caffe Nero,Eating Out,2,187
28,11,2014,Chicken Cottage,Eating Out,5,182
28,11,2014,Restaurant Gordon RamsayPortland Restaurant,Eating Out,48,134
29,11,2014,Heaven Club,Eating Out,5,129
29,11,2014,Heaven Club,Eating Out,16,113
29,11,2014,Heaven Club,Eating Out,8,105
29,11,2014,Heaven Club,Eating Out,5,100
1,12,2014,Rhino Sports salary,General,1700,1800
1,12,2014,South West Trains,Transport,33,1767
1,12,2014,Caffe Nero,Eating Out,1,1766
2,12,2014,Starbucks Coffee,Eating Out,2,1764
2,12,2014,ATM Cash Withdrawal,General,10,1754
3,12,2014,Caffe Nero,Eating Out,1,1753
3,12,2014,Subway,Eating Out,6,1747
4,12,2014,Caffe Nero,Eating Out,2,1745
4,12,2014,Pret A Manger,Eating Out,4,1741
4,12,2014,ATM Cash Withdrawal,General,10,1731
5,12,2014,Sainsburys,Groceries,71,1660
5,12,2014,Starbucks Coffee,Eating Out,1,1659
5,12,2014,Pizza Express,Eating Out,28,1631
7,12,2014,Cubit and West rent,Rent,550,1081
8,12,2014,South West Trains,Transport,37,1044
8,12,2014,Costa Coffee,Eating Out,2,1042
8,12,2014,Greggs,Eating Out,4,1038
8,12,2014,ATM Cash Withdrawal,General,10,1028
9,12,2014,Wild Bean Cafe,Eating Out,2,1026
9,12,2014,Tool Tec,,6,1020
10,12,2014,ATM Cash Withdrawal,General,10,1010
11,12,2014,Costa Coffee,Eating Out,1,1009
11,12,2014,Pret A Manger,Eating Out,7,1002
11,12,2014,Tool Tec,,3,999
12,12,2014,Morrisons,Groceries,88,911
12,12,2014,Costa Coffee,Eating Out,2,909
12,12,2014,Chicken Cottage,Eating Out,7,902
13,12,2014,ATM Cash Withdrawal,General,20,882
13,12,2014,Paying back Julie,,1,881
15,12,2014,BRGAS-Electricity,Bills,39,842
15,12,2014,BRGAS-Gas,Bills,30,812
15,12,2014,South West Trains,Transport,24,788
15,12,2014,Starbucks Coffee,Eating Out,2,786
15,12,2014,McDonalds,Eating Out,8,778
16,12,2014,LBS Council Tax,Bills,50,728
16,12,2014,Caffe Nero,Eating Out,2,726
16,12,2014,ATM Cash Withdrawal,General,20,706
17,12,2014,Wild Bean Cafe,Eating Out,2,704
17,12,2014,Greggs,Eating Out,6,698
17,12,2014,ATM Cash Withdrawal,General,10,688
18,12,2014,Caffe Nero,Eating Out,2,686
18,12,2014,ATM Cash Withdrawal,General,20,666
19,12,2014,Waitrose,Groceries,75,591
19,12,2014,Caffe Nero,Eating Out,1,590
19,12,2014,Chicken Cottage,Eating Out,7,583
19,12,2014,Dominos Pizza,Eating Out,28,555
20,12,2014,VIRGIN MEDIA PYMTS,Bills,44,511
20,12,2014,Pizza Express,Eating Out,31,480
21,12,2014,Pizza Express,Eating Out,58,422
22,12,2014,South West Trains,Transport,34,388
22,12,2014,Wild Bean Cafe,Eating Out,2,386
22,12,2014,Chicken Cottage,Eating Out,7,379
23,12,2014,Wild Bean Cafe,Eating Out,2,377
23,12,2014,Subway,Eating Out,4,373
24,12,2014,O2,Bills,38,335
24,12,2014,Wild Bean Cafe,Eating Out,2,333
25,12,2014,Costa Coffee,Eating Out,1,332
25,12,2014,Pret A Manger,Eating Out,4,328
26,12,2014,ASDA,Groceries,86,242
26,12,2014,Costa Coffee,Eating Out,2,240
28,12,2014,Restaurant Gordon RamsayPortland Restaurant,Eating Out,52,188
28,12,2014,ATM Cash Withdrawal,General,10,178
29,12,2014,South West Trains,Transport,32,146
29,12,2014,Greggs,Eating Out,6,140
29,12,2014,ATM Cash Withdrawal,General,10,130
30,12,2014,Starbucks Coffee,Eating Out,2,128
30,12,2014,The West Cornwall Pasty Company,Eating Out,6,122
30,12,2014,ATM Cash Withdrawal,General,20,102
30,12,2014,Tool Shop,,2,100
31,12,2014,Caffe Nero,Eating Out,1,99
1,1,2015,Rhino Sports salary,General,1700,1799
1,1,2015,Wild Bean Cafe,Eating Out,2,1797
1,1,2015,Red Shop,,3,1794
2,1,2015,Sainsburys,Groceries,58,1736
2,1,2015,Heaven Club,Eating Out,5,1731
2,1,2015,Heaven Club,Eating Out,15,1716
2,1,2015,Heaven Club,Eating Out,10,1706
2,1,2015,Heaven Club,Eating Out,11,1695
2,1,2015,ATM Cash Withdrawal,General,10,1685
3,1,2015,Dominos Pizza,Eating Out,24,1661
4,1,2015,Restaurant Gordon RamsayPortland Restaurant,Eating Out,49,1612
5,1,2015,South West Trains,Transport,30,1582
5,1,2015,Costa Coffee,Eating Out,2,1580
5,1,2015,The West Cornwall Pasty Company,Eating Out,8,1572
5,1,2015,ATM Cash Withdrawal,General,20,1552
6,1,2015,Caffe Nero,Eating Out,1,1551
7,1,2015,Cubit and West rent,Rent,550,1001
7,1,2015,Starbucks Coffee,Eating Out,2,999
7,1,2015,Chicken Cottage,Eating Out,4,995
8,1,2015,Costa Coffee,Eating Out,1,994
8,1,2015,ATM Cash Withdrawal,General,20,974
9,1,2015,Tescos,Groceries,84,890
9,1,2015,Wild Bean Cafe,Eating Out,1,889
10,1,2015,ATM Cash Withdrawal,General,10,879
11,1,2015,ATM Cash Withdrawal,General,20,859
12,1,2015,South West Trains,Transport,38,821
12,1,2015,Caffe Nero,Eating Out,1,820
13,1,2015,Caffe Nero,Eating Out,1,819
13,1,2015,Pret A Manger,Eating Out,6,813
13,1,2015,ATM Cash Withdrawal,General,20,793
14,1,2015,Pret A Manger,Eating Out,6,787
14,1,2015,ATM Cash Withdrawal,General,10,777
15,1,2015,BRGAS-Electricity,Bills,59,718
15,1,2015,BRGAS-Gas,Bills,49,669
16,1,2015,LBS Council Tax,Bills,50,619
16,1,2015,Morrisons,Groceries,60,559
16,1,2015,Starbucks Coffee,Eating Out,2,557
16,1,2015,McDonalds,Eating Out,7,550
17,1,2015,Anglo restaurant,Eating Out,43,507
18,1,2015,ATM Cash Withdrawal,General,20,487
19,1,2015,South West Trains,Transport,38,449
19,1,2015,Wild Bean Cafe,Eating Out,2,447
19,1,2015,Chicken Cottage,Eating Out,5,442
20,1,2015,VIRGIN MEDIA PYMTS,Bills,36,406
20,1,2015,Costa Coffee,Eating Out,2,404
20,1,2015,Pret A Manger,Eating Out,8,396
21,1,2015,Costa Coffee,Eating Out,1,395
21,1,2015,The West Cornwall Pasty Company,Eating Out,7,388
21,1,2015,ATM Cash Withdrawal,General,20,368
22,1,2015,Starbucks Coffee,Eating Out,2,366
22,1,2015,Subway,Eating Out,5,361
23,1,2015,Sainsburys,Groceries,63,298
23,1,2015,Wild Bean Cafe,Eating Out,2,296
24,1,2015,O2,Bills,30,266
24,1,2015,Dominos Pizza,Eating Out,37,229
24,1,2015,Cheam Service Station,,4,225
26,1,2015,South West Trains,Transport,33,192
26,1,2015,Costa Coffee,Eating Out,2,190
26,1,2015,McDonalds,Eating Out,8,182
27,1,2015,Costa Coffee,Eating Out,2,180
27,1,2015,Chicken Cottage,Eating Out,4,176
28,1,2015,Wild Bean Cafe,Eating Out,1,175
28,1,2015,McDonalds,Eating Out,5,170
29,1,2015,Tool Shop,,2,168
30,1,2015,Sainsburys,Groceries,62,106
30,1,2015,Pret A Manger,Eating Out,7,99
30,1,2015,Pizza Express,Eating Out,28,71
30,1,2015,ATM Cash Withdrawal,General,20,51
31,1,2015,Heaven Club,Eating Out,13,38
31,1,2015,Heaven Club,Eating Out,14,24
31,1,2015,Heaven Club,Eating Out,13,11
31,1,2015,ATM Cash Withdrawal,General,20,-9
1,2,2015,Rhino Sports salary,General,1700,1691
2,2,2015,South West Trains,Transport,24,1667
2,2,2015,Starbucks Coffee,Eating Out,2,1665
3,2,2015,Starbucks Coffee,Eating Out,2,1663
4,2,2015,Costa Coffee,Eating Out,2,1661
4,2,2015,Pret A Manger,Eating Out,8,1653
5,2,2015,Costa Coffee,Eating Out,2,1651
5,2,2015,Tool Tec,,5,1646
6,2,2015,Morrisons,Groceries,72,1574
6,2,2015,Caffe Nero,Eating Out,2,1572
6,2,2015,Greggs,Eating Out,7,1565
6,2,2015,Heaven Club,Eating Out,8,1557
6,2,2015,Heaven Club,Eating Out,10,1547
6,2,2015,ATM Cash Withdrawal,General,10,1537
6,2,2015,Red Shop,,9,1528
7,2,2015,Cubit and West rent,Rent,550,978
9,2,2015,South West Trains,Transport,27,951
9,2,2015,Caffe Nero,Eating Out,2,949
9,2,2015,Chicken Cottage,Eating Out,4,945
9,2,2015,Tool Tec,,1,944
11,2,2015,Wild Bean Cafe,Eating Out,2,942
11,2,2015,The West Cornwall Pasty Company,Eating Out,6,936
11,2,2015,ATM Cash Withdrawal,General,20,916
12,2,2015,Starbucks Coffee,Eating Out,1,915
13,2,2015,Waitrose,Groceries,50,865
13,2,2015,Starbucks Coffee,Eating Out,1,864
13,2,2015,McDonalds,Eating Out,4,860
13,2,2015,The Grand Pub,Eating Out,6,854
13,2,2015,The Grand Pub,Eating Out,9,845
13,2,2015,The Grand Pub,Eating Out,8,837
13,2,2015,The Grand Pub,Eating Out,12,825
13,2,2015,Scott's Restaurant,Eating Out,26,799
14,2,2015,Restaurant Gordon RamsayPortland Restaurant,Eating Out,41,758
15,2,2015,BRGAS-Electricity,Bills,32,726
15,2,2015,BRGAS-Gas,Bills,42,684
15,2,2015,Anglo restaurant,Eating Out,48,636
16,2,2015,LBS Council Tax,Bills,50,586
16,2,2015,South West Trains,Transport,34,552
16,2,2015,Costa Coffee,Eating Out,1,551
17,2,2015,Costa Coffee,Eating Out,2,549
17,2,2015,McDonalds,Eating Out,8,541
17,2,2015,Tool Tec,,2,539
18,2,2015,Wild Bean Cafe,Eating Out,2,537
18,2,2015,Greggs,Eating Out,5,532
18,2,2015,Civic Shop,,7,525
19,2,2015,Caffe Nero,Eating Out,2,523
19,2,2015,Cheam Service Station,,9,514
20,2,2015,VIRGIN MEDIA PYMTS,Bills,31,483
20,2,2015,Sainsburys,Groceries,81,402
20,2,2015,Dominos Pizza,Eating Out,40,362
21,2,2015,ATM Cash Withdrawal,General,10,352
22,2,2015,Anglo restaurant,Eating Out,59,293
23,2,2015,South West Trains,Transport,33,260
23,2,2015,Caffe Nero,Eating Out,1,259
23,2,2015,Subway,Eating Out,5,254
23,2,2015,ATM Cash Withdrawal,General,20,234
24,2,2015,O2,Bills,38,196
24,2,2015,Costa Coffee,Eating Out,1,195
24,2,2015,ATM Cash Withdrawal,General,20,175
25,2,2015,Starbucks Coffee,Eating Out,2,173
25,2,2015,Pret A Manger,Eating Out,7,166
26,2,2015,McDonalds,Eating Out,7,159
27,2,2015,ASDA,Groceries,45,114
27,2,2015,Caffe Nero,Eating Out,2,112
27,2,2015,The West Cornwall Pasty Company,Eating Out,6,106
1,3,2015,Rhino Sports salary,General,1700,1806
1,3,2015,Pizza Express,Eating Out,41,1765
2,3,2015,South West Trains,Transport,35,1730
2,3,2015,Starbucks Coffee,Eating Out,2,1728
3,3,2015,Starbucks Coffee,Eating Out,1,1727
3,3,2015,The West Cornwall Pasty Company,Eating Out,7,1720
3,3,2015,ATM Cash Withdrawal,General,20,1700
4,3,2015,Costa Coffee,Eating Out,2,1698
4,3,2015,Subway,Eating Out,5,1693
5,3,2015,Starbucks Coffee,Eating Out,1,1692
5,3,2015,ATM Cash Withdrawal,General,20,1672
6,3,2015,ASDA,Groceries,79,1593
6,3,2015,The West Cornwall Pasty Company,Eating Out,7,1586
6,3,2015,Anglo restaurant,Eating Out,50,1536
6,3,2015,ATM Cash Withdrawal,General,10,1526
7,3,2015,Cubit and West rent,Rent,550,976
7,3,2015,ATM Cash Withdrawal,General,10,966
8,3,2015,Dominos Pizza,Eating Out,45,921
9,3,2015,South West Trains,Transport,30,891
9,3,2015,Chicken Cottage,Eating Out,7,884
9,3,2015,ATM Cash Withdrawal,General,20,864
10,3,2015,Starbucks Coffee,Eating Out,1,863
11,3,2015,Caffe Nero,Eating Out,1,862
11,3,2015,Chicken Cottage,Eating Out,8,854
11,3,2015,Red Shop,,9,845
12,3,2015,Starbucks Coffee,Eating Out,2,843
12,3,2015,The West Cornwall Pasty Company,Eating Out,4,839
13,3,2015,Sainsburys,Groceries,59,780
13,3,2015,Costa Coffee,Eating Out,1,779
13,3,2015,Anglo restaurant,Eating Out,53,726
14,3,2015,ATM Cash Withdrawal,General,10,716
14,3,2015,Tool Shop,,2,714
15,3,2015,BRGAS-Electricity,Bills,38,676
15,3,2015,BRGAS-Gas,Bills,21,655
15,3,2015,Dominos Pizza,Eating Out,42,613
15,3,2015,ATM Cash Withdrawal,General,20,593
16,3,2015,LBS Council Tax,Bills,50,543
16,3,2015,South West Trains,Transport,30,513
16,3,2015,Costa Coffee,Eating Out,2,511
16,3,2015,Pret A Manger,Eating Out,5,506
17,3,2015,ATM Cash Withdrawal,General,10,496
18,3,2015,ATM Cash Withdrawal,General,10,486
19,3,2015,The West Cornwall Pasty Company,Eating Out,4,482
20,3,2015,VIRGIN MEDIA PYMTS,Bills,51,431
20,3,2015,Morrisons,Groceries,83,348
20,3,2015,Costa Coffee,Eating Out,1,347
20,3,2015,Scott's Restaurant,Eating Out,33,314
21,3,2015,ATM Cash Withdrawal,General,10,304
23,3,2015,South West Trains,Transport,26,278
23,3,2015,Starbucks Coffee,Eating Out,1,277
23,3,2015,Tool Shop,,6,271
24,3,2015,O2,Bills,30,241
24,3,2015,Starbucks Coffee,Eating Out,2,239
24,3,2015,Subway,Eating Out,6,233
25,3,2015,Wild Bean Cafe,Eating Out,2,231
25,3,2015,ATM Cash Withdrawal,General,20,211
26,3,2015,Starbucks Coffee,Eating Out,2,209
26,3,2015,The West Cornwall Pasty Company,Eating Out,7,202
27,3,2015,Morrisons,Groceries,63,139
27,3,2015,Starbucks Coffee,Eating Out,2,137
27,3,2015,Pizza Express,Eating Out,48,89
28,3,2015,Dominos Pizza,Eating Out,54,35
30,3,2015,South West Trains,Transport,27,8
30,3,2015,Starbucks Coffee,Eating Out,1,7
30,3,2015,Chicken Cottage,Eating Out,5,2
31,3,2015,Costa Coffee,Eating Out,2,0
31,3,2015,ATM Cash Withdrawal,General,20,-20
31,3,2015,Paying back James,,1,-21
1,4,2015,Rhino Sports salary,General,1700,1679
1,4,2015,Costa Coffee,Eating Out,2,1677
1,4,2015,Subway,Eating Out,6,1671
1,4,2015,ATM Cash Withdrawal,General,20,1651
1,4,2015,Cheam Service Station,,1,1650
2,4,2015,Caffe Nero,Eating Out,2,1648
3,4,2015,ASDA,Groceries,55,1593
3,4,2015,Wild Bean Cafe,Eating Out,2,1591
3,4,2015,Pret A Manger,Eating Out,5,1586
4,4,2015,Scott's Restaurant,Eating Out,37,1549
6,4,2015,South West Trains,Transport,27,1522
6,4,2015,Starbucks Coffee,Eating Out,2,1520
6,4,2015,Civic Shop,,5,1515
7,4,2015,Cubit and West rent,Rent,550,965
7,4,2015,Costa Coffee,Eating Out,2,963
7,4,2015,The West Cornwall Pasty Company,Eating Out,4,959
8,4,2015,Caffe Nero,Eating Out,2,957
8,4,2015,McDonalds,Eating Out,8,949
9,4,2015,Starbucks Coffee,Eating Out,1,948
9,4,2015,ATM Cash Withdrawal,General,20,928
10,4,2015,ASDA,Groceries,58,870
10,4,2015,Costa Coffee,Eating Out,2,868
10,4,2015,Fabric Club,Eating Out,14,854
10,4,2015,Fabric Club,Eating Out,13,841
10,4,2015,Fabric Club,Eating Out,8,833
10,4,2015,Fabric Club,Eating Out,13,820
10,4,2015,Fabric Club,Eating Out,14,806
10,4,2015,Restaurant Gordon RamsayPortland Restaurant,Eating Out,39,767
11,4,2015,Heaven Club,Eating Out,7,760
11,4,2015,Heaven Club,Eating Out,5,755
11,4,2015,Heaven Club,Eating Out,16,739
11,4,2015,Heaven Club,Eating Out,12,727
11,4,2015,Heaven Club,Eating Out,10,717
11,4,2015,Heaven Club,Eating Out,14,703
13,4,2015,South West Trains,Transport,25,678
13,4,2015,Caffe Nero,Eating Out,1,677
14,4,2015,Wild Bean Cafe,Eating Out,2,675
14,4,2015,Subway,Eating Out,6,669
15,4,2015,BRGAS-Electricity,Bills,37,632
15,4,2015,BRGAS-Gas,Bills,41,591
15,4,2015,Costa Coffee,Eating Out,2,589
15,4,2015,Greggs,Eating Out,4,585
16,4,2015,LBS Council Tax,Bills,50,535
16,4,2015,Wild Bean Cafe,Eating Out,1,534
16,4,2015,Chicken Cottage,Eating Out,4,530
16,4,2015,Tool Shop,,3,527
17,4,2015,Morrisons,Groceries,44,483
17,4,2015,Starbucks Coffee,Eating Out,2,481
17,4,2015,Restaurant Gordon RamsayPortland Restaurant,Eating Out,26,455
18,4,2015,ATM Cash Withdrawal,General,20,435
19,4,2015,ATM Cash Withdrawal,General,20,415
20,4,2015,VIRGIN MEDIA PYMTS,Bills,58,357
20,4,2015,South West Trains,Transport,37,320
20,4,2015,Starbucks Coffee,Eating Out,2,318
20,4,2015,ATM Cash Withdrawal,General,10,308
20,4,2015,Paying back Julie,,4,304
21,4,2015,Costa Coffee,Eating Out,1,303
21,4,2015,Pret A Manger,Eating Out,6,297
23,4,2015,Wild Bean Cafe,Eating Out,2,295
23,4,2015,ATM Cash Withdrawal,General,10,285
24,4,2015,O2,Bills,37,248
24,4,2015,Waitrose,Groceries,70,178
24,4,2015,Costa Coffee,Eating Out,1,177
24,4,2015,Paying back Julie,,5,172
25,4,2015,Tool Tec,,3,169
27,4,2015,South West Trains,Transport,26,143
27,4,2015,Greggs,Eating Out,5,138
27,4,2015,ATM Cash Withdrawal,General,10,128
28,4,2015,Wild Bean Cafe,Eating Out,2,126
28,4,2015,McDonalds,Eating Out,4,122
29,4,2015,Paying back James,,7,115
30,4,2015,Costa Coffee,Eating Out,1,114
30,4,2015,The West Cornwall Pasty Company,Eating Out,5,109
30,4,2015,ATM Cash Withdrawal,General,10,99
1,5,2015,Rhino Sports salary,General,1700,1799
1,5,2015,Tescos,Groceries,43,1756
1,5,2015,Costa Coffee,Eating Out,1,1755
1,5,2015,Pret A Manger,Eating Out,4,1751
1,5,2015,Anglo restaurant,Eating Out,57,1694
3,5,2015,ATM Cash Withdrawal,General,20,1674
4,5,2015,South West Trains,Transport,35,1639
4,5,2015,Pret A Manger,Eating Out,6,1633
4,5,2015,ATM Cash Withdrawal,General,20,1613
5,5,2015,Starbucks Coffee,Eating Out,1,1612
6,5,2015,Wild Bean Cafe,Eating Out,2,1610
6,5,2015,ATM Cash Withdrawal,General,20,1590
6,5,2015,Red Shop,,3,1587
7,5,2015,Cubit and West rent,Rent,550,1037
7,5,2015,Pret A Manger,Eating Out,4,1033
7,5,2015,ATM Cash Withdrawal,General,20,1013
8,5,2015,ASDA,Groceries,49,964
8,5,2015,Wild Bean Cafe,Eating Out,1,963
9,5,2015,ATM Cash Withdrawal,General,20,943
11,5,2015,South West Trains,Transport,27,916
11,5,2015,Wild Bean Cafe,Eating Out,2,914
11,5,2015,Pret A Manger,Eating Out,6,908
11,5,2015,ATM Cash Withdrawal,General,20,888
12,5,2015,Caffe Nero,Eating Out,1,887
12,5,2015,The West Cornwall Pasty Company,Eating Out,7,880
12,5,2015,ATM Cash Withdrawal,General,10,870
13,5,2015,Costa Coffee,Eating Out,2,868
13,5,2015,ATM Cash Withdrawal,General,20,848
14,5,2015,Costa Coffee,Eating Out,2,846
15,5,2015,BRGAS-Electricity,Bills,27,819
15,5,2015,BRGAS-Gas,Bills,26,793
15,5,2015,Sainsburys,Groceries,64,729
15,5,2015,The West Cornwall Pasty Company,Eating Out,6,723
15,5,2015,Cheam Service Station,,7,716
16,5,2015,LBS Council Tax,Bills,50,666
16,5,2015,Anglo restaurant,Eating Out,43,623
18,5,2015,South West Trains,Transport,38,585
18,5,2015,Caffe Nero,Eating Out,1,584
18,5,2015,The West Cornwall Pasty Company,Eating Out,6,578
19,5,2015,Chicken Cottage,Eating Out,5,573
19,5,2015,ATM Cash Withdrawal,General,10,563
20,5,2015,VIRGIN MEDIA PYMTS,Bills,59,504
20,5,2015,Starbucks Coffee,Eating Out,2,502
20,5,2015,Pret A Manger,Eating Out,7,495
21,5,2015,Caffe Nero,Eating Out,2,493
21,5,2015,Chicken Cottage,Eating Out,6,487
22,5,2015,Sainsburys,Groceries,57,430
22,5,2015,Caffe Nero,Eating Out,1,429
22,5,2015,Chicken Cottage,Eating Out,6,423
22,5,2015,ATM Cash Withdrawal,General,10,413
24,5,2015,O2,Bills,37,376
24,5,2015,Restaurant Gordon RamsayPortland Restaurant,Eating Out,56,320
25,5,2015,South West Trains,Transport,30,290
25,5,2015,Chicken Cottage,Eating Out,8,282
26,5,2015,Starbucks Coffee,Eating Out,2,280
26,5,2015,Subway,Eating Out,4,276
27,5,2015,The West Cornwall Pasty Company,Eating Out,5,271
28,5,2015,Caffe Nero,Eating Out,2,269
28,5,2015,Greggs,Eating Out,7,262
29,5,2015,ASDA,Groceries,44,218
29,5,2015,Caffe Nero,Eating Out,2,216
29,5,2015,Paying back James,,8,208
31,5,2015,ATM Cash Withdrawal,General,20,188
1,6,2015,Rhino Sports salary,General,1700,1888
1,6,2015,South West Trains,Transport,36,1852
1,6,2015,Wild Bean Cafe,Eating Out,1,1851
1,6,2015,ATM Cash Withdrawal,General,20,1831
2,6,2015,Caffe Nero,Eating Out,2,1829
2,6,2015,Greggs,Eating Out,5,1824
2,6,2015,ATM Cash Withdrawal,General,10,1814
3,6,2015,Costa Coffee,Eating Out,2,1812
3,6,2015,Greggs,Eating Out,4,1808
4,6,2015,McDonalds,Eating Out,6,1802
5,6,2015,ASDA,Groceries,86,1716
5,6,2015,Starbucks Coffee,Eating Out,2,1714
6,6,2015,Scott's Restaurant,Eating Out,38,1676
7,6,2015,Cubit and West rent,Rent,550,1126
7,6,2015,ATM Cash Withdrawal,General,20,1106
8,6,2015,South West Trains,Transport,27,1079
9,6,2015,Wild Bean Cafe,Eating Out,1,1078
9,6,2015,Cheam Service Station,,9,1069
10,6,2015,Wild Bean Cafe,Eating Out,1,1068
10,6,2015,The West Cornwall Pasty Company,Eating Out,4,1064
11,6,2015,Wild Bean Cafe,Eating Out,1,1063
11,6,2015,The West Cornwall Pasty Company,Eating Out,7,1056
12,6,2015,Waitrose,Groceries,80,976
12,6,2015,Wild Bean Cafe,Eating Out,1,975
12,6,2015,Pret A Manger,Eating Out,7,968
12,6,2015,Tool Shop,,8,960
13,6,2015,ATM Cash Withdrawal,General,10,950
14,6,2015,ATM Cash Withdrawal,General,20,930
15,6,2015,BRGAS-Electricity,Bills,41,889
15,6,2015,BRGAS-Gas,Bills,32,857
15,6,2015,South West Trains,Transport,28,829
15,6,2015,Caffe Nero,Eating Out,1,828
15,6,2015,Chicken Cottage,Eating Out,4,824
16,6,2015,LBS Council Tax,Bills,50,774
16,6,2015,Caffe Nero,Eating Out,2,772
16,6,2015,Greggs,Eating Out,8,764
16,6,2015,Civic Shop,,1,763
17,6,2015,Costa Coffee,Eating Out,1,762
17,6,2015,The West Cornwall Pasty Company,Eating Out,4,758
17,6,2015,ATM Cash Withdrawal,General,10,748
18,6,2015,Starbucks Coffee,Eating Out,2,746
18,6,2015,Chicken Cottage,Eating Out,8,738
19,6,2015,Tescos,Groceries,42,696
19,6,2015,Costa Coffee,Eating Out,2,694
19,6,2015,The West Cornwall Pasty Company,Eating Out,7,687
20,6,2015,VIRGIN MEDIA PYMTS,Bills,57,630
20,6,2015,ATM Cash Withdrawal,General,20,610
21,6,2015,Anglo restaurant,Eating Out,32,578
21,6,2015,ATM Cash Withdrawal,General,20,558
21,6,2015,Civic Shop,,4,554
22,6,2015,South West Trains,Transport,30,524
22,6,2015,Costa Coffee,Eating Out,2,522
22,6,2015,Pret A Manger,Eating Out,4,518
23,6,2015,Starbucks Coffee,Eating Out,2,516
23,6,2015,Subway,Eating Out,8,508
23,6,2015,ATM Cash Withdrawal,General,20,488
24,6,2015,O2,Bills,30,458
24,6,2015,Costa Coffee,Eating Out,2,456
24,6,2015,ATM Cash Withdrawal,General,10,446
25,6,2015,Starbucks Coffee,Eating Out,1,445
26,6,2015,Morrisons,Groceries,61,384
26,6,2015,Starbucks Coffee,Eating Out,2,382
26,6,2015,Greggs,Eating Out,7,375
26,6,2015,Anglo restaurant,Eating Out,47,328
27,6,2015,Scott's Restaurant,Eating Out,34,294
27,6,2015,Tool Shop,,5,289
28,6,2015,Scott's Restaurant,Eating Out,36,253
28,6,2015,ATM Cash Withdrawal,General,20,233
29,6,2015,South West Trains,Transport,34,199
29,6,2015,Costa Coffee,Eating Out,1,198
29,6,2015,Paying back James,,2,196
30,6,2015,Caffe Nero,Eating Out,1,195
1,7,2015,Rhino Sports salary,General,1700,1895
1,7,2015,Wild Bean Cafe,Eating Out,1,1894
1,7,2015,Greggs,Eating Out,5,1889
1,7,2015,ATM Cash Withdrawal,General,10,1879
2,7,2015,Caffe Nero,Eating Out,2,1877
2,7,2015,Greggs,Eating Out,5,1872
3,7,2015,Sainsburys,Groceries,54,1818
3,7,2015,Starbucks Coffee,Eating Out,1,1817
3,7,2015,Pizza Express,Eating Out,48,1769
3,7,2015,ATM Cash Withdrawal,General,10,1759
5,7,2015,Restaurant Gordon RamsayPortland Restaurant,Eating Out,54,1705
6,7,2015,South West Trains,Transport,29,1676
6,7,2015,Caffe Nero,Eating Out,1,1675
6,7,2015,Greggs,Eating Out,5,1670
6,7,2015,Red Shop,,9,1661
7,7,2015,Cubit and West rent,Rent,550,1111
7,7,2015,Starbucks Coffee,Eating Out,2,1109
7,7,2015,Greggs,Eating Out,8,1101
8,7,2015,Wild Bean Cafe,Eating Out,1,1100
8,7,2015,Greggs,Eating Out,6,1094
8,7,2015,Cheam Service Station,,9,1085
9,7,2015,Greggs,Eating Out,4,1081
9,7,2015,ATM Cash Withdrawal,General,10,1071
10,7,2015,Waitrose,Groceries,67,1004
10,7,2015,Costa Coffee,Eating Out,1,1003
10,7,2015,Pret A Manger,Eating Out,6,997
10,7,2015,ATM Cash Withdrawal,General,10,987
11,7,2015,Restaurant Gordon RamsayPortland Restaurant,Eating Out,36,951
11,7,2015,Paying back Julie,,3,948
12,7,2015,Anglo restaurant,Eating Out,42,906
13,7,2015,South West Trains,Transport,34,872
13,7,2015,Costa Coffee,Eating Out,2,870
13,7,2015,ATM Cash Withdrawal,General,20,850
13,7,2015,Red Shop,,7,843
15,7,2015,BRGAS-Electricity,Bills,36,807
15,7,2015,BRGAS-Gas,Bills,35,772
15,7,2015,Wild Bean Cafe,Eating Out,1,771
15,7,2015,Subway,Eating Out,6,765
15,7,2015,ATM Cash Withdrawal,General,10,755
16,7,2015,LBS Council Tax,Bills,50,705
17,7,2015,Tescos,Groceries,48,657
17,7,2015,Starbucks Coffee,Eating Out,2,655
17,7,2015,Pret A Manger,Eating Out,7,648
17,7,2015,Heaven Club,Eating Out,10,638
17,7,2015,Heaven Club,Eating Out,13,625
18,7,2015,ATM Cash Withdrawal,General,10,615
19,7,2015,Pizza Express,Eating Out,58,557
20,7,2015,VIRGIN MEDIA PYMTS,Bills,29,528
20,7,2015,South West Trains,Transport,35,493
21,7,2015,Costa Coffee,Eating Out,2,491
21,7,2015,Subway,Eating Out,6,485
21,7,2015,ATM Cash Withdrawal,General,10,475
22,7,2015,Starbucks Coffee,Eating Out,2,473
22,7,2015,Greggs,Eating Out,8,465
22,7,2015,ATM Cash Withdrawal,General,10,455
23,7,2015,Costa Coffee,Eating Out,2,453
23,7,2015,Greggs,Eating Out,7,446
24,7,2015,O2,Bills,32,414
24,7,2015,Morrisons,Groceries,86,328
24,7,2015,Wild Bean Cafe,Eating Out,2,326
24,7,2015,Scott's Restaurant,Eating Out,36,290
25,7,2015,Civic Shop,,1,289
26,7,2015,ATM Cash Withdrawal,General,20,269
27,7,2015,South West Trains,Transport,33,236
27,7,2015,Wild Bean Cafe,Eating Out,1,235
28,7,2015,Costa Coffee,Eating Out,2,233
28,7,2015,Subway,Eating Out,4,229
29,7,2015,The West Cornwall Pasty Company,Eating Out,8,221
30,7,2015,Wild Bean Cafe,Eating Out,1,220
31,7,2015,Waitrose,Groceries,70,150
31,7,2015,Caffe Nero,Eating Out,2,148
31,7,2015,Subway,Eating Out,6,142
31,7,2015,ATM Cash Withdrawal,General,10,132
31,7,2015,Paying back Julie,,3,129
1,8,2015,Rhino Sports salary,General,1700,1829
1,8,2015,Heaven Club,Eating Out,15,1814
1,8,2015,Heaven Club,Eating Out,15,1799
1,8,2015,Heaven Club,Eating Out,8,1791
1,8,2015,Heaven Club,Eating Out,11,1780
1,8,2015,Heaven Club,Eating Out,11,1769
1,8,2015,Heaven Club,Eating Out,13,1756
1,8,2015,ATM Cash Withdrawal,General,20,1736
3,8,2015,South West Trains,Transport,34,1702
3,8,2015,Caffe Nero,Eating Out,1,1701
3,8,2015,ATM Cash Withdrawal,General,20,1681
4,8,2015,Starbucks Coffee,Eating Out,1,1680
4,8,2015,McDonalds,Eating Out,6,1674
5,8,2015,The West Cornwall Pasty Company,Eating Out,8,1666
5,8,2015,Tool Shop,,3,1663
6,8,2015,Starbucks Coffee,Eating Out,1,1662
6,8,2015,Subway,Eating Out,4,1658
7,8,2015,Cubit and West rent,Rent,550,1108
7,8,2015,Waitrose,Groceries,76,1032
7,8,2015,Wild Bean Cafe,Eating Out,2,1030
8,8,2015,Scott's Restaurant,Eating Out,31,999
10,8,2015,South West Trains,Transport,27,972
10,8,2015,Wild Bean Cafe,Eating Out,2,970
10,8,2015,The West Cornwall Pasty Company,Eating Out,5,965
10,8,2015,ATM Cash Withdrawal,General,10,955
11,8,2015,Subway,Eating Out,5,950
12,8,2015,Wild Bean Cafe,Eating Out,1,949
12,8,2015,ATM Cash Withdrawal,General,10,939
13,8,2015,Wild Bean Cafe,Eating Out,2,937
13,8,2015,Pret A Manger,Eating Out,6,931
13,8,2015,ATM Cash Withdrawal,General,10,921
14,8,2015,Sainsburys,Groceries,61,860
14,8,2015,Starbucks Coffee,Eating Out,2,858
14,8,2015,Pret A Manger,Eating Out,8,850
14,8,2015,Pizza Express,Eating Out,58,792
15,8,2015,BRGAS-Electricity,Bills,30,762
15,8,2015,BRGAS-Gas,Bills,31,731
15,8,2015,The Grand Pub,Eating Out,8,723
15,8,2015,The Grand Pub,Eating Out,15,708
15,8,2015,The Grand Pub,Eating Out,8,700
15,8,2015,The Grand Pub,Eating Out,16,684
15,8,2015,The Grand Pub,Eating Out,9,675
15,8,2015,Anglo restaurant,Eating Out,36,639
16,8,2015,LBS Council Tax,Bills,50,589
16,8,2015,ATM Cash Withdrawal,General,10,579
17,8,2015,South West Trains,Transport,37,542
18,8,2015,Costa Coffee,Eating Out,2,540
18,8,2015,Subway,Eating Out,6,534
18,8,2015,ATM Cash Withdrawal,General,10,524
19,8,2015,Wild Bean Cafe,Eating Out,2,522
19,8,2015,Pret A Manger,Eating Out,6,516
20,8,2015,VIRGIN MEDIA PYMTS,Bills,44,472
20,8,2015,Caffe Nero,Eating Out,2,470
20,8,2015,Chicken Cottage,Eating Out,4,466
21,8,2015,Morrisons,Groceries,48,418
21,8,2015,Starbucks Coffee,Eating Out,2,416
22,8,2015,ATM Cash Withdrawal,General,10,406
24,8,2015,O2,Bills,33,373
24,8,2015,South West Trains,Transport,26,347
24,8,2015,Caffe Nero,Eating Out,2,345
24,8,2015,Chicken Cottage,Eating Out,7,338
25,8,2015,Starbucks Coffee,Eating Out,2,336
25,8,2015,Greggs,Eating Out,7,329
25,8,2015,ATM Cash Withdrawal,General,20,309
26,8,2015,Caffe Nero,Eating Out,2,307
26,8,2015,ATM Cash Withdrawal,General,20,287
27,8,2015,Wild Bean Cafe,Eating Out,2,285
27,8,2015,Greggs,Eating Out,6,279
28,8,2015,Waitrose,Groceries,53,226
28,8,2015,Wild Bean Cafe,Eating Out,2,224
28,8,2015,McDonalds,Eating Out,5,219
28,8,2015,ATM Cash Withdrawal,General,20,199
29,8,2015,Ministry of Sound ClubXOYO Club,Eating Out,6,193
29,8,2015,Ministry of Sound ClubXOYO Club,Eating Out,8,185
30,8,2015,Dominos Pizza,Eating Out,43,142
30,8,2015,ATM Cash Withdrawal,General,20,122
30,8,2015,Tool Shop,,5,117
31,8,2015,South West Trains,Transport,37,80
31,8,2015,Wild Bean Cafe,Eating Out,1,79
31,8,2015,Subway,Eating Out,8,71
1,9,2015,Rhino Sports salary,General,1700,1771
1,9,2015,Starbucks Coffee,Eating Out,1,1770
2,9,2015,Chicken Cottage,Eating Out,5,1765
3,9,2015,Wild Bean Cafe,Eating Out,2,1763
3,9,2015,ATM Cash Withdrawal,General,10,1753
4,9,2015,ASDA,Groceries,58,1695
4,9,2015,Greggs,Eating Out,7,1688
4,9,2015,Anglo restaurant,Eating Out,31,1657
4,9,2015,ATM Cash Withdrawal,General,10,1647
5,9,2015,Paying back Julie,,3,1644
7,9,2015,Cubit and West rent,Rent,550,1094
7,9,2015,South West Trains,Transport,25,1069
7,9,2015,Wild Bean Cafe,Eating Out,2,1067
7,9,2015,Pret A Manger,Eating Out,8,1059
7,9,2015,ATM Cash Withdrawal,General,20,1039
8,9,2015,Caffe Nero,Eating Out,1,1038
9,9,2015,Caffe Nero,Eating Out,1,1037
9,9,2015,The West Cornwall Pasty Company,Eating Out,7,1030
9,9,2015,ATM Cash Withdrawal,General,20,1010
10,9,2015,Starbucks Coffee,Eating Out,2,1008
10,9,2015,Greggs,Eating Out,6,1002
11,9,2015,Tescos,Groceries,82,920
11,9,2015,Pret A Manger,Eating Out,8,912
13,9,2015,Anglo restaurant,Eating Out,57,855
14,9,2015,South West Trains,Transport,34,821
14,9,2015,Wild Bean Cafe,Eating Out,1,820
15,9,2015,BRGAS-Electricity,Bills,37,783
15,9,2015,BRGAS-Gas,Bills,27,756
15,9,2015,Red Shop,,5,751
16,9,2015,LBS Council Tax,Bills,50,701
16,9,2015,Starbucks Coffee,Eating Out,1,700
16,9,2015,The West Cornwall Pasty Company,Eating Out,5,695
17,9,2015,Wild Bean Cafe,Eating Out,2,693
17,9,2015,Red Shop,,3,690
18,9,2015,Tescos,Groceries,61,629
18,9,2015,Caffe Nero,Eating Out,2,627
18,9,2015,Restaurant Gordon RamsayPortland Restaurant,Eating Out,29,598
19,9,2015,Restaurant Gordon RamsayPortland Restaurant,Eating Out,51,547
19,9,2015,ATM Cash Withdrawal,General,20,527
20,9,2015,VIRGIN MEDIA PYMTS,Bills,53,474
20,9,2015,ATM Cash Withdrawal,General,10,464
21,9,2015,South West Trains,Transport,25,439
21,9,2015,Wild Bean Cafe,Eating Out,1,438
23,9,2015,Caffe Nero,Eating Out,2,436
23,9,2015,Greggs,Eating Out,8,428
24,9,2015,O2,Bills,35,393
24,9,2015,Costa Coffee,Eating Out,2,391
24,9,2015,Greggs,Eating Out,6,385
24,9,2015,ATM Cash Withdrawal,General,20,365
25,9,2015,Morrisons,Groceries,82,283
25,9,2015,Dominos Pizza,Eating Out,33,250
28,9,2015,South West Trains,Transport,38,212
28,9,2015,Starbucks Coffee,Eating Out,1,211
28,9,2015,The West Cornwall Pasty Company,Eating Out,5,206
28,9,2015,Tool Shop,,4,202
29,9,2015,Caffe Nero,Eating Out,1,201
30,9,2015,Caffe Nero,Eating Out,1,200
1,10,2015,Rhino Sports salary,General,1700,1900
2,10,2015,Morrisons,Groceries,58,1842
2,10,2015,Starbucks Coffee,Eating Out,1,1841
2,10,2015,Subway,Eating Out,6,1835
2,10,2015,Anglo restaurant,Eating Out,56,1779
4,10,2015,ATM Cash Withdrawal,General,20,1759
5,10,2015,South West Trains,Transport,33,1726
5,10,2015,Starbucks Coffee,Eating Out,2,1724
5,10,2015,Pret A Manger,Eating Out,7,1717
7,10,2015,Cubit and West rent,Rent,550,1167
7,10,2015,Caffe Nero,Eating Out,1,1166
7,10,2015,Subway,Eating Out,7,1159
7,10,2015,Tool Shop,,6,1153
8,10,2015,Costa Coffee,Eating Out,2,1151
8,10,2015,McDonalds,Eating Out,7,1144
8,10,2015,ATM Cash Withdrawal,General,10,1134
9,10,2015,Tescos,Groceries,89,1045
9,10,2015,Costa Coffee,Eating Out,1,1044
9,10,2015,ATM Cash Withdrawal,General,20,1024
11,10,2015,ATM Cash Withdrawal,General,10,1014
12,10,2015,South West Trains,Transport,35,979
12,10,2015,Costa Coffee,Eating Out,2,977
12,10,2015,The West Cornwall Pasty Company,Eating Out,5,972
13,10,2015,Caffe Nero,Eating Out,2,970
13,10,2015,Subway,Eating Out,7,963
13,10,2015,ATM Cash Withdrawal,General,10,953
14,10,2015,Costa Coffee,Eating Out,2,951
14,10,2015,ATM Cash Withdrawal,General,20,931
14,10,2015,Civic Shop,,3,928
15,10,2015,BRGAS-Electricity,Bills,27,901
15,10,2015,BRGAS-Gas,Bills,21,880
15,10,2015,Subway,Eating Out,8,872
16,10,2015,LBS Council Tax,Bills,50,822
16,10,2015,Waitrose,Groceries,54,768
16,10,2015,Starbucks Coffee,Eating Out,2,766
17,10,2015,Civic Shop,,6,760
19,10,2015,South West Trains,Transport,32,728
19,10,2015,Starbucks Coffee,Eating Out,2,726
19,10,2015,Pret A Manger,Eating Out,4,722
19,10,2015,Paying back James,,7,715
20,10,2015,VIRGIN MEDIA PYMTS,Bills,51,664
20,10,2015,Wild Bean Cafe,Eating Out,2,662
21,10,2015,Costa Coffee,Eating Out,2,660
21,10,2015,McDonalds,Eating Out,5,655
21,10,2015,Paying back Julie,,6,649
22,10,2015,Wild Bean Cafe,Eating Out,2,647
22,10,2015,Subway,Eating Out,4,643
23,10,2015,ASDA,Groceries,48,595
23,10,2015,Starbucks Coffee,Eating Out,2,593
23,10,2015,Pizza Express,Eating Out,38,555
24,10,2015,O2,Bills,35,520
24,10,2015,Heaven Club,Eating Out,7,513
24,10,2015,Heaven Club,Eating Out,15,498
24,10,2015,Heaven Club,Eating Out,12,486
24,10,2015,ATM Cash Withdrawal,General,20,466
26,10,2015,South West Trains,Transport,37,429
26,10,2015,Wild Bean Cafe,Eating Out,2,427
27,10,2015,Costa Coffee,Eating Out,2,425
27,10,2015,Greggs,Eating Out,6,419
28,10,2015,Civic Shop,,8,411
29,10,2015,Pret A Manger,Eating Out,8,403
29,10,2015,Paying back James,,5,398
30,10,2015,Sainsburys,Groceries,79,319
30,10,2015,Costa Coffee,Eating Out,2,317
30,10,2015,Greggs,Eating Out,5,312
31,10,2015,ATM Cash Withdrawal,General,20,292
1,11,2015,Rhino Sports salary,General,1700,1992
2,11,2015,South West Trains,Transport,28,1964
2,11,2015,Caffe Nero,Eating Out,2,1962
2,11,2015,McDonalds,Eating Out,8,1954
3,11,2015,Wild Bean Cafe,Eating Out,1,1953
4,11,2015,Wild Bean Cafe,Eating Out,2,1951
4,11,2015,McDonalds,Eating Out,5,1946
5,11,2015,Costa Coffee,Eating Out,2,1944
6,11,2015,ASDA,Groceries,42,1902
6,11,2015,Wild Bean Cafe,Eating Out,1,1901
6,11,2015,Restaurant Gordon RamsayPortland Restaurant,Eating Out,35,1866
7,11,2015,Cubit and West rent,Rent,550,1316
7,11,2015,Fabric Club,Eating Out,5,1311
7,11,2015,Fabric Club,Eating Out,9,1302
7,11,2015,Dominos Pizza,Eating Out,58,1244
8,11,2015,Scott's Restaurant,Eating Out,31,1213
9,11,2015,South West Trains,Transport,32,1181
9,11,2015,Costa Coffee,Eating Out,2,1179
9,11,2015,Subway,Eating Out,5,1174
9,11,2015,ATM Cash Withdrawal,General,10,1164
10,11,2015,ATM Cash Withdrawal,General,20,1144
12,11,2015,Caffe Nero,Eating Out,2,1142
13,11,2015,Tescos,Groceries,77,1065
13,11,2015,Subway,Eating Out,6,1059
13,11,2015,Heaven Club,Eating Out,11,1048
13,11,2015,Heaven Club,Eating Out,9,1039
13,11,2015,Heaven Club,Eating Out,6,1033
13,11,2015,Heaven Club,Eating Out,8,1025
13,11,2015,Anglo restaurant,Eating Out,27,998
13,11,2015,ATM Cash Withdrawal,General,10,988
15,11,2015,BRGAS-Electricity,Bills,43,945
15,11,2015,BRGAS-Gas,Bills,78,867
15,11,2015,Pizza Express,Eating Out,27,840
15,11,2015,ATM Cash Withdrawal,General,10,830
16,11,2015,LBS Council Tax,Bills,50,780
16,11,2015,South West Trains,Transport,25,755
16,11,2015,Costa Coffee,Eating Out,2,753
16,11,2015,McDonalds,Eating Out,8,745
17,11,2015,Costa Coffee,Eating Out,2,743
17,11,2015,Red Shop,,8,735
18,11,2015,ATM Cash Withdrawal,General,20,715
18,11,2015,Paying back James,,2,713
19,11,2015,Starbucks Coffee,Eating Out,2,711
19,11,2015,The West Cornwall Pasty Company,Eating Out,8,703
19,11,2015,Tool Shop,,5,698
20,11,2015,VIRGIN MEDIA PYMTS,Bills,30,668
20,11,2015,Tescos,Groceries,75,593
20,11,2015,Wild Bean Cafe,Eating Out,2,591
20,11,2015,Greggs,Eating Out,7,584
20,11,2015,Pizza Express,Eating Out,24,560
20,11,2015,ATM Cash Withdrawal,General,10,550
21,11,2015,Anglo restaurant,Eating Out,50,500
21,11,2015,ATM Cash Withdrawal,General,20,480
22,11,2015,Anglo restaurant,Eating Out,56,424
22,11,2015,Tool Shop,,6,418
23,11,2015,South West Trains,Transport,31,387
23,11,2015,Starbucks Coffee,Eating Out,1,386
23,11,2015,ATM Cash Withdrawal,General,10,376
24,11,2015,O2,Bills,30,346
24,11,2015,Wild Bean Cafe,Eating Out,2,344
24,11,2015,Chicken Cottage,Eating Out,8,336
25,11,2015,Caffe Nero,Eating Out,2,334
25,11,2015,Subway,Eating Out,6,328
26,11,2015,ATM Cash Withdrawal,General,20,308
26,11,2015,Paying back Julie,,8,300
27,11,2015,Waitrose,Groceries,58,242
27,11,2015,Caffe Nero,Eating Out,1,241
27,11,2015,The West Cornwall Pasty Company,Eating Out,6,235
28,11,2015,Restaurant Gordon RamsayPortland Restaurant,Eating Out,27,208
28,11,2015,Red Shop,,1,207
30,11,2015,South West Trains,Transport,37,170
30,11,2015,Starbucks Coffee,Eating Out,1,169
30,11,2015,Subway,Eating Out,6,163
1,12,2015,Rhino Sports salary,General,1700,1863
1,12,2015,Cheam Service Station,,9,1854
2,12,2015,Greggs,Eating Out,7,1847
3,12,2015,Wild Bean Cafe,Eating Out,2,1845
3,12,2015,McDonalds,Eating Out,7,1838
4,12,2015,Waitrose,Groceries,48,1790
4,12,2015,Wild Bean Cafe,Eating Out,1,1789
4,12,2015,Greggs,Eating Out,8,1781
4,12,2015,Ministry of Sound ClubXOYO Club,Eating Out,12,1769
4,12,2015,Ministry of Sound ClubXOYO Club,Eating Out,13,1756
4,12,2015,Ministry of Sound ClubXOYO Club,Eating Out,12,1744
4,12,2015,Ministry of Sound ClubXOYO Club,Eating Out,7,1737
4,12,2015,Ministry of Sound ClubXOYO Club,Eating Out,16,1721
4,12,2015,Ministry of Sound ClubXOYO Club,Eating Out,14,1707
5,12,2015,Scott's Restaurant,Eating Out,49,1658
6,12,2015,ATM Cash Withdrawal,General,20,1638
7,12,2015,Cubit and West rent,Rent,550,1088
7,12,2015,South West Trains,Transport,35,1053
7,12,2015,Wild Bean Cafe,Eating Out,1,1052
7,12,2015,The West Cornwall Pasty Company,Eating Out,5,1047
7,12,2015,ATM Cash Withdrawal,General,20,1027
8,12,2015,Starbucks Coffee,Eating Out,2,1025
8,12,2015,Greggs,Eating Out,6,1019
8,12,2015,ATM Cash Withdrawal,General,10,1009
9,12,2015,Caffe Nero,Eating Out,2,1007
9,12,2015,Pret A Manger,Eating Out,7,1000
10,12,2015,Costa Coffee,Eating Out,2,998
11,12,2015,Sainsburys,Groceries,42,956
11,12,2015,Caffe Nero,Eating Out,2,954
11,12,2015,Dominos Pizza,Eating Out,31,923
14,12,2015,South West Trains,Transport,28,895
14,12,2015,Caffe Nero,Eating Out,2,893
15,12,2015,BRGAS-Electricity,Bills,30,863
15,12,2015,BRGAS-Gas,Bills,44,819
15,12,2015,Greggs,Eating Out,6,813
16,12,2015,LBS Council Tax,Bills,50,763
16,12,2015,Wild Bean Cafe,Eating Out,1,762
16,12,2015,Subway,Eating Out,5,757
17,12,2015,Costa Coffee,Eating Out,2,755
17,12,2015,The West Cornwall Pasty Company,Eating Out,5,750
17,12,2015,ATM Cash Withdrawal,General,20,730
18,12,2015,Sainsburys,Groceries,56,674
18,12,2015,Wild Bean Cafe,Eating Out,2,672
18,12,2015,Subway,Eating Out,8,664
18,12,2015,The Grand Pub,Eating Out,7,657
18,12,2015,The Grand Pub,Eating Out,7,650
18,12,2015,ATM Cash Withdrawal,General,20,630
19,12,2015,Restaurant Gordon RamsayPortland Restaurant,Eating Out,55,575
20,12,2015,VIRGIN MEDIA PYMTS,Bills,53,522
20,12,2015,Restaurant Gordon RamsayPortland Restaurant,Eating Out,26,496
21,12,2015,South West Trains,Transport,37,459
21,12,2015,Caffe Nero,Eating Out,1,458
21,12,2015,Chicken Cottage,Eating Out,7,451
22,12,2015,Costa Coffee,Eating Out,1,450
22,12,2015,ATM Cash Withdrawal,General,10,440
23,12,2015,Starbucks Coffee,Eating Out,1,439
23,12,2015,The West Cornwall Pasty Company,Eating Out,4,435
23,12,2015,ATM Cash Withdrawal,General,10,425
24,12,2015,O2,Bills,30,395
24,12,2015,Wild Bean Cafe,Eating Out,2,393
24,12,2015,Chicken Cottage,Eating Out,6,387
25,12,2015,Waitrose,Groceries,73,314
25,12,2015,Caffe Nero,Eating Out,2,312
25,12,2015,McDonalds,Eating Out,8,304
25,12,2015,Scott's Restaurant,Eating Out,47,257
27,12,2015,ATM Cash Withdrawal,General,10,247
27,12,2015,Cheam Service Station,,2,245
28,12,2015,South West Trains,Transport,27,218
28,12,2015,Costa Coffee,Eating Out,2,216
28,12,2015,Greggs,Eating Out,5,211
29,12,2015,Caffe Nero,Eating Out,1,210
29,12,2015,Greggs,Eating Out,4,206
29,12,2015,ATM Cash Withdrawal,General,10,196
30,12,2015,Costa Coffee,Eating Out,1,195
31,12,2015,Starbucks Coffee,Eating Out,1,194
31,12,2015,Pret A Manger,Eating Out,4,190
31,12,2015,ATM Cash Withdrawal,General,10,180
1,1,2016,Rhino Sports salary,General,1700,1880
1,1,2016,Waitrose,Groceries,74,1806
1,1,2016,Greggs,Eating Out,8,1798
3,1,2016,Restaurant Gordon RamsayPortland Restaurant,Eating Out,46,1752
3,1,2016,ATM Cash Withdrawal,General,10,1742
4,1,2016,South West Trains,Transport,36,1706
4,1,2016,Wild Bean Cafe,Eating Out,2,1704
5,1,2016,Starbucks Coffee,Eating Out,1,1703
5,1,2016,Subway,Eating Out,5,1698
5,1,2016,Tool Shop,,5,1693
6,1,2016,Wild Bean Cafe,Eating Out,2,1691
6,1,2016,Chicken Cottage,Eating Out,7,1684
6,1,2016,Red Shop,,9,1675
7,1,2016,Cubit and West rent,Rent,550,1125
7,1,2016,Costa Coffee,Eating Out,1,1124
7,1,2016,Pret A Manger,Eating Out,5,1119
8,1,2016,ASDA,Groceries,80,1039
8,1,2016,Starbucks Coffee,Eating Out,2,1037
8,1,2016,Chicken Cottage,Eating Out,4,1033
8,1,2016,Anglo restaurant,Eating Out,54,979
9,1,2016,Ministry of Sound ClubXOYO Club,Eating Out,9,970
9,1,2016,Ministry of Sound ClubXOYO Club,Eating Out,13,957
9,1,2016,Ministry of Sound ClubXOYO Club,Eating Out,6,951
9,1,2016,Ministry of Sound ClubXOYO Club,Eating Out,13,938
9,1,2016,Ministry of Sound ClubXOYO Club,Eating Out,9,929
9,1,2016,Dominos Pizza,Eating Out,33,896
9,1,2016,Paying back James,,2,894
10,1,2016,Scott's Restaurant,Eating Out,30,864
11,1,2016,South West Trains,Transport,25,839
11,1,2016,Wild Bean Cafe,Eating Out,1,838
12,1,2016,Caffe Nero,Eating Out,2,836
12,1,2016,Pret A Manger,Eating Out,8,828
13,1,2016,Caffe Nero,Eating Out,2,826
13,1,2016,ATM Cash Withdrawal,General,10,816
14,1,2016,Costa Coffee,Eating Out,1,815
14,1,2016,Greggs,Eating Out,6,809
15,1,2016,BRGAS-Electricity,Bills,75,734
15,1,2016,BRGAS-Gas,Bills,38,696
15,1,2016,Tescos,Groceries,49,647
16,1,2016,LBS Council Tax,Bills,50,597
16,1,2016,Dominos Pizza,Eating Out,28,569
16,1,2016,Paying back Julie,,7,562
18,1,2016,South West Trains,Transport,29,533
18,1,2016,Subway,Eating Out,5,528
19,1,2016,Wild Bean Cafe,Eating Out,1,527
19,1,2016,Chicken Cottage,Eating Out,4,523
19,1,2016,ATM Cash Withdrawal,General,10,513
20,1,2016,VIRGIN MEDIA PYMTS,Bills,31,482
20,1,2016,Costa Coffee,Eating Out,2,480
20,1,2016,McDonalds,Eating Out,7,473
21,1,2016,Costa Coffee,Eating Out,1,472
21,1,2016,Subway,Eating Out,8,464
22,1,2016,Sainsburys,Groceries,73,391
22,1,2016,Caffe Nero,Eating Out,2,389
22,1,2016,Subway,Eating Out,6,383
22,1,2016,ATM Cash Withdrawal,General,10,373
23,1,2016,Heaven Club,Eating Out,9,364
23,1,2016,Heaven Club,Eating Out,15,349
23,1,2016,Heaven Club,Eating Out,8,341
23,1,2016,Heaven Club,Eating Out,15,326
24,1,2016,O2,Bills,38,288
24,1,2016,ATM Cash Withdrawal,General,20,268
25,1,2016,South West Trains,Transport,29,239
25,1,2016,Wild Bean Cafe,Eating Out,2,237
25,1,2016,McDonalds,Eating Out,4,233
25,1,2016,ATM Cash Withdrawal,General,10,223
26,1,2016,Wild Bean Cafe,Eating Out,1,222
26,1,2016,The West Cornwall Pasty Company,Eating Out,5,217
27,1,2016,Wild Bean Cafe,Eating Out,2,215
27,1,2016,Cheam Service Station,,9,206
28,1,2016,Costa Coffee,Eating Out,2,204
28,1,2016,ATM Cash Withdrawal,General,10,194
29,1,2016,Waitrose,Groceries,42,152
29,1,2016,Costa Coffee,Eating Out,2,150
29,1,2016,The West Cornwall Pasty Company,Eating Out,7,143
1,2,2016,Rhino Sports salary,General,1700,1843
1,2,2016,South West Trains,Transport,26,1817
1,2,2016,Costa Coffee,Eating Out,1,1816
1,2,2016,Pret A Manger,Eating Out,6,1810
2,2,2016,ATM Cash Withdrawal,General,20,1790
3,2,2016,Wild Bean Cafe,Eating Out,2,1788
3,2,2016,Greggs,Eating Out,7,1781
4,2,2016,ATM Cash Withdrawal,General,10,1771
5,2,2016,Tescos,Groceries,50,1721
5,2,2016,ATM Cash Withdrawal,General,20,1701
7,2,2016,Cubit and West rent,Rent,550,1151
7,2,2016,Cheam Service Station,,5,1146
8,2,2016,South West Trains,Transport,33,1113
8,2,2016,Wild Bean Cafe,Eating Out,2,1111
8,2,2016,McDonalds,Eating Out,7,1104
9,2,2016,Starbucks Coffee,Eating Out,1,1103
10,2,2016,Subway,Eating Out,8,1095
11,2,2016,Starbucks Coffee,Eating Out,2,1093
11,2,2016,Greggs,Eating Out,7,1086
11,2,2016,Red Shop,,8,1078
12,2,2016,Sainsburys,Groceries,88,990
12,2,2016,Caffe Nero,Eating Out,2,988
12,2,2016,Chicken Cottage,Eating Out,8,980
12,2,2016,Fabric Club,Eating Out,11,969
12,2,2016,Fabric Club,Eating Out,13,956
12,2,2016,ATM Cash Withdrawal,General,20,936
13,2,2016,The Grand Pub,Eating Out,5,931
13,2,2016,The Grand Pub,Eating Out,8,923
13,2,2016,The Grand Pub,Eating Out,6,917
13,2,2016,The Grand Pub,Eating Out,16,901
13,2,2016,The Grand Pub,Eating Out,9,892
13,2,2016,ATM Cash Withdrawal,General,20,872
14,2,2016,Restaurant Gordon RamsayPortland Restaurant,Eating Out,35,837
15,2,2016,BRGAS-Electricity,Bills,33,804
15,2,2016,BRGAS-Gas,Bills,36,768
15,2,2016,South West Trains,Transport,30,738
15,2,2016,Caffe Nero,Eating Out,2,736
16,2,2016,LBS Council Tax,Bills,50,686
16,2,2016,Costa Coffee,Eating Out,1,685
17,2,2016,Starbucks Coffee,Eating Out,2,683
17,2,2016,ATM Cash Withdrawal,General,20,663
18,2,2016,Subway,Eating Out,5,658
19,2,2016,Waitrose,Groceries,86,572
19,2,2016,Starbucks Coffee,Eating Out,2,570
19,2,2016,Chicken Cottage,Eating Out,7,563
19,2,2016,Scott's Restaurant,Eating Out,55,508
20,2,2016,VIRGIN MEDIA PYMTS,Bills,38,470
20,2,2016,ATM Cash Withdrawal,General,20,450
21,2,2016,Pizza Express,Eating Out,53,397
22,2,2016,South West Trains,Transport,35,362
23,2,2016,Wild Bean Cafe,Eating Out,2,360
23,2,2016,Greggs,Eating Out,5,355
24,2,2016,O2,Bills,31,324
24,2,2016,Starbucks Coffee,Eating Out,1,323
24,2,2016,Greggs,Eating Out,6,317
25,2,2016,Costa Coffee,Eating Out,2,315
26,2,2016,Morrisons,Groceries,50,265
26,2,2016,Wild Bean Cafe,Eating Out,2,263
26,2,2016,The West Cornwall Pasty Company,Eating Out,7,256
27,2,2016,ATM Cash Withdrawal,General,10,246
28,2,2016,Scott's Restaurant,Eating Out,28,218
29,2,2016,South West Trains,Transport,29,189
29,2,2016,Costa Coffee,Eating Out,2,187
29,2,2016,Subway,Eating Out,5,182
1,3,2016,Rhino Sports salary,General,1700,1882
1,3,2016,Costa Coffee,Eating Out,2,1880
2,3,2016,Costa Coffee,Eating Out,2,1878
2,3,2016,Chicken Cottage,Eating Out,4,1874
3,3,2016,Wild Bean Cafe,Eating Out,2,1872
3,3,2016,Greggs,Eating Out,8,1864
3,3,2016,ATM Cash Withdrawal,General,10,1854
4,3,2016,Sainsburys,Groceries,52,1802
4,3,2016,Starbucks Coffee,Eating Out,1,1801
7,3,2016,Cubit and West rent,Rent,550,1251
7,3,2016,South West Trains,Transport,37,1214
8,3,2016,The West Cornwall Pasty Company,Eating Out,7,1207
8,3,2016,Paying back James,,7,1200
9,3,2016,Wild Bean Cafe,Eating Out,2,1198
9,3,2016,Greggs,Eating Out,8,1190
10,3,2016,Costa Coffee,Eating Out,1,1189
10,3,2016,Chicken Cottage,Eating Out,7,1182
11,3,2016,Tescos,Groceries,77,1105
12,3,2016,Anglo restaurant,Eating Out,35,1070
14,3,2016,South West Trains,Transport,36,1034
15,3,2016,BRGAS-Electricity,Bills,22,1012
15,3,2016,BRGAS-Gas,Bills,38,974
15,3,2016,The West Cornwall Pasty Company,Eating Out,4,970
16,3,2016,LBS Council Tax,Bills,50,920
16,3,2016,Caffe Nero,Eating Out,2,918
16,3,2016,The West Cornwall Pasty Company,Eating Out,4,914
17,3,2016,Starbucks Coffee,Eating Out,2,912
17,3,2016,Pret A Manger,Eating Out,5,907
18,3,2016,Waitrose,Groceries,83,824
18,3,2016,The West Cornwall Pasty Company,Eating Out,6,818
18,3,2016,Scott's Restaurant,Eating Out,48,770
19,3,2016,Scott's Restaurant,Eating Out,36,734
19,3,2016,ATM Cash Withdrawal,General,10,724
20,3,2016,VIRGIN MEDIA PYMTS,Bills,49,675
21,3,2016,South West Trains,Transport,32,643
21,3,2016,Wild Bean Cafe,Eating Out,1,642
21,3,2016,The West Cornwall Pasty Company,Eating Out,4,638
21,3,2016,ATM Cash Withdrawal,General,20,618
22,3,2016,Wild Bean Cafe,Eating Out,2,616
22,3,2016,McDonalds,Eating Out,6,610
22,3,2016,ATM Cash Withdrawal,General,10,600
23,3,2016,Subway,Eating Out,8,592
23,3,2016,ATM Cash Withdrawal,General,10,582
24,3,2016,O2,Bills,34,548
24,3,2016,Costa Coffee,Eating Out,2,546
25,3,2016,Morrisons,Groceries,50,496
25,3,2016,Starbucks Coffee,Eating Out,1,495
27,3,2016,Scott's Restaurant,Eating Out,56,439
28,3,2016,South West Trains,Transport,38,401
28,3,2016,Costa Coffee,Eating Out,2,399
28,3,2016,ATM Cash Withdrawal,General,10,389
28,3,2016,Red Shop,,7,382
29,3,2016,Caffe Nero,Eating Out,2,380
30,3,2016,Caffe Nero,Eating Out,1,379
31,3,2016,Costa Coffee,Eating Out,1,378
31,3,2016,Subway,Eating Out,8,370
31,3,2016,Paying back James,,9,361
1,4,2016,Rhino Sports salary,General,1700,2061
1,4,2016,Sainsburys,Groceries,83,1978
1,4,2016,Wild Bean Cafe,Eating Out,1,1977
2,4,2016,Dominos Pizza,Eating Out,46,1931
4,4,2016,South West Trains,Transport,24,1907
5,4,2016,Wild Bean Cafe,Eating Out,2,1905
5,4,2016,Red Shop,,1,1904
6,4,2016,Caffe Nero,Eating Out,1,1903
6,4,2016,Pret A Manger,Eating Out,7,1896
7,4,2016,Cubit and West rent,Rent,550,1346
7,4,2016,Chicken Cottage,Eating Out,8,1338
7,4,2016,ATM Cash Withdrawal,General,20,1318
8,4,2016,Sainsburys,Groceries,83,1235
8,4,2016,Caffe Nero,Eating Out,2,1233
9,4,2016,The Grand Pub,Eating Out,7,1226
9,4,2016,The Grand Pub,Eating Out,14,1212
10,4,2016,Dominos Pizza,Eating Out,26,1186
11,4,2016,South West Trains,Transport,37,1149
11,4,2016,Wild Bean Cafe,Eating Out,2,1147
12,4,2016,Costa Coffee,Eating Out,2,1145
12,4,2016,Subway,Eating Out,4,1141
12,4,2016,ATM Cash Withdrawal,General,20,1121
13,4,2016,Wild Bean Cafe,Eating Out,2,1119
13,4,2016,Pret A Manger,Eating Out,7,1112
14,4,2016,Chicken Cottage,Eating Out,7,1105
15,4,2016,BRGAS-Electricity,Bills,29,1076
15,4,2016,BRGAS-Gas,Bills,29,1047
15,4,2016,Tescos,Groceries,74,973
15,4,2016,Costa Coffee,Eating Out,1,972
15,4,2016,Greggs,Eating Out,6,966
15,4,2016,Ministry of Sound ClubXOYO Club,Eating Out,6,960
15,4,2016,Ministry of Sound ClubXOYO Club,Eating Out,16,944
15,4,2016,Ministry of Sound ClubXOYO Club,Eating Out,7,937
15,4,2016,Ministry of Sound ClubXOYO Club,Eating Out,11,926
15,4,2016,Restaurant Gordon RamsayPortland Restaurant,Eating Out,37,889
16,4,2016,LBS Council Tax,Bills,50,839
16,4,2016,Anglo restaurant,Eating Out,46,793
18,4,2016,South West Trains,Transport,33,760
18,4,2016,Pret A Manger,Eating Out,5,755
19,4,2016,Starbucks Coffee,Eating Out,1,754
19,4,2016,Greggs,Eating Out,4,750
20,4,2016,VIRGIN MEDIA PYMTS,Bills,39,711
20,4,2016,Starbucks Coffee,Eating Out,2,709
20,4,2016,Tool Shop,,2,707
21,4,2016,Wild Bean Cafe,Eating Out,2,705
21,4,2016,Chicken Cottage,Eating Out,8,697
22,4,2016,ASDA,Groceries,63,634
22,4,2016,Wild Bean Cafe,Eating Out,2,632
22,4,2016,Greggs,Eating Out,5,627
22,4,2016,Fabric Club,Eating Out,13,614
22,4,2016,Fabric Club,Eating Out,7,607
22,4,2016,Fabric Club,Eating Out,6,601
22,4,2016,Fabric Club,Eating Out,9,592
22,4,2016,Fabric Club,Eating Out,5,587
22,4,2016,Fabric Club,Eating Out,13,574
22,4,2016,Dominos Pizza,Eating Out,46,528
24,4,2016,O2,Bills,31,497
24,4,2016,Pizza Express,Eating Out,41,456
24,4,2016,ATM Cash Withdrawal,General,20,436
25,4,2016,South West Trains,Transport,31,405
25,4,2016,Costa Coffee,Eating Out,2,403
25,4,2016,Red Shop,,4,399
26,4,2016,Starbucks Coffee,Eating Out,2,397
26,4,2016,ATM Cash Withdrawal,General,10,387
27,4,2016,Caffe Nero,Eating Out,1,386
27,4,2016,Pret A Manger,Eating Out,6,380
28,4,2016,ATM Cash Withdrawal,General,20,360
29,4,2016,Sainsburys,Groceries,85,275
29,4,2016,Caffe Nero,Eating Out,2,273
29,4,2016,Pizza Express,Eating Out,31,242
29,4,2016,Tool Tec,,5,237
30,4,2016,Anglo restaurant,Eating Out,46,191
30,4,2016,ATM Cash Withdrawal,General,20,171
1,5,2016,Rhino Sports salary,General,1700,1871
1,5,2016,Dominos Pizza,Eating Out,54,1817
2,5,2016,South West Trains,Transport,31,1786
2,5,2016,Costa Coffee,Eating Out,1,1785
2,5,2016,Pret A Manger,Eating Out,5,1780
3,5,2016,The West Cornwall Pasty Company,Eating Out,6,1774
4,5,2016,Costa Coffee,Eating Out,2,1772
4,5,2016,ATM Cash Withdrawal,General,20,1752
5,5,2016,Starbucks Coffee,Eating Out,2,1750
5,5,2016,ATM Cash Withdrawal,General,10,1740
6,5,2016,Morrisons,Groceries,73,1667
6,5,2016,Caffe Nero,Eating Out,2,1665
7,5,2016,Cubit and West rent,Rent,550,1115
8,5,2016,Pizza Express,Eating Out,53,1062
9,5,2016,South West Trains,Transport,28,1034
9,5,2016,Caffe Nero,Eating Out,2,1032
9,5,2016,ATM Cash Withdrawal,General,20,1012
10,5,2016,Pret A Manger,Eating Out,5,1007
10,5,2016,Red Shop,,9,998
11,5,2016,Starbucks Coffee,Eating Out,2,996
12,5,2016,Caffe Nero,Eating Out,2,994
12,5,2016,Greggs,Eating Out,7,987
12,5,2016,ATM Cash Withdrawal,General,20,967
13,5,2016,Morrisons,Groceries,66,901
13,5,2016,Starbucks Coffee,Eating Out,2,899
13,5,2016,The West Cornwall Pasty Company,Eating Out,4,895
14,5,2016,Restaurant Gordon RamsayPortland Restaurant,Eating Out,59,836
14,5,2016,ATM Cash Withdrawal,General,20,816
15,5,2016,BRGAS-Electricity,Bills,27,789
15,5,2016,BRGAS-Gas,Bills,28,761
15,5,2016,Anglo restaurant,Eating Out,30,731
15,5,2016,ATM Cash Withdrawal,General,10,721
15,5,2016,Tool Shop,,4,717
16,5,2016,LBS Council Tax,Bills,50,667
16,5,2016,South West Trains,Transport,34,633
16,5,2016,Wild Bean Cafe,Eating Out,2,631
16,5,2016,McDonalds,Eating Out,6,625
16,5,2016,Civic Shop,,9,616
17,5,2016,Greggs,Eating Out,5,611
19,5,2016,Starbucks Coffee,Eating Out,1,610
20,5,2016,VIRGIN MEDIA PYMTS,Bills,58,552
20,5,2016,ASDA,Groceries,72,480
20,5,2016,Starbucks Coffee,Eating Out,2,478
20,5,2016,McDonalds,Eating Out,5,473
20,5,2016,ATM Cash Withdrawal,General,20,453
20,5,2016,Cheam Service Station,,5,448
21,5,2016,Ministry of Sound ClubXOYO Club,Eating Out,10,438
21,5,2016,Ministry of Sound ClubXOYO Club,Eating Out,11,427
21,5,2016,ATM Cash Withdrawal,General,10,417
22,5,2016,Dominos Pizza,Eating Out,50,367
23,5,2016,South West Trains,Transport,32,335
24,5,2016,O2,Bills,31,304
24,5,2016,Costa Coffee,Eating Out,1,303
24,5,2016,ATM Cash Withdrawal,General,20,283
24,5,2016,Red Shop,,3,280
25,5,2016,Wild Bean Cafe,Eating Out,2,278
25,5,2016,The West Cornwall Pasty Company,Eating Out,7,271
26,5,2016,Caffe Nero,Eating Out,2,269
26,5,2016,ATM Cash Withdrawal,General,20,249
27,5,2016,Tescos,Groceries,62,187
27,5,2016,The West Cornwall Pasty Company,Eating Out,7,180
27,5,2016,ATM Cash Withdrawal,General,20,160
28,5,2016,Restaurant Gordon RamsayPortland Restaurant,Eating Out,27,133
30,5,2016,South West Trains,Transport,25,108
30,5,2016,Tool Tec,,2,106
31,5,2016,McDonalds,Eating Out,6,100
1,6,2016,Rhino Sports salary,General,1700,1800
1,6,2016,Wild Bean Cafe,Eating Out,1,1799
1,6,2016,The West Cornwall Pasty Company,Eating Out,6,1793
1,6,2016,ATM Cash Withdrawal,General,20,1773
2,6,2016,Costa Coffee,Eating Out,2,1771
2,6,2016,ATM Cash Withdrawal,General,20,1751
3,6,2016,Morrisons,Groceries,86,1665
3,6,2016,Costa Coffee,Eating Out,1,1664
3,6,2016,Greggs,Eating Out,8,1656
3,6,2016,ATM Cash Withdrawal,General,20,1636
4,6,2016,ATM Cash Withdrawal,General,20,1616
5,6,2016,ATM Cash Withdrawal,General,10,1606
6,6,2016,South West Trains,Transport,35,1571
6,6,2016,Wild Bean Cafe,Eating Out,1,1570
6,6,2016,McDonalds,Eating Out,8,1562
6,6,2016,ATM Cash Withdrawal,General,10,1552
7,6,2016,Cubit and West rent,Rent,550,1002
7,6,2016,Starbucks Coffee,Eating Out,2,1000
7,6,2016,McDonalds,Eating Out,7,993
7,6,2016,ATM Cash Withdrawal,General,20,973
8,6,2016,Wild Bean Cafe,Eating Out,1,972
8,6,2016,The West Cornwall Pasty Company,Eating Out,5,967
8,6,2016,ATM Cash Withdrawal,General,10,957
9,6,2016,Starbucks Coffee,Eating Out,1,956
9,6,2016,Subway,Eating Out,7,949
10,6,2016,Sainsburys,Groceries,79,870
10,6,2016,Costa Coffee,Eating Out,2,868
10,6,2016,Pret A Manger,Eating Out,8,860
10,6,2016,Heaven Club,Eating Out,16,844
10,6,2016,Heaven Club,Eating Out,15,829
10,6,2016,Heaven Club,Eating Out,14,815
10,6,2016,Heaven Club,Eating Out,9,806
10,6,2016,Heaven Club,Eating Out,14,792
13,6,2016,South West Trains,Transport,37,755
13,6,2016,Costa Coffee,Eating Out,2,753
13,6,2016,Subway,Eating Out,4,749
13,6,2016,ATM Cash Withdrawal,General,10,739
13,6,2016,Tool Tec,,1,738
14,6,2016,Starbucks Coffee,Eating Out,2,736
15,6,2016,BRGAS-Electricity,Bills,24,712
15,6,2016,BRGAS-Gas,Bills,37,675
15,6,2016,Caffe Nero,Eating Out,1,674
15,6,2016,Subway,Eating Out,5,669
15,6,2016,Tool Shop,,9,660
16,6,2016,LBS Council Tax,Bills,50,610
16,6,2016,Wild Bean Cafe,Eating Out,2,608
16,6,2016,ATM Cash Withdrawal,General,10,598
17,6,2016,Tescos,Groceries,49,549
17,6,2016,The Grand Pub,Eating Out,11,538
17,6,2016,The Grand Pub,Eating Out,8,530
17,6,2016,The Grand Pub,Eating Out,13,517
17,6,2016,The Grand Pub,Eating Out,6,511
17,6,2016,The Grand Pub,Eating Out,8,503
17,6,2016,The Grand Pub,Eating Out,13,490
18,6,2016,ATM Cash Withdrawal,General,20,470
20,6,2016,VIRGIN MEDIA PYMTS,Bills,55,415
20,6,2016,South West Trains,Transport,34,381
20,6,2016,Costa Coffee,Eating Out,1,380
20,6,2016,Chicken Cottage,Eating Out,8,372
21,6,2016,Costa Coffee,Eating Out,2,370
21,6,2016,The West Cornwall Pasty Company,Eating Out,5,365
21,6,2016,ATM Cash Withdrawal,General,10,355
22,6,2016,ATM Cash Withdrawal,General,10,345
22,6,2016,Tool Shop,,3,342
23,6,2016,Costa Coffee,Eating Out,2,340
24,6,2016,O2,Bills,36,304
24,6,2016,Tescos,Groceries,81,223
24,6,2016,Caffe Nero,Eating Out,2,221
24,6,2016,McDonalds,Eating Out,8,213
26,6,2016,Tool Tec,,1,212
27,6,2016,South West Trains,Transport,33,179
27,6,2016,Caffe Nero,Eating Out,1,178
28,6,2016,Costa Coffee,Eating Out,2,176
28,6,2016,Greggs,Eating Out,8,168
28,6,2016,ATM Cash Withdrawal,General,10,158
29,6,2016,Costa Coffee,Eating Out,2,156
29,6,2016,McDonalds,Eating Out,6,150
30,6,2016,Costa Coffee,Eating Out,2,148
30,6,2016,Chicken Cottage,Eating Out,6,142
30,6,2016,ATM Cash Withdrawal,General,10,132
1,7,2016,Rhino Sports salary,General,1700,1832
1,7,2016,ASDA,Groceries,44,1788
1,7,2016,Starbucks Coffee,Eating Out,2,1786
1,7,2016,Pret A Manger,Eating Out,4,1782
1,7,2016,Scott's Restaurant,Eating Out,56,1726
1,7,2016,ATM Cash Withdrawal,General,20,1706
2,7,2016,ATM Cash Withdrawal,General,10,1696
2,7,2016,Civic Shop,,3,1693
3,7,2016,Pizza Express,Eating Out,32,1661
3,7,2016,ATM Cash Withdrawal,General,10,1651
4,7,2016,South West Trains,Transport,30,1621
4,7,2016,Chicken Cottage,Eating Out,8,1613
4,7,2016,ATM Cash Withdrawal,General,20,1593
5,7,2016,Costa Coffee,Eating Out,1,1592
5,7,2016,Pret A Manger,Eating Out,6,1586
6,7,2016,Starbucks Coffee,Eating Out,2,1584
6,7,2016,The West Cornwall Pasty Company,Eating Out,6,1578
6,7,2016,ATM Cash Withdrawal,General,20,1558
7,7,2016,Cubit and West rent,Rent,550,1008
7,7,2016,Starbucks Coffee,Eating Out,2,1006
7,7,2016,Subway,Eating Out,4,1002
8,7,2016,ASDA,Groceries,81,921
8,7,2016,Starbucks Coffee,Eating Out,2,919
8,7,2016,McDonalds,Eating Out,5,914
9,7,2016,ATM Cash Withdrawal,General,10,904
10,7,2016,Paying back Julie,,8,896
11,7,2016,South West Trains,Transport,28,868
11,7,2016,Wild Bean Cafe,Eating Out,1,867
11,7,2016,McDonalds,Eating Out,8,859
12,7,2016,Caffe Nero,Eating Out,1,858
12,7,2016,Pret A Manger,Eating Out,8,850
12,7,2016,Tool Tec,,1,849
13,7,2016,Caffe Nero,Eating Out,1,848
13,7,2016,McDonalds,Eating Out,8,840
13,7,2016,Paying back Julie,,5,835
14,7,2016,Pret A Manger,Eating Out,8,827
14,7,2016,Cheam Service Station,,7,820
15,7,2016,BRGAS-Electricity,Bills,28,792
15,7,2016,BRGAS-Gas,Bills,22,770
15,7,2016,Waitrose,Groceries,54,716
15,7,2016,Wild Bean Cafe,Eating Out,2,714
15,7,2016,Subway,Eating Out,4,710
16,7,2016,LBS Council Tax,Bills,50,660
18,7,2016,South West Trains,Transport,31,629
18,7,2016,Costa Coffee,Eating Out,2,627
18,7,2016,Subway,Eating Out,4,623
18,7,2016,Red Shop,,1,622
19,7,2016,Wild Bean Cafe,Eating Out,1,621
20,7,2016,VIRGIN MEDIA PYMTS,Bills,30,591
20,7,2016,Costa Coffee,Eating Out,1,590
20,7,2016,Pret A Manger,Eating Out,6,584
21,7,2016,Starbucks Coffee,Eating Out,1,583
21,7,2016,Pret A Manger,Eating Out,7,576
22,7,2016,ASDA,Groceries,76,500
22,7,2016,Starbucks Coffee,Eating Out,2,498
22,7,2016,ATM Cash Withdrawal,General,10,488
23,7,2016,ATM Cash Withdrawal,General,10,478
24,7,2016,O2,Bills,32,446
25,7,2016,South West Trains,Transport,38,408
25,7,2016,Costa Coffee,Eating Out,2,406
26,7,2016,Subway,Eating Out,8,398
27,7,2016,Costa Coffee,Eating Out,2,396
27,7,2016,Subway,Eating Out,4,392
28,7,2016,Costa Coffee,Eating Out,1,391
28,7,2016,McDonalds,Eating Out,5,386
29,7,2016,Sainsburys,Groceries,44,342
29,7,2016,Costa Coffee,Eating Out,2,340
29,7,2016,Greggs,Eating Out,8,332
29,7,2016,ATM Cash Withdrawal,General,10,322
30,7,2016,Dominos Pizza,Eating Out,47,275
30,7,2016,ATM Cash Withdrawal,General,20,255
31,7,2016,ATM Cash Withdrawal,General,20,235
1,8,2016,Rhino Sports salary,General,1700,1935
1,8,2016,South West Trains,Transport,24,1911
1,8,2016,Starbucks Coffee,Eating Out,2,1909
2,8,2016,Caffe Nero,Eating Out,2,1907
2,8,2016,The West Cornwall Pasty Company,Eating Out,8,1899
3,8,2016,ATM Cash Withdrawal,General,20,1879
4,8,2016,Wild Bean Cafe,Eating Out,2,1877
4,8,2016,Subway,Eating Out,7,1870
5,8,2016,ASDA,Groceries,64,1806
5,8,2016,Anglo restaurant,Eating Out,54,1752
5,8,2016,Paying back Julie,,4,1748
6,8,2016,Scott's Restaurant,Eating Out,27,1721
7,8,2016,Cubit and West rent,Rent,550,1171
7,8,2016,Anglo restaurant,Eating Out,24,1147
8,8,2016,South West Trains,Transport,28,1119
8,8,2016,Costa Coffee,Eating Out,2,1117
8,8,2016,ATM Cash Withdrawal,General,20,1097
9,8,2016,Wild Bean Cafe,Eating Out,2,1095
9,8,2016,Subway,Eating Out,6,1089
9,8,2016,ATM Cash Withdrawal,General,20,1069
10,8,2016,The West Cornwall Pasty Company,Eating Out,4,1065
11,8,2016,Caffe Nero,Eating Out,2,1063
11,8,2016,Pret A Manger,Eating Out,5,1058
12,8,2016,Morrisons,Groceries,42,1016
12,8,2016,Starbucks Coffee,Eating Out,2,1014
12,8,2016,The West Cornwall Pasty Company,Eating Out,6,1008
12,8,2016,ATM Cash Withdrawal,General,10,998
13,8,2016,The Grand Pub,Eating Out,12,986
13,8,2016,The Grand Pub,Eating Out,6,980
13,8,2016,The Grand Pub,Eating Out,14,966
13,8,2016,The Grand Pub,Eating Out,10,956
13,8,2016,The Grand Pub,Eating Out,10,946
13,8,2016,ATM Cash Withdrawal,General,10,936
14,8,2016,Scott's Restaurant,Eating Out,51,885
14,8,2016,ATM Cash Withdrawal,General,20,865
15,8,2016,BRGAS-Electricity,Bills,33,832
15,8,2016,BRGAS-Gas,Bills,29,803
15,8,2016,South West Trains,Transport,24,779
15,8,2016,Starbucks Coffee,Eating Out,2,777
15,8,2016,The West Cornwall Pasty Company,Eating Out,7,770
15,8,2016,ATM Cash Withdrawal,General,20,750
16,8,2016,LBS Council Tax,Bills,50,700
16,8,2016,Chicken Cottage,Eating Out,4,696
16,8,2016,ATM Cash Withdrawal,General,20,676
17,8,2016,Costa Coffee,Eating Out,1,675
17,8,2016,ATM Cash Withdrawal,General,20,655
18,8,2016,Starbucks Coffee,Eating Out,2,653
18,8,2016,Greggs,Eating Out,4,649
19,8,2016,Tescos,Groceries,72,577
19,8,2016,Pret A Manger,Eating Out,7,570
19,8,2016,Fabric Club,Eating Out,14,556
19,8,2016,Fabric Club,Eating Out,14,542
19,8,2016,ATM Cash Withdrawal,General,20,522
20,8,2016,VIRGIN MEDIA PYMTS,Bills,33,489
20,8,2016,Fabric Club,Eating Out,16,473
20,8,2016,Fabric Club,Eating Out,15,458
20,8,2016,Fabric Club,Eating Out,12,446
20,8,2016,Fabric Club,Eating Out,16,430
20,8,2016,Anglo restaurant,Eating Out,46,384
21,8,2016,Pizza Express,Eating Out,26,358
22,8,2016,South West Trains,Transport,38,320
22,8,2016,Wild Bean Cafe,Eating Out,2,318
23,8,2016,Caffe Nero,Eating Out,1,317
23,8,2016,Greggs,Eating Out,8,309
24,8,2016,O2,Bills,38,271
24,8,2016,Caffe Nero,Eating Out,2,269
24,8,2016,Chicken Cottage,Eating Out,4,265
26,8,2016,Sainsburys,Groceries,78,187
26,8,2016,Heaven Club,Eating Out,11,176
26,8,2016,Heaven Club,Eating Out,12,164
26,8,2016,Heaven Club,Eating Out,10,154
26,8,2016,Heaven Club,Eating Out,9,145
26,8,2016,Heaven Club,Eating Out,8,137
26,8,2016,Heaven Club,Eating Out,9,128
26,8,2016,ATM Cash Withdrawal,General,10,118
29,8,2016,South West Trains,Transport,30,88
29,8,2016,ATM Cash Withdrawal,General,10,78
30,8,2016,Caffe Nero,Eating Out,1,77
30,8,2016,Greggs,Eating Out,8,69
30,8,2016,ATM Cash Withdrawal,General,20,49
31,8,2016,Costa Coffee,Eating Out,1,48
31,8,2016,Pret A Manger,Eating Out,7,41
31,8,2016,ATM Cash Withdrawal,General,20,21
1,9,2016,Rhino Sports salary,General,1700,1721
1,9,2016,Caffe Nero,Eating Out,1,1720
1,9,2016,ATM Cash Withdrawal,General,20,1700
2,9,2016,Morrisons,Groceries,83,1617
2,9,2016,Caffe Nero,Eating Out,2,1615
2,9,2016,Greggs,Eating Out,4,1611
2,9,2016,Fabric Club,Eating Out,14,1597
2,9,2016,Fabric Club,Eating Out,15,1582
2,9,2016,Fabric Club,Eating Out,9,1573
2,9,2016,Fabric Club,Eating Out,8,1565
3,9,2016,Paying back James,,5,1560
4,9,2016,Anglo restaurant,Eating Out,24,1536
4,9,2016,ATM Cash Withdrawal,General,20,1516
5,9,2016,South West Trains,Transport,28,1488
5,9,2016,Caffe Nero,Eating Out,2,1486
6,9,2016,Costa Coffee,Eating Out,2,1484
6,9,2016,Subway,Eating Out,4,1480
7,9,2016,Cubit and West rent,Rent,550,930
7,9,2016,Costa Coffee,Eating Out,1,929
8,9,2016,Starbucks Coffee,Eating Out,2,927
8,9,2016,Greggs,Eating Out,4,923
9,9,2016,Morrisons,Groceries,67,856
9,9,2016,Starbucks Coffee,Eating Out,2,854
10,9,2016,Ministry of Sound ClubXOYO Club,Eating Out,16,838
10,9,2016,Ministry of Sound ClubXOYO Club,Eating Out,10,828
10,9,2016,Ministry of Sound ClubXOYO Club,Eating Out,5,823
10,9,2016,Ministry of Sound ClubXOYO Club,Eating Out,16,807
10,9,2016,Ministry of Sound ClubXOYO Club,Eating Out,13,794
10,9,2016,Ministry of Sound ClubXOYO Club,Eating Out,8,786
12,9,2016,South West Trains,Transport,24,762
12,9,2016,Caffe Nero,Eating Out,1,761
12,9,2016,The West Cornwall Pasty Company,Eating Out,4,757
12,9,2016,ATM Cash Withdrawal,General,20,737
13,9,2016,Starbucks Coffee,Eating Out,1,736
13,9,2016,Pret A Manger,Eating Out,8,728
13,9,2016,Paying back James,,1,727
14,9,2016,Caffe Nero,Eating Out,2,725
14,9,2016,ATM Cash Withdrawal,General,20,705
15,9,2016,BRGAS-Electricity,Bills,26,679
15,9,2016,BRGAS-Gas,Bills,24,655
15,9,2016,Costa Coffee,Eating Out,2,653
15,9,2016,ATM Cash Withdrawal,General,20,633
15,9,2016,Paying back James,,1,632
16,9,2016,LBS Council Tax,Bills,50,582
16,9,2016,Sainsburys,Groceries,66,516
16,9,2016,The West Cornwall Pasty Company,Eating Out,5,511
17,9,2016,ATM Cash Withdrawal,General,20,491
18,9,2016,Scott's Restaurant,Eating Out,35,456
18,9,2016,Paying back James,,5,451
19,9,2016,South West Trains,Transport,31,420
19,9,2016,Wild Bean Cafe,Eating Out,2,418
19,9,2016,McDonalds,Eating Out,8,410
19,9,2016,ATM Cash Withdrawal,General,10,400
20,9,2016,VIRGIN MEDIA PYMTS,Bills,53,347
20,9,2016,Pret A Manger,Eating Out,4,343
21,9,2016,Costa Coffee,Eating Out,2,341
22,9,2016,Pret A Manger,Eating Out,4,337
23,9,2016,ASDA,Groceries,84,253
23,9,2016,Wild Bean Cafe,Eating Out,2,251
23,9,2016,Subway,Eating Out,8,243
23,9,2016,ATM Cash Withdrawal,General,20,223
24,9,2016,O2,Bills,32,191
24,9,2016,Anglo restaurant,Eating Out,47,144
24,9,2016,ATM Cash Withdrawal,General,20,124
25,9,2016,Anglo restaurant,Eating Out,34,90
25,9,2016,ATM Cash Withdrawal,General,10,80
26,9,2016,South West Trains,Transport,24,56
26,9,2016,Costa Coffee,Eating Out,2,54
26,9,2016,McDonalds,Eating Out,8,46
26,9,2016,ATM Cash Withdrawal,General,10,36
27,9,2016,Starbucks Coffee,Eating Out,2,34
27,9,2016,Chicken Cottage,Eating Out,6,28
28,9,2016,Caffe Nero,Eating Out,2,26
29,9,2016,ATM Cash Withdrawal,General,10,16
30,9,2016,Morrisons,Groceries,63,-47
30,9,2016,Costa Coffee,Eating Out,1,-48
30,9,2016,Chicken Cottage,Eating Out,7,-55
30,9,2016,Dominos Pizza,Eating Out,28,-83
30,9,2016,ATM Cash Withdrawal,General,20,-103
1,10,2016,Rhino Sports salary,General,1700,1597
1,10,2016,ATM Cash Withdrawal,General,20,1577
3,10,2016,South West Trains,Transport,34,1543
3,10,2016,Wild Bean Cafe,Eating Out,2,1541
4,10,2016,Pret A Manger,Eating Out,8,1533
5,10,2016,Tool Tec,,7,1526
6,10,2016,Pret A Manger,Eating Out,5,1521
7,10,2016,Cubit and West rent,Rent,550,971
7,10,2016,Morrisons,Groceries,82,889
7,10,2016,The West Cornwall Pasty Company,Eating Out,7,882
7,10,2016,ATM Cash Withdrawal,General,10,872
8,10,2016,Dominos Pizza,Eating Out,30,842
9,10,2016,Anglo restaurant,Eating Out,48,794
9,10,2016,ATM Cash Withdrawal,General,10,784
10,10,2016,South West Trains,Transport,38,746
10,10,2016,McDonalds,Eating Out,6,740
11,10,2016,Wild Bean Cafe,Eating Out,2,738
11,10,2016,ATM Cash Withdrawal,General,20,718
12,10,2016,Starbucks Coffee,Eating Out,1,717
12,10,2016,Pret A Manger,Eating Out,8,709
13,10,2016,Starbucks Coffee,Eating Out,1,708
13,10,2016,McDonalds,Eating Out,6,702
14,10,2016,Tescos,Groceries,85,617
15,10,2016,BRGAS-Electricity,Bills,31,586
15,10,2016,BRGAS-Gas,Bills,24,562
16,10,2016,LBS Council Tax,Bills,50,512
16,10,2016,Scott's Restaurant,Eating Out,28,484
17,10,2016,South West Trains,Transport,27,457
17,10,2016,The West Cornwall Pasty Company,Eating Out,7,450
18,10,2016,ATM Cash Withdrawal,General,20,430
18,10,2016,Tool Shop,,5,425
19,10,2016,Starbucks Coffee,Eating Out,2,423
19,10,2016,Subway,Eating Out,7,416
19,10,2016,ATM Cash Withdrawal,General,10,406
20,10,2016,VIRGIN MEDIA PYMTS,Bills,29,377
20,10,2016,Wild Bean Cafe,Eating Out,1,376
20,10,2016,Chicken Cottage,Eating Out,4,372
21,10,2016,ASDA,Groceries,75,297
21,10,2016,Wild Bean Cafe,Eating Out,2,295
22,10,2016,Anglo restaurant,Eating Out,29,266
22,10,2016,ATM Cash Withdrawal,General,10,256
23,10,2016,Paying back Julie,,9,247
24,10,2016,O2,Bills,38,209
24,10,2016,South West Trains,Transport,24,185
24,10,2016,Costa Coffee,Eating Out,2,183
24,10,2016,Greggs,Eating Out,5,178
25,10,2016,Starbucks Coffee,Eating Out,2,176
25,10,2016,McDonalds,Eating Out,6,170
26,10,2016,Costa Coffee,Eating Out,2,168
26,10,2016,ATM Cash Withdrawal,General,10,158
26,10,2016,Red Shop,,2,156
27,10,2016,Costa Coffee,Eating Out,2,154
27,10,2016,Greggs,Eating Out,7,147
28,10,2016,Waitrose,Groceries,83,64
28,10,2016,Caffe Nero,Eating Out,2,62
28,10,2016,Pizza Express,Eating Out,35,27
29,10,2016,Restaurant Gordon RamsayPortland Restaurant,Eating Out,53,-26
29,10,2016,ATM Cash Withdrawal,General,10,-36
31,10,2016,South West Trains,Transport,38,-74
31,10,2016,Caffe Nero,Eating Out,2,-76
1,11,2016,Rhino Sports salary,General,1700,1624
1,11,2016,McDonalds,Eating Out,6,1618
2,11,2016,Wild Bean Cafe,Eating Out,2,1616
2,11,2016,Chicken Cottage,Eating Out,5,1611
3,11,2016,Costa Coffee,Eating Out,1,1610
3,11,2016,The West Cornwall Pasty Company,Eating Out,7,1603
4,11,2016,Sainsburys,Groceries,86,1517
4,11,2016,Caffe Nero,Eating Out,2,1515
5,11,2016,Restaurant Gordon RamsayPortland Restaurant,Eating Out,34,1481
7,11,2016,Cubit and West rent,Rent,550,931
7,11,2016,South West Trains,Transport,35,896
7,11,2016,Starbucks Coffee,Eating Out,2,894
7,11,2016,McDonalds,Eating Out,8,886
9,11,2016,Starbucks Coffee,Eating Out,1,885
9,11,2016,The West Cornwall Pasty Company,Eating Out,7,878
9,11,2016,ATM Cash Withdrawal,General,10,868
10,11,2016,Starbucks Coffee,Eating Out,1,867
10,11,2016,McDonalds,Eating Out,4,863
10,11,2016,ATM Cash Withdrawal,General,10,853
10,11,2016,Cheam Service Station,,2,851
11,11,2016,Sainsburys,Groceries,61,790
11,11,2016,Starbucks Coffee,Eating Out,2,788
11,11,2016,The West Cornwall Pasty Company,Eating Out,6,782
12,11,2016,ATM Cash Withdrawal,General,20,762
13,11,2016,Scott's Restaurant,Eating Out,56,706
14,11,2016,South West Trains,Transport,38,668
14,11,2016,Wild Bean Cafe,Eating Out,2,666
14,11,2016,Pret A Manger,Eating Out,6,660
15,11,2016,BRGAS-Electricity,Bills,89,571
15,11,2016,BRGAS-Gas,Bills,43,528
15,11,2016,McDonalds,Eating Out,4,524
15,11,2016,ATM Cash Withdrawal,General,20,504
16,11,2016,LBS Council Tax,Bills,50,454
16,11,2016,Costa Coffee,Eating Out,1,453
16,11,2016,Chicken Cottage,Eating Out,8,445
17,11,2016,The West Cornwall Pasty Company,Eating Out,4,441
17,11,2016,ATM Cash Withdrawal,General,10,431
18,11,2016,Sainsburys,Groceries,62,369
18,11,2016,Greggs,Eating Out,5,364
19,11,2016,Ministry of Sound ClubXOYO Club,Eating Out,9,355
19,11,2016,Ministry of Sound ClubXOYO Club,Eating Out,15,340
19,11,2016,Ministry of Sound ClubXOYO Club,Eating Out,16,324
19,11,2016,Ministry of Sound ClubXOYO Club,Eating Out,6,318
19,11,2016,Ministry of Sound ClubXOYO Club,Eating Out,8,310
19,11,2016,Ministry of Sound ClubXOYO Club,Eating Out,16,294
20,11,2016,VIRGIN MEDIA PYMTS,Bills,51,243
21,11,2016,South West Trains,Transport,31,212
21,11,2016,Starbucks Coffee,Eating Out,2,210
22,11,2016,Wild Bean Cafe,Eating Out,2,208
23,11,2016,Starbucks Coffee,Eating Out,2,206
23,11,2016,Subway,Eating Out,7,199
24,11,2016,O2,Bills,32,167
24,11,2016,Wild Bean Cafe,Eating Out,1,166
24,11,2016,McDonalds,Eating Out,7,159
25,11,2016,Morrisons,Groceries,53,106
25,11,2016,Costa Coffee,Eating Out,1,105
25,11,2016,Chicken Cottage,Eating Out,7,98
28,11,2016,South West Trains,Transport,24,74
28,11,2016,Wild Bean Cafe,Eating Out,2,72
28,11,2016,Subway,Eating Out,4,68
29,11,2016,Costa Coffee,Eating Out,1,67
29,11,2016,Greggs,Eating Out,5,62
30,11,2016,Starbucks Coffee,Eating Out,2,60
30,11,2016,ATM Cash Withdrawal,General,10,50
1,12,2016,Rhino Sports salary,General,1700,1750
1,12,2016,Costa Coffee,Eating Out,2,1748
1,12,2016,Chicken Cottage,Eating Out,4,1744
1,12,2016,ATM Cash Withdrawal,General,10,1734
2,12,2016,ASDA,Groceries,50,1684
2,12,2016,Greggs,Eating Out,6,1678
2,12,2016,ATM Cash Withdrawal,General,20,1658
5,12,2016,South West Trains,Transport,34,1624
5,12,2016,Costa Coffee,Eating Out,2,1622
5,12,2016,McDonalds,Eating Out,6,1616
6,12,2016,Subway,Eating Out,5,1611
6,12,2016,Civic Shop,,6,1605
7,12,2016,Cubit and West rent,Rent,550,1055
7,12,2016,Subway,Eating Out,5,1050
8,12,2016,Costa Coffee,Eating Out,1,1049
8,12,2016,Chicken Cottage,Eating Out,5,1044
8,12,2016,Cheam Service Station,,4,1040
9,12,2016,Tescos,Groceries,54,986
9,12,2016,Starbucks Coffee,Eating Out,2,984
9,12,2016,Heaven Club,Eating Out,11,973
9,12,2016,Heaven Club,Eating Out,12,961
9,12,2016,Heaven Club,Eating Out,10,951
9,12,2016,Dominos Pizza,Eating Out,51,900
9,12,2016,ATM Cash Withdrawal,General,20,880
11,12,2016,ATM Cash Withdrawal,General,10,870
12,12,2016,South West Trains,Transport,33,837
12,12,2016,Costa Coffee,Eating Out,2,835
13,12,2016,Caffe Nero,Eating Out,1,834
14,12,2016,Costa Coffee,Eating Out,1,833
14,12,2016,McDonalds,Eating Out,7,826
14,12,2016,ATM Cash Withdrawal,General,20,806
15,12,2016,BRGAS-Electricity,Bills,36,770
15,12,2016,BRGAS-Gas,Bills,41,729
15,12,2016,Caffe Nero,Eating Out,1,728
16,12,2016,LBS Council Tax,Bills,50,678
16,12,2016,Morrisons,Groceries,43,635
16,12,2016,Costa Coffee,Eating Out,1,634
16,12,2016,Chicken Cottage,Eating Out,7,627
16,12,2016,Paying back James,,8,619
17,12,2016,Dominos Pizza,Eating Out,46,573
17,12,2016,Tool Tec,,4,569
19,12,2016,South West Trains,Transport,35,534
19,12,2016,Caffe Nero,Eating Out,1,533
20,12,2016,VIRGIN MEDIA PYMTS,Bills,35,498
20,12,2016,Starbucks Coffee,Eating Out,1,497
20,12,2016,Greggs,Eating Out,5,492
20,12,2016,ATM Cash Withdrawal,General,10,482
21,12,2016,Wild Bean Cafe,Eating Out,1,481
21,12,2016,Subway,Eating Out,7,474
21,12,2016,ATM Cash Withdrawal,General,20,454
23,12,2016,Morrisons,Groceries,50,404
23,12,2016,Chicken Cottage,Eating Out,4,400
23,12,2016,ATM Cash Withdrawal,General,10,390
23,12,2016,Cheam Service Station,,4,386
24,12,2016,O2,Bills,36,350
24,12,2016,Dominos Pizza,Eating Out,26,324
26,12,2016,South West Trains,Transport,24,300
26,12,2016,Costa Coffee,Eating Out,1,299
26,12,2016,Pret A Manger,Eating Out,8,291
27,12,2016,Wild Bean Cafe,Eating Out,2,289
28,12,2016,Starbucks Coffee,Eating Out,2,287
28,12,2016,ATM Cash Withdrawal,General,10,277
29,12,2016,Starbucks Coffee,Eating Out,2,275
29,12,2016,Subway,Eating Out,6,269
29,12,2016,ATM Cash Withdrawal,General,20,249
30,12,2016,Sainsburys,Groceries,86,163
30,12,2016,Starbucks Coffee,Eating Out,2,161
30,12,2016,Scott's Restaurant,Eating Out,34,127
31,12,2016,Heaven Club,Eating Out,11,116
31,12,2016,Heaven Club,Eating Out,15,101
31,12,2016,Heaven Club,Eating Out,10,91
31,12,2016,Heaven Club,Eating Out,14,77
31,12,2016,Heaven Club,Eating Out,8,69
31,12,2016,Heaven Club,Eating Out,5,64
31,12,2016,Tool Shop,,2,62
1,1,2017,Rhino Sports salary,General,1700,1762
1,1,2017,Red Shop,,9,1753
2,1,2017,South West Trains,Transport,28,1725
2,1,2017,Starbucks Coffee,Eating Out,2,1723
2,1,2017,Subway,Eating Out,7,1716
3,1,2017,Costa Coffee,Eating Out,2,1714
4,1,2017,ATM Cash Withdrawal,General,20,1694
5,1,2017,Caffe Nero,Eating Out,2,1692
5,1,2017,ATM Cash Withdrawal,General,20,1672
6,1,2017,Tescos,Groceries,71,1601
6,1,2017,Caffe Nero,Eating Out,2,1599
6,1,2017,Chicken Cottage,Eating Out,4,1595
7,1,2017,Cubit and West rent,Rent,550,1045
8,1,2017,ATM Cash Withdrawal,General,10,1035
9,1,2017,South West Trains,Transport,24,1011
9,1,2017,Caffe Nero,Eating Out,1,1010
9,1,2017,Subway,Eating Out,5,1005
10,1,2017,Caffe Nero,Eating Out,2,1003
11,1,2017,Costa Coffee,Eating Out,2,1001
11,1,2017,Chicken Cottage,Eating Out,5,996
12,1,2017,Caffe Nero,Eating Out,1,995
12,1,2017,McDonalds,Eating Out,8,987
13,1,2017,Tescos,Groceries,80,907
13,1,2017,Wild Bean Cafe,Eating Out,1,906
13,1,2017,Dominos Pizza,Eating Out,51,855
13,1,2017,Red Shop,,1,854
14,1,2017,Pizza Express,Eating Out,43,811
14,1,2017,Cheam Service Station,,8,803
15,1,2017,BRGAS-Electricity,Bills,66,737
15,1,2017,BRGAS-Gas,Bills,43,694
16,1,2017,LBS Council Tax,Bills,50,644
16,1,2017,South West Trains,Transport,26,618
16,1,2017,Wild Bean Cafe,Eating Out,2,616
17,1,2017,Wild Bean Cafe,Eating Out,1,615
17,1,2017,Paying back James,,6,609
18,1,2017,Starbucks Coffee,Eating Out,2,607
18,1,2017,ATM Cash Withdrawal,General,20,587
18,1,2017,Tool Tec,,3,584
19,1,2017,Wild Bean Cafe,Eating Out,2,582
19,1,2017,Pret A Manger,Eating Out,7,575
20,1,2017,VIRGIN MEDIA PYMTS,Bills,59,516
20,1,2017,Sainsburys,Groceries,74,442
20,1,2017,Wild Bean Cafe,Eating Out,2,440
20,1,2017,Civic Shop,,4,436
21,1,2017,Anglo restaurant,Eating Out,48,388
21,1,2017,ATM Cash Withdrawal,General,20,368
22,1,2017,Scott's Restaurant,Eating Out,36,332
22,1,2017,ATM Cash Withdrawal,General,10,322
23,1,2017,South West Trains,Transport,26,296
23,1,2017,Subway,Eating Out,6,290
23,1,2017,ATM Cash Withdrawal,General,10,280
23,1,2017,Civic Shop,,1,279
24,1,2017,O2,Bills,32,247
24,1,2017,Wild Bean Cafe,Eating Out,1,246
27,1,2017,Waitrose,Groceries,59,187
27,1,2017,Caffe Nero,Eating Out,2,185
28,1,2017,Scott's Restaurant,Eating Out,40,145
30,1,2017,South West Trains,Transport,27,118
30,1,2017,Wild Bean Cafe,Eating Out,1,117
30,1,2017,Chicken Cottage,Eating Out,7,110
31,1,2017,Starbucks Coffee,Eating Out,2,108
31,1,2017,Chicken Cottage,Eating Out,4,104
31,1,2017,Tool Tec,,8,96
1,2,2017,Rhino Sports salary,General,1700,1796
1,2,2017,Starbucks Coffee,Eating Out,2,1794
1,2,2017,Pret A Manger,Eating Out,7,1787
2,2,2017,Costa Coffee,Eating Out,2,1785
2,2,2017,Chicken Cottage,Eating Out,8,1777
3,2,2017,Waitrose,Groceries,45,1732
3,2,2017,McDonalds,Eating Out,4,1728
3,2,2017,Dominos Pizza,Eating Out,26,1702
3,2,2017,ATM Cash Withdrawal,General,20,1682
4,2,2017,Heaven Club,Eating Out,11,1671
4,2,2017,Pizza Express,Eating Out,27,1644
5,2,2017,Anglo restaurant,Eating Out,38,1606
6,2,2017,South West Trains,Transport,27,1579
6,2,2017,Costa Coffee,Eating Out,1,1578
6,2,2017,Chicken Cottage,Eating Out,6,1572
7,2,2017,Cubit and West rent,Rent,550,1022
7,2,2017,Chicken Cottage,Eating Out,5,1017
9,2,2017,Pret A Manger,Eating Out,8,1009
9,2,2017,Cheam Service Station,,9,1000
10,2,2017,Morrisons,Groceries,50,950
11,2,2017,Fabric Club,Eating Out,13,937
11,2,2017,Fabric Club,Eating Out,11,926
11,2,2017,Dominos Pizza,Eating Out,45,881
12,2,2017,Scott's Restaurant,Eating Out,35,846
13,2,2017,South West Trains,Transport,31,815
13,2,2017,Caffe Nero,Eating Out,2,813
14,2,2017,Caffe Nero,Eating Out,2,811
14,2,2017,Chicken Cottage,Eating Out,7,804
15,2,2017,BRGAS-Electricity,Bills,23,781
15,2,2017,BRGAS-Gas,Bills,30,751
15,2,2017,Costa Coffee,Eating Out,1,750
15,2,2017,Pret A Manger,Eating Out,6,744
15,2,2017,ATM Cash Withdrawal,General,20,724
16,2,2017,LBS Council Tax,Bills,50,674
16,2,2017,Wild Bean Cafe,Eating Out,1,673
16,2,2017,Greggs,Eating Out,4,669
16,2,2017,ATM Cash Withdrawal,General,20,649
17,2,2017,Morrisons,Groceries,86,563
17,2,2017,Starbucks Coffee,Eating Out,2,561
17,2,2017,Pizza Express,Eating Out,50,511
17,2,2017,Tool Tec,,2,509
19,2,2017,Pizza Express,Eating Out,30,479
19,2,2017,Paying back James,,3,476
20,2,2017,VIRGIN MEDIA PYMTS,Bills,58,418
20,2,2017,South West Trains,Transport,34,384
20,2,2017,Caffe Nero,Eating Out,1,383
21,2,2017,Chicken Cottage,Eating Out,8,375
22,2,2017,ATM Cash Withdrawal,General,10,365
23,2,2017,Caffe Nero,Eating Out,2,363
23,2,2017,Subway,Eating Out,4,359
24,2,2017,O2,Bills,32,327
24,2,2017,ASDA,Groceries,65,262
24,2,2017,ATM Cash Withdrawal,General,20,242
25,2,2017,ATM Cash Withdrawal,General,10,232
26,2,2017,ATM Cash Withdrawal,General,20,212
27,2,2017,South West Trains,Transport,37,175
27,2,2017,Starbucks Coffee,Eating Out,2,173
27,2,2017,Subway,Eating Out,5,168
28,2,2017,Caffe Nero,Eating Out,2,166
28,2,2017,Subway,Eating Out,5,161
1,3,2017,Rhino Sports salary,General,1700,1861
1,3,2017,Wild Bean Cafe,Eating Out,1,1860
1,3,2017,McDonalds,Eating Out,7,1853
1,3,2017,ATM Cash Withdrawal,General,10,1843
2,3,2017,Starbucks Coffee,Eating Out,2,1841
2,3,2017,Subway,Eating Out,6,1835
3,3,2017,ASDA,Groceries,69,1766
3,3,2017,Starbucks Coffee,Eating Out,2,1764
3,3,2017,McDonalds,Eating Out,7,1757
3,3,2017,Scott's Restaurant,Eating Out,27,1730
3,3,2017,ATM Cash Withdrawal,General,20,1710
3,3,2017,Paying back James,,8,1702
4,3,2017,Heaven Club,Eating Out,10,1692
4,3,2017,Heaven Club,Eating Out,11,1681
4,3,2017,Heaven Club,Eating Out,10,1671
4,3,2017,Heaven Club,Eating Out,10,1661
4,3,2017,Heaven Club,Eating Out,5,1656
4,3,2017,Tool Shop,,8,1648
5,3,2017,Scott's Restaurant,Eating Out,29,1619
5,3,2017,Paying back Julie,,5,1614
6,3,2017,South West Trains,Transport,30,1584
6,3,2017,Starbucks Coffee,Eating Out,2,1582
6,3,2017,Tool Tec,,4,1578
7,3,2017,Cubit and West rent,Rent,550,1028
7,3,2017,Caffe Nero,Eating Out,2,1026
7,3,2017,Subway,Eating Out,5,1021
8,3,2017,Caffe Nero,Eating Out,2,1019
8,3,2017,Chicken Cottage,Eating Out,6,1013
9,3,2017,Wild Bean Cafe,Eating Out,2,1011
10,3,2017,ASDA,Groceries,82,929
10,3,2017,Subway,Eating Out,5,924
10,3,2017,Scott's Restaurant,Eating Out,52,872
10,3,2017,ATM Cash Withdrawal,General,20,852
10,3,2017,Tool Shop,,9,843
11,3,2017,ATM Cash Withdrawal,General,10,833
13,3,2017,South West Trains,Transport,30,803
13,3,2017,Costa Coffee,Eating Out,2,801
13,3,2017,The West Cornwall Pasty Company,Eating Out,5,796
14,3,2017,Costa Coffee,Eating Out,2,794
14,3,2017,McDonalds,Eating Out,5,789
15,3,2017,BRGAS-Electricity,Bills,38,751
15,3,2017,BRGAS-Gas,Bills,39,712
15,3,2017,Wild Bean Cafe,Eating Out,2,710
15,3,2017,Subway,Eating Out,5,705
16,3,2017,LBS Council Tax,Bills,50,655
16,3,2017,Starbucks Coffee,Eating Out,2,653
17,3,2017,Waitrose,Groceries,86,567
17,3,2017,Starbucks Coffee,Eating Out,2,565
18,3,2017,ATM Cash Withdrawal,General,20,545
19,3,2017,Civic Shop,,3,542
20,3,2017,VIRGIN MEDIA PYMTS,Bills,51,491
20,3,2017,South West Trains,Transport,28,463
20,3,2017,Wild Bean Cafe,Eating Out,2,461
20,3,2017,The West Cornwall Pasty Company,Eating Out,8,453
21,3,2017,Costa Coffee,Eating Out,1,452
21,3,2017,Pret A Manger,Eating Out,5,447
23,3,2017,Starbucks Coffee,Eating Out,1,446
23,3,2017,Pret A Manger,Eating Out,5,441
24,3,2017,O2,Bills,30,411
24,3,2017,Waitrose,Groceries,82,329
24,3,2017,Subway,Eating Out,6,323
24,3,2017,Fabric Club,Eating Out,14,309
24,3,2017,Fabric Club,Eating Out,7,302
24,3,2017,Fabric Club,Eating Out,8,294
24,3,2017,Dominos Pizza,Eating Out,52,242
24,3,2017,ATM Cash Withdrawal,General,10,232
26,3,2017,Anglo restaurant,Eating Out,58,174
26,3,2017,ATM Cash Withdrawal,General,20,154
27,3,2017,South West Trains,Transport,35,119
27,3,2017,Pret A Manger,Eating Out,7,112
27,3,2017,ATM Cash Withdrawal,General,10,102
28,3,2017,Chicken Cottage,Eating Out,8,94
28,3,2017,ATM Cash Withdrawal,General,10,84
29,3,2017,Caffe Nero,Eating Out,1,83
29,3,2017,ATM Cash Withdrawal,General,20,63
30,3,2017,Subway,Eating Out,7,56
30,3,2017,ATM Cash Withdrawal,General,20,36
31,3,2017,Tescos,Groceries,57,-21
31,3,2017,Caffe Nero,Eating Out,1,-22
31,3,2017,Chicken Cottage,Eating Out,5,-27
31,3,2017,Fabric Club,Eating Out,14,-41
31,3,2017,Fabric Club,Eating Out,13,-54
31,3,2017,Fabric Club,Eating Out,13,-67
31,3,2017,Fabric Club,Eating Out,10,-77
31,3,2017,Fabric Club,Eating Out,11,-88
1,4,2017,Rhino Sports salary,General,1700,1612
3,4,2017,South West Trains,Transport,35,1577
3,4,2017,Costa Coffee,Eating Out,1,1576
3,4,2017,Pret A Manger,Eating Out,6,1570
3,4,2017,ATM Cash Withdrawal,General,20,1550
4,4,2017,Wild Bean Cafe,Eating Out,1,1549
4,4,2017,Greggs,Eating Out,5,1544
6,4,2017,Caffe Nero,Eating Out,1,1543
6,4,2017,Pret A Manger,Eating Out,8,1535
7,4,2017,Cubit and West rent,Rent,550,985
7,4,2017,ASDA,Groceries,77,908
7,4,2017,Wild Bean Cafe,Eating Out,1,907
7,4,2017,Chicken Cottage,Eating Out,8,899
8,4,2017,Anglo restaurant,Eating Out,46,853
9,4,2017,ATM Cash Withdrawal,General,20,833
10,4,2017,South West Trains,Transport,26,807
10,4,2017,Costa Coffee,Eating Out,2,805
10,4,2017,Chicken Cottage,Eating Out,8,797
11,4,2017,Costa Coffee,Eating Out,2,795
11,4,2017,Subway,Eating Out,8,787
11,4,2017,ATM Cash Withdrawal,General,20,767
11,4,2017,Paying back James,,2,765
12,4,2017,Starbucks Coffee,Eating Out,2,763
13,4,2017,Wild Bean Cafe,Eating Out,1,762
14,4,2017,Tescos,Groceries,61,701
14,4,2017,Caffe Nero,Eating Out,2,699
14,4,2017,Subway,Eating Out,6,693
14,4,2017,The Grand Pub,Eating Out,8,685
14,4,2017,ATM Cash Withdrawal,General,10,675
14,4,2017,Tool Tec,,9,666
15,4,2017,BRGAS-Electricity,Bills,22,644
15,4,2017,BRGAS-Gas,Bills,22,622
15,4,2017,Anglo restaurant,Eating Out,57,565
15,4,2017,ATM Cash Withdrawal,General,10,555
16,4,2017,LBS Council Tax,Bills,50,505
16,4,2017,Anglo restaurant,Eating Out,58,447
16,4,2017,Paying back Julie,,6,441
17,4,2017,South West Trains,Transport,29,412
17,4,2017,Caffe Nero,Eating Out,1,411
17,4,2017,Greggs,Eating Out,4,407
18,4,2017,Costa Coffee,Eating Out,2,405
18,4,2017,McDonalds,Eating Out,8,397
19,4,2017,Greggs,Eating Out,6,391
20,4,2017,VIRGIN MEDIA PYMTS,Bills,32,359
20,4,2017,Wild Bean Cafe,Eating Out,1,358
21,4,2017,Tescos,Groceries,69,289
21,4,2017,Fabric Club,Eating Out,6,283
21,4,2017,Fabric Club,Eating Out,10,273
21,4,2017,Fabric Club,Eating Out,15,258
21,4,2017,Fabric Club,Eating Out,5,253
21,4,2017,Fabric Club,Eating Out,6,247
21,4,2017,Red Shop,,7,240
22,4,2017,ATM Cash Withdrawal,General,10,230
23,4,2017,Restaurant Gordon RamsayPortland Restaurant,Eating Out,58,172
23,4,2017,ATM Cash Withdrawal,General,20,152
24,4,2017,O2,Bills,37,115
24,4,2017,South West Trains,Transport,31,84
24,4,2017,Costa Coffee,Eating Out,1,83
24,4,2017,Subway,Eating Out,4,79
25,4,2017,Starbucks Coffee,Eating Out,2,77
25,4,2017,The West Cornwall Pasty Company,Eating Out,4,73
25,4,2017,ATM Cash Withdrawal,General,10,63
25,4,2017,Red Shop,,3,60
26,4,2017,Wild Bean Cafe,Eating Out,2,58
26,4,2017,The West Cornwall Pasty Company,Eating Out,6,52
27,4,2017,McDonalds,Eating Out,8,44
27,4,2017,ATM Cash Withdrawal,General,20,24
28,4,2017,Sainsburys,Groceries,50,-26
28,4,2017,The West Cornwall Pasty Company,Eating Out,4,-30
29,4,2017,Tool Shop,,2,-32
1,5,2017,Rhino Sports salary,General,1700,1668
1,5,2017,South West Trains,Transport,27,1641
1,5,2017,Costa Coffee,Eating Out,2,1639
2,5,2017,Caffe Nero,Eating Out,1,1638
2,5,2017,The West Cornwall Pasty Company,Eating Out,6,1632
3,5,2017,Wild Bean Cafe,Eating Out,1,1631
3,5,2017,Pret A Manger,Eating Out,6,1625
3,5,2017,Civic Shop,,6,1619
4,5,2017,Starbucks Coffee,Eating Out,2,1617
4,5,2017,ATM Cash Withdrawal,General,20,1597
5,5,2017,Waitrose,Groceries,52,1545
5,5,2017,Wild Bean Cafe,Eating Out,2,1543
5,5,2017,Heaven Club,Eating Out,7,1536
5,5,2017,Scott's Restaurant,Eating Out,45,1491
5,5,2017,ATM Cash Withdrawal,General,20,1471
5,5,2017,Civic Shop,,7,1464
7,5,2017,Cubit and West rent,Rent,550,914
8,5,2017,South West Trains,Transport,28,886
8,5,2017,Starbucks Coffee,Eating Out,2,884
8,5,2017,Chicken Cottage,Eating Out,4,880
8,5,2017,ATM Cash Withdrawal,General,20,860
9,5,2017,Costa Coffee,Eating Out,2,858
9,5,2017,The West Cornwall Pasty Company,Eating Out,5,853
10,5,2017,Subway,Eating Out,4,849
10,5,2017,ATM Cash Withdrawal,General,10,839
11,5,2017,Costa Coffee,Eating Out,2,837
11,5,2017,The West Cornwall Pasty Company,Eating Out,6,831
12,5,2017,Sainsburys,Groceries,85,746
12,5,2017,Costa Coffee,Eating Out,2,744
12,5,2017,The West Cornwall Pasty Company,Eating Out,4,740
12,5,2017,ATM Cash Withdrawal,General,20,720
13,5,2017,Anglo restaurant,Eating Out,43,677
14,5,2017,Anglo restaurant,Eating Out,59,618
15,5,2017,BRGAS-Electricity,Bills,37,581
15,5,2017,BRGAS-Gas,Bills,27,554
15,5,2017,South West Trains,Transport,32,522
15,5,2017,Costa Coffee,Eating Out,2,520
15,5,2017,ATM Cash Withdrawal,General,20,500
16,5,2017,LBS Council Tax,Bills,50,450
16,5,2017,Caffe Nero,Eating Out,1,449
16,5,2017,Greggs,Eating Out,4,445
16,5,2017,Tool Tec,,5,440
17,5,2017,Wild Bean Cafe,Eating Out,1,439
18,5,2017,Costa Coffee,Eating Out,2,437
19,5,2017,Sainsburys,Groceries,58,379
19,5,2017,Costa Coffee,Eating Out,2,377
19,5,2017,Chicken Cottage,Eating Out,5,372
19,5,2017,Anglo restaurant,Eating Out,24,348
20,5,2017,VIRGIN MEDIA PYMTS,Bills,51,297
20,5,2017,Red Shop,,1,296
21,5,2017,Anglo restaurant,Eating Out,54,242
22,5,2017,South West Trains,Transport,35,207
22,5,2017,Starbucks Coffee,Eating Out,1,206
23,5,2017,Starbucks Coffee,Eating Out,1,205
23,5,2017,McDonalds,Eating Out,5,200
24,5,2017,O2,Bills,36,164
24,5,2017,Wild Bean Cafe,Eating Out,1,163
25,5,2017,Costa Coffee,Eating Out,2,161
25,5,2017,McDonalds,Eating Out,5,156
25,5,2017,ATM Cash Withdrawal,General,20,136
26,5,2017,ASDA,Groceries,80,56
26,5,2017,Caffe Nero,Eating Out,2,54
26,5,2017,Scott's Restaurant,Eating Out,44,10
27,5,2017,Fabric Club,Eating Out,13,-3
27,5,2017,Fabric Club,Eating Out,5,-8
27,5,2017,Fabric Club,Eating Out,7,-15
27,5,2017,Fabric Club,Eating Out,6,-21
27,5,2017,ATM Cash Withdrawal,General,20,-41
29,5,2017,South West Trains,Transport,29,-70
29,5,2017,The West Cornwall Pasty Company,Eating Out,4,-74
29,5,2017,ATM Cash Withdrawal,General,20,-94
31,5,2017,Caffe Nero,Eating Out,2,-96
31,5,2017,Subway,Eating Out,8,-104
1,6,2017,Rhino Sports salary,General,1700,1596
1,6,2017,Starbucks Coffee,Eating Out,1,1595
1,6,2017,Subway,Eating Out,4,1591
2,6,2017,ASDA,Groceries,57,1534
2,6,2017,Starbucks Coffee,Eating Out,2,1532
2,6,2017,Subway,Eating Out,5,1527
3,6,2017,Restaurant Gordon RamsayPortland Restaurant,Eating Out,52,1475
3,6,2017,ATM Cash Withdrawal,General,10,1465
4,6,2017,Dominos Pizza,Eating Out,55,1410
5,6,2017,South West Trains,Transport,29,1381
5,6,2017,Costa Coffee,Eating Out,1,1380
5,6,2017,Subway,Eating Out,4,1376
6,6,2017,Caffe Nero,Eating Out,2,1374
6,6,2017,McDonalds,Eating Out,6,1368
7,6,2017,Cubit and West rent,Rent,550,818
7,6,2017,Costa Coffee,Eating Out,2,816
7,6,2017,ATM Cash Withdrawal,General,20,796
8,6,2017,Wild Bean Cafe,Eating Out,1,795
8,6,2017,Chicken Cottage,Eating Out,5,790
9,6,2017,Waitrose,Groceries,47,743
9,6,2017,Pret A Manger,Eating Out,6,737
11,6,2017,ATM Cash Withdrawal,General,10,727
12,6,2017,South West Trains,Transport,27,700
12,6,2017,Costa Coffee,Eating Out,2,698
12,6,2017,Greggs,Eating Out,8,690
13,6,2017,Starbucks Coffee,Eating Out,1,689
13,6,2017,McDonalds,Eating Out,5,684
14,6,2017,Starbucks Coffee,Eating Out,1,683
14,6,2017,Subway,Eating Out,7,676
15,6,2017,BRGAS-Electricity,Bills,44,632
15,6,2017,BRGAS-Gas,Bills,34,598
15,6,2017,Starbucks Coffee,Eating Out,2,596
15,6,2017,Subway,Eating Out,4,592
16,6,2017,LBS Council Tax,Bills,50,542
16,6,2017,Tescos,Groceries,72,470
16,6,2017,Pret A Manger,Eating Out,4,466
17,6,2017,ATM Cash Withdrawal,General,20,446
18,6,2017,Dominos Pizza,Eating Out,48,398
19,6,2017,South West Trains,Transport,26,372
19,6,2017,Caffe Nero,Eating Out,1,371
19,6,2017,ATM Cash Withdrawal,General,20,351
20,6,2017,VIRGIN MEDIA PYMTS,Bills,36,315
20,6,2017,Caffe Nero,Eating Out,2,313
20,6,2017,Subway,Eating Out,5,308
20,6,2017,ATM Cash Withdrawal,General,20,288
21,6,2017,Wild Bean Cafe,Eating Out,1,287
21,6,2017,Chicken Cottage,Eating Out,7,280
22,6,2017,Starbucks Coffee,Eating Out,1,279
22,6,2017,Greggs,Eating Out,5,274
23,6,2017,Waitrose,Groceries,71,203
23,6,2017,Starbucks Coffee,Eating Out,2,201
23,6,2017,The West Cornwall Pasty Company,Eating Out,8,193
23,6,2017,Scott's Restaurant,Eating Out,44,149
24,6,2017,O2,Bills,36,113
24,6,2017,Scott's Restaurant,Eating Out,40,73
26,6,2017,South West Trains,Transport,28,45
26,6,2017,Starbucks Coffee,Eating Out,2,43
27,6,2017,Wild Bean Cafe,Eating Out,2,41
27,6,2017,Subway,Eating Out,6,35
28,6,2017,Caffe Nero,Eating Out,2,33
28,6,2017,Pret A Manger,Eating Out,7,26
29,6,2017,Caffe Nero,Eating Out,2,24
29,6,2017,Red Shop,,2,22
30,6,2017,Waitrose,Groceries,65,-43
30,6,2017,Wild Bean Cafe,Eating Out,2,-45
1,7,2017,Rhino Sports salary,General,1700,1655
2,7,2017,Restaurant Gordon RamsayPortland Restaurant,Eating Out,51,1604
2,7,2017,Red Shop,,5,1599
3,7,2017,South West Trains,Transport,36,1563
3,7,2017,Costa Coffee,Eating Out,2,1561
3,7,2017,ATM Cash Withdrawal,General,20,1541
3,7,2017,Tool Shop,,6,1535
4,7,2017,Chicken Cottage,Eating Out,7,1528
6,7,2017,Starbucks Coffee,Eating Out,1,1527
6,7,2017,Subway,Eating Out,7,1520
7,7,2017,Cubit and West rent,Rent,550,970
7,7,2017,Sainsburys,Groceries,65,905
7,7,2017,Caffe Nero,Eating Out,2,903
9,7,2017,Restaurant Gordon RamsayPortland Restaurant,Eating Out,36,867
9,7,2017,Paying back James,,6,861
10,7,2017,South West Trains,Transport,37,824
10,7,2017,Starbucks Coffee,Eating Out,2,822
10,7,2017,ATM Cash Withdrawal,General,20,802
12,7,2017,Starbucks Coffee,Eating Out,2,800
12,7,2017,Greggs,Eating Out,7,793
13,7,2017,Pret A Manger,Eating Out,6,787
13,7,2017,ATM Cash Withdrawal,General,20,767
14,7,2017,Sainsburys,Groceries,63,704
15,7,2017,BRGAS-Electricity,Bills,26,678
15,7,2017,BRGAS-Gas,Bills,28,650
15,7,2017,Restaurant Gordon RamsayPortland Restaurant,Eating Out,55,595
16,7,2017,LBS Council Tax,Bills,50,545
16,7,2017,ATM Cash Withdrawal,General,10,535
17,7,2017,South West Trains,Transport,30,505
17,7,2017,Caffe Nero,Eating Out,1,504
17,7,2017,Subway,Eating Out,8,496
18,7,2017,Costa Coffee,Eating Out,1,495
18,7,2017,The West Cornwall Pasty Company,Eating Out,5,490
19,7,2017,McDonalds,Eating Out,6,484
19,7,2017,ATM Cash Withdrawal,General,20,464
20,7,2017,VIRGIN MEDIA PYMTS,Bills,49,415
20,7,2017,The West Cornwall Pasty Company,Eating Out,7,408
20,7,2017,ATM Cash Withdrawal,General,20,388
21,7,2017,Tescos,Groceries,60,328
21,7,2017,Caffe Nero,Eating Out,1,327
21,7,2017,McDonalds,Eating Out,7,320
21,7,2017,Paying back Julie,,8,312
22,7,2017,Scott's Restaurant,Eating Out,39,273
23,7,2017,Red Shop,,2,271
24,7,2017,O2,Bills,30,241
24,7,2017,South West Trains,Transport,37,204
24,7,2017,Starbucks Coffee,Eating Out,2,202
24,7,2017,Subway,Eating Out,5,197
26,7,2017,Starbucks Coffee,Eating Out,2,195
26,7,2017,Chicken Cottage,Eating Out,6,189
27,7,2017,Wild Bean Cafe,Eating Out,1,188
27,7,2017,Cheam Service Station,,1,187
28,7,2017,Waitrose,Groceries,58,129
28,7,2017,Starbucks Coffee,Eating Out,1,128
28,7,2017,Greggs,Eating Out,4,124
28,7,2017,ATM Cash Withdrawal,General,20,104
29,7,2017,Dominos Pizza,Eating Out,42,62
29,7,2017,Paying back Julie,,6,56
31,7,2017,South West Trains,Transport,38,18
31,7,2017,Starbucks Coffee,Eating Out,1,17
1,8,2017,Rhino Sports salary,General,1700,1717
1,8,2017,Costa Coffee,Eating Out,2,1715
1,8,2017,The West Cornwall Pasty Company,Eating Out,7,1708
1,8,2017,ATM Cash Withdrawal,General,20,1688
2,8,2017,Costa Coffee,Eating Out,2,1686
3,8,2017,Wild Bean Cafe,Eating Out,1,1685
3,8,2017,McDonalds,Eating Out,8,1677
3,8,2017,ATM Cash Withdrawal,General,20,1657
4,8,2017,Morrisons,Groceries,78,1579
4,8,2017,Starbucks Coffee,Eating Out,2,1577
4,8,2017,Subway,Eating Out,4,1573
4,8,2017,Dominos Pizza,Eating Out,54,1519
6,8,2017,Scott's Restaurant,Eating Out,25,1494
7,8,2017,Cubit and West rent,Rent,550,944
7,8,2017,South West Trains,Transport,28,916
7,8,2017,Wild Bean Cafe,Eating Out,2,914
7,8,2017,The West Cornwall Pasty Company,Eating Out,6,908
7,8,2017,Red Shop,,6,902
8,8,2017,Costa Coffee,Eating Out,1,901
8,8,2017,Subway,Eating Out,6,895
9,8,2017,Caffe Nero,Eating Out,2,893
9,8,2017,Greggs,Eating Out,5,888
10,8,2017,ATM Cash Withdrawal,General,10,878
10,8,2017,Red Shop,,9,869
11,8,2017,Sainsburys,Groceries,82,787
11,8,2017,Starbucks Coffee,Eating Out,1,786
11,8,2017,The West Cornwall Pasty Company,Eating Out,5,781
11,8,2017,ATM Cash Withdrawal,General,10,771
12,8,2017,Anglo restaurant,Eating Out,32,739
12,8,2017,Tool Shop,,6,733
13,8,2017,Scott's Restaurant,Eating Out,47,686
14,8,2017,South West Trains,Transport,32,654
14,8,2017,Subway,Eating Out,6,648
15,8,2017,BRGAS-Electricity,Bills,35,613
15,8,2017,BRGAS-Gas,Bills,36,577
15,8,2017,Pret A Manger,Eating Out,6,571
15,8,2017,ATM Cash Withdrawal,General,10,561
16,8,2017,LBS Council Tax,Bills,50,511
16,8,2017,Wild Bean Cafe,Eating Out,2,509
16,8,2017,Pret A Manger,Eating Out,8,501
17,8,2017,Starbucks Coffee,Eating Out,2,499
17,8,2017,Greggs,Eating Out,6,493
18,8,2017,Morrisons,Groceries,63,430
18,8,2017,Wild Bean Cafe,Eating Out,1,429
18,8,2017,Anglo restaurant,Eating Out,44,385
20,8,2017,VIRGIN MEDIA PYMTS,Bills,28,357
20,8,2017,Scott's Restaurant,Eating Out,34,323
21,8,2017,South West Trains,Transport,37,286
21,8,2017,Pret A Manger,Eating Out,5,281
22,8,2017,Pret A Manger,Eating Out,4,277
23,8,2017,Costa Coffee,Eating Out,1,276
23,8,2017,Greggs,Eating Out,6,270
23,8,2017,ATM Cash Withdrawal,General,20,250
24,8,2017,O2,Bills,33,217
25,8,2017,Morrisons,Groceries,68,149
25,8,2017,Starbucks Coffee,Eating Out,2,147
26,8,2017,Dominos Pizza,Eating Out,57,90
28,8,2017,South West Trains,Transport,35,55
28,8,2017,Wild Bean Cafe,Eating Out,1,54
28,8,2017,Subway,Eating Out,6,48
28,8,2017,ATM Cash Withdrawal,General,20,28
29,8,2017,Starbucks Coffee,Eating Out,1,27
29,8,2017,Pret A Manger,Eating Out,5,22
29,8,2017,ATM Cash Withdrawal,General,20,2
30,8,2017,Wild Bean Cafe,Eating Out,1,1
31,8,2017,Starbucks Coffee,Eating Out,2,-1
1,9,2017,Rhino Sports salary,General,1700,1699
1,9,2017,Morrisons,Groceries,59,1640
1,9,2017,Costa Coffee,Eating Out,1,1639
1,9,2017,McDonalds,Eating Out,5,1634
2,9,2017,Pizza Express,Eating Out,38,1596
4,9,2017,South West Trains,Transport,26,1570
4,9,2017,Caffe Nero,Eating Out,2,1568
4,9,2017,ATM Cash Withdrawal,General,10,1558
5,9,2017,Costa Coffee,Eating Out,1,1557
6,9,2017,Starbucks Coffee,Eating Out,1,1556
7,9,2017,Cubit and West rent,Rent,550,1006
7,9,2017,Wild Bean Cafe,Eating Out,2,1004
7,9,2017,ATM Cash Withdrawal,General,10,994
7,9,2017,Cheam Service Station,,4,990
8,9,2017,ASDA,Groceries,81,909
8,9,2017,Caffe Nero,Eating Out,2,907
8,9,2017,Greggs,Eating Out,6,901
8,9,2017,Anglo restaurant,Eating Out,52,849
9,9,2017,Restaurant Gordon RamsayPortland Restaurant,Eating Out,26,823
11,9,2017,South West Trains,Transport,36,787
11,9,2017,Costa Coffee,Eating Out,1,786
11,9,2017,Pret A Manger,Eating Out,8,778
11,9,2017,ATM Cash Withdrawal,General,10,768
12,9,2017,Costa Coffee,Eating Out,2,766
12,9,2017,The West Cornwall Pasty Company,Eating Out,7,759
12,9,2017,ATM Cash Withdrawal,General,20,739
14,9,2017,Costa Coffee,Eating Out,1,738
15,9,2017,BRGAS-Electricity,Bills,23,715
15,9,2017,BRGAS-Gas,Bills,32,683
15,9,2017,Waitrose,Groceries,49,634
16,9,2017,LBS Council Tax,Bills,50,584
16,9,2017,Ministry of Sound ClubXOYO Club,Eating Out,7,577
16,9,2017,Ministry of Sound ClubXOYO Club,Eating Out,11,566
18,9,2017,South West Trains,Transport,38,528
18,9,2017,Costa Coffee,Eating Out,1,527
18,9,2017,The West Cornwall Pasty Company,Eating Out,6,521
18,9,2017,ATM Cash Withdrawal,General,20,501
19,9,2017,Costa Coffee,Eating Out,2,499
20,9,2017,VIRGIN MEDIA PYMTS,Bills,59,440
20,9,2017,Subway,Eating Out,6,434
21,9,2017,Caffe Nero,Eating Out,2,432
21,9,2017,ATM Cash Withdrawal,General,10,422
22,9,2017,Morrisons,Groceries,56,366
22,9,2017,Starbucks Coffee,Eating Out,2,364
22,9,2017,McDonalds,Eating Out,5,359
22,9,2017,Fabric Club,Eating Out,16,343
22,9,2017,Fabric Club,Eating Out,9,334
22,9,2017,Fabric Club,Eating Out,7,327
22,9,2017,Anglo restaurant,Eating Out,42,285
24,9,2017,O2,Bills,30,255
25,9,2017,South West Trains,Transport,33,222
25,9,2017,Chicken Cottage,Eating Out,8,214
25,9,2017,ATM Cash Withdrawal,General,20,194
26,9,2017,Caffe Nero,Eating Out,2,192
27,9,2017,Costa Coffee,Eating Out,1,191
27,9,2017,Paying back James,,1,190
28,9,2017,Pret A Manger,Eating Out,7,183
29,9,2017,Waitrose,Groceries,48,135
29,9,2017,Greggs,Eating Out,4,131
29,9,2017,Dominos Pizza,Eating Out,42,89
29,9,2017,Paying back James,,1,88
30,9,2017,Pizza Express,Eating Out,44,44
1,10,2017,Rhino Sports salary,General,1700,1744
1,10,2017,Dominos Pizza,Eating Out,41,1703
2,10,2017,South West Trains,Transport,35,1668
2,10,2017,Starbucks Coffee,Eating Out,2,1666
2,10,2017,Tool Tec,,8,1658
3,10,2017,Starbucks Coffee,Eating Out,2,1656
3,10,2017,Chicken Cottage,Eating Out,4,1652
3,10,2017,ATM Cash Withdrawal,General,10,1642
3,10,2017,Paying back James,,8,1634
4,10,2017,Starbucks Coffee,Eating Out,1,1633
4,10,2017,Greggs,Eating Out,8,1625
5,10,2017,Caffe Nero,Eating Out,2,1623
5,10,2017,McDonalds,Eating Out,6,1617
6,10,2017,Tescos,Groceries,86,1531
6,10,2017,McDonalds,Eating Out,4,1527
6,10,2017,Fabric Club,Eating Out,7,1520
6,10,2017,Fabric Club,Eating Out,9,1511
6,10,2017,Fabric Club,Eating Out,11,1500
6,10,2017,ATM Cash Withdrawal,General,20,1480
6,10,2017,Civic Shop,,4,1476
7,10,2017,Cubit and West rent,Rent,550,926
7,10,2017,ATM Cash Withdrawal,General,20,906
8,10,2017,Scott's Restaurant,Eating Out,42,864
9,10,2017,South West Trains,Transport,27,837
9,10,2017,Wild Bean Cafe,Eating Out,1,836
9,10,2017,Pret A Manger,Eating Out,7,829
10,10,2017,Starbucks Coffee,Eating Out,2,827
10,10,2017,Greggs,Eating Out,5,822
11,10,2017,Caffe Nero,Eating Out,2,820
11,10,2017,ATM Cash Withdrawal,General,10,810
12,10,2017,Starbucks Coffee,Eating Out,2,808
12,10,2017,Pret A Manger,Eating Out,4,804
13,10,2017,Morrisons,Groceries,64,740
13,10,2017,Greggs,Eating Out,6,734
14,10,2017,Ministry of Sound ClubXOYO Club,Eating Out,8,726
14,10,2017,Scott's Restaurant,Eating Out,48,678
15,10,2017,BRGAS-Electricity,Bills,41,637
15,10,2017,BRGAS-Gas,Bills,34,603
16,10,2017,LBS Council Tax,Bills,50,553
16,10,2017,South West Trains,Transport,34,519
16,10,2017,Caffe Nero,Eating Out,2,517
17,10,2017,Civic Shop,,9,508
18,10,2017,Starbucks Coffee,Eating Out,1,507
20,10,2017,VIRGIN MEDIA PYMTS,Bills,49,458
20,10,2017,ASDA,Groceries,50,408
20,10,2017,Caffe Nero,Eating Out,2,406
22,10,2017,ATM Cash Withdrawal,General,20,386
23,10,2017,South West Trains,Transport,36,350
23,10,2017,Starbucks Coffee,Eating Out,2,348
23,10,2017,ATM Cash Withdrawal,General,10,338
23,10,2017,Cheam Service Station,,5,333
24,10,2017,O2,Bills,34,299
24,10,2017,Starbucks Coffee,Eating Out,1,298
24,10,2017,Pret A Manger,Eating Out,5,293
25,10,2017,Wild Bean Cafe,Eating Out,2,291
25,10,2017,ATM Cash Withdrawal,General,10,281
26,10,2017,Greggs,Eating Out,4,277
27,10,2017,Sainsburys,Groceries,83,194
27,10,2017,Caffe Nero,Eating Out,2,192
27,10,2017,The West Cornwall Pasty Company,Eating Out,7,185
27,10,2017,Ministry of Sound ClubXOYO Club,Eating Out,14,171
27,10,2017,Ministry of Sound ClubXOYO Club,Eating Out,5,166
27,10,2017,Ministry of Sound ClubXOYO Club,Eating Out,10,156
27,10,2017,Ministry of Sound ClubXOYO Club,Eating Out,7,149
27,10,2017,ATM Cash Withdrawal,General,20,129
28,10,2017,Dominos Pizza,Eating Out,28,101
28,10,2017,ATM Cash Withdrawal,General,10,91
28,10,2017,Cheam Service Station,,3,88
29,10,2017,Scott's Restaurant,Eating Out,44,44
30,10,2017,South West Trains,Transport,26,18
30,10,2017,McDonalds,Eating Out,7,11
31,10,2017,Costa Coffee,Eating Out,2,9
1,11,2017,Rhino Sports salary,General,1700,1709
1,11,2017,Wild Bean Cafe,Eating Out,1,1708
1,11,2017,Subway,Eating Out,8,1700
2,11,2017,Caffe Nero,Eating Out,2,1698
2,11,2017,ATM Cash Withdrawal,General,20,1678
3,11,2017,ASDA,Groceries,75,1603
3,11,2017,Costa Coffee,Eating Out,2,1601
3,11,2017,Greggs,Eating Out,5,1596
3,11,2017,Fabric Club,Eating Out,11,1585
3,11,2017,Fabric Club,Eating Out,12,1573
6,11,2017,South West Trains,Transport,32,1541
6,11,2017,Costa Coffee,Eating Out,2,1539
6,11,2017,Subway,Eating Out,5,1534
6,11,2017,ATM Cash Withdrawal,General,10,1524
7,11,2017,Cubit and West rent,Rent,550,974
7,11,2017,Wild Bean Cafe,Eating Out,1,973
7,11,2017,Pret A Manger,Eating Out,8,965
7,11,2017,Civic Shop,,3,962
8,11,2017,Costa Coffee,Eating Out,2,960
8,11,2017,Subway,Eating Out,4,956
9,11,2017,Wild Bean Cafe,Eating Out,1,955
9,11,2017,Chicken Cottage,Eating Out,5,950
9,11,2017,ATM Cash Withdrawal,General,20,930
10,11,2017,Waitrose,Groceries,49,881
10,11,2017,Costa Coffee,Eating Out,1,880
10,11,2017,Chicken Cottage,Eating Out,5,875
10,11,2017,ATM Cash Withdrawal,General,10,865
10,11,2017,Red Shop,,7,858
12,11,2017,ATM Cash Withdrawal,General,20,838
13,11,2017,South West Trains,Transport,28,810
13,11,2017,Costa Coffee,Eating Out,1,809
13,11,2017,The West Cornwall Pasty Company,Eating Out,7,802
14,11,2017,Wild Bean Cafe,Eating Out,2,800
15,11,2017,BRGAS-Electricity,Bills,57,743
15,11,2017,BRGAS-Gas,Bills,67,676
15,11,2017,Costa Coffee,Eating Out,1,675
15,11,2017,Greggs,Eating Out,8,667
16,11,2017,LBS Council Tax,Bills,50,617
16,11,2017,Starbucks Coffee,Eating Out,1,616
17,11,2017,Morrisons,Groceries,53,563
17,11,2017,Costa Coffee,Eating Out,1,562
17,11,2017,Paying back James,,7,555
18,11,2017,Cheam Service Station,,5,550
19,11,2017,Scott's Restaurant,Eating Out,58,492
20,11,2017,VIRGIN MEDIA PYMTS,Bills,32,460
20,11,2017,South West Trains,Transport,30,430
20,11,2017,Pret A Manger,Eating Out,6,424
21,11,2017,Wild Bean Cafe,Eating Out,2,422
21,11,2017,Subway,Eating Out,8,414
21,11,2017,Paying back Julie,,6,408
22,11,2017,Starbucks Coffee,Eating Out,2,406
22,11,2017,Subway,Eating Out,7,399
23,11,2017,Starbucks Coffee,Eating Out,2,397
24,11,2017,O2,Bills,32,365
24,11,2017,Tescos,Groceries,84,281
24,11,2017,Starbucks Coffee,Eating Out,1,280
24,11,2017,Cheam Service Station,,2,278
25,11,2017,Anglo restaurant,Eating Out,48,230
27,11,2017,South West Trains,Transport,36,194
27,11,2017,Starbucks Coffee,Eating Out,2,192
27,11,2017,Subway,Eating Out,7,185
29,11,2017,The West Cornwall Pasty Company,Eating Out,5,180
30,11,2017,Costa Coffee,Eating Out,2,178
30,11,2017,Greggs,Eating Out,7,171
1,12,2017,Rhino Sports salary,General,1700,1871
1,12,2017,Morrisons,Groceries,68,1803
1,12,2017,Chicken Cottage,Eating Out,6,1797
2,12,2017,Heaven Club,Eating Out,7,1790
2,12,2017,Heaven Club,Eating Out,6,1784
2,12,2017,Heaven Club,Eating Out,13,1771
2,12,2017,Heaven Club,Eating Out,14,1757
2,12,2017,Heaven Club,Eating Out,10,1747
4,12,2017,South West Trains,Transport,33,1714
4,12,2017,McDonalds,Eating Out,8,1706
4,12,2017,Red Shop,,2,1704
5,12,2017,Costa Coffee,Eating Out,2,1702
5,12,2017,ATM Cash Withdrawal,General,10,1692
5,12,2017,Tool Tec,,1,1691
6,12,2017,Costa Coffee,Eating Out,2,1689
7,12,2017,Cubit and West rent,Rent,550,1139
7,12,2017,Costa Coffee,Eating Out,2,1137
7,12,2017,McDonalds,Eating Out,7,1130
8,12,2017,Morrisons,Groceries,52,1078
8,12,2017,Costa Coffee,Eating Out,2,1076
8,12,2017,Greggs,Eating Out,6,1070
11,12,2017,South West Trains,Transport,36,1034
11,12,2017,Costa Coffee,Eating Out,2,1032
11,12,2017,ATM Cash Withdrawal,General,10,1022
12,12,2017,The West Cornwall Pasty Company,Eating Out,8,1014
12,12,2017,ATM Cash Withdrawal,General,20,994
12,12,2017,Paying back James,,4,990
13,12,2017,Caffe Nero,Eating Out,2,988
13,12,2017,Chicken Cottage,Eating Out,6,982
13,12,2017,Tool Tec,,2,980
14,12,2017,Caffe Nero,Eating Out,2,978
14,12,2017,Pret A Manger,Eating Out,8,970
14,12,2017,Civic Shop,,4,966
15,12,2017,BRGAS-Electricity,Bills,44,922
15,12,2017,BRGAS-Gas,Bills,31,891
15,12,2017,Waitrose,Groceries,86,805
15,12,2017,Costa Coffee,Eating Out,2,803
15,12,2017,Greggs,Eating Out,4,799
15,12,2017,Scott's Restaurant,Eating Out,39,760
15,12,2017,ATM Cash Withdrawal,General,20,740
16,12,2017,LBS Council Tax,Bills,50,690
17,12,2017,ATM Cash Withdrawal,General,10,680
17,12,2017,Cheam Service Station,,8,672
18,12,2017,South West Trains,Transport,35,637
19,12,2017,The West Cornwall Pasty Company,Eating Out,7,630
20,12,2017,VIRGIN MEDIA PYMTS,Bills,42,588
20,12,2017,Wild Bean Cafe,Eating Out,1,587
20,12,2017,Greggs,Eating Out,5,582
22,12,2017,Sainsburys,Groceries,49,533
22,12,2017,Starbucks Coffee,Eating Out,1,532
22,12,2017,Subway,Eating Out,6,526
22,12,2017,ATM Cash Withdrawal,General,20,506
23,12,2017,Heaven Club,Eating Out,7,499
24,12,2017,O2,Bills,38,461
24,12,2017,Pizza Express,Eating Out,47,414
25,12,2017,South West Trains,Transport,35,379
25,12,2017,Caffe Nero,Eating Out,1,378
25,12,2017,ATM Cash Withdrawal,General,10,368
26,12,2017,Wild Bean Cafe,Eating Out,2,366
26,12,2017,Greggs,Eating Out,5,361
27,12,2017,Caffe Nero,Eating Out,2,359
27,12,2017,The West Cornwall Pasty Company,Eating Out,6,353
28,12,2017,Starbucks Coffee,Eating Out,2,351
28,12,2017,Subway,Eating Out,8,343
29,12,2017,Tescos,Groceries,68,275
29,12,2017,Caffe Nero,Eating Out,1,274
29,12,2017,Pret A Manger,Eating Out,4,270
29,12,2017,ATM Cash Withdrawal,General,10,260
30,12,2017,ATM Cash Withdrawal,General,20,240
31,12,2017,Anglo restaurant,Eating Out,39,201
1,1,2018,Rhino Sports salary,General,1700,1901
1,1,2018,South West Trains,Transport,33,1868
1,1,2018,Wild Bean Cafe,Eating Out,2,1866
2,1,2018,Tool Tec,,7,1859
3,1,2018,Wild Bean Cafe,Eating Out,2,1857
3,1,2018,Pret A Manger,Eating Out,5,1852
3,1,2018,ATM Cash Withdrawal,General,20,1832
4,1,2018,Greggs,Eating Out,8,1824
5,1,2018,Waitrose,Groceries,65,1759
5,1,2018,Pret A Manger,Eating Out,6,1753
5,1,2018,Dominos Pizza,Eating Out,38,1715
5,1,2018,ATM Cash Withdrawal,General,20,1695
6,1,2018,ATM Cash Withdrawal,General,20,1675
7,1,2018,Cubit and West rent,Rent,550,1125
8,1,2018,South West Trains,Transport,30,1095
8,1,2018,Costa Coffee,Eating Out,2,1093
9,1,2018,Costa Coffee,Eating Out,2,1091
10,1,2018,Caffe Nero,Eating Out,1,1090
10,1,2018,The West Cornwall Pasty Company,Eating Out,7,1083
11,1,2018,Costa Coffee,Eating Out,2,1081
11,1,2018,Pret A Manger,Eating Out,7,1074
11,1,2018,ATM Cash Withdrawal,General,20,1054
12,1,2018,Sainsburys,Groceries,69,985
12,1,2018,Wild Bean Cafe,Eating Out,1,984
12,1,2018,Pizza Express,Eating Out,58,926
13,1,2018,Anglo restaurant,Eating Out,47,879
15,1,2018,BRGAS-Electricity,Bills,33,846
15,1,2018,BRGAS-Gas,Bills,56,790
15,1,2018,South West Trains,Transport,30,760
15,1,2018,Caffe Nero,Eating Out,2,758
15,1,2018,Greggs,Eating Out,8,750
15,1,2018,Red Shop,,3,747
16,1,2018,LBS Council Tax,Bills,50,697
16,1,2018,Costa Coffee,Eating Out,2,695
16,1,2018,The West Cornwall Pasty Company,Eating Out,8,687
17,1,2018,Wild Bean Cafe,Eating Out,1,686
17,1,2018,Pret A Manger,Eating Out,5,681
17,1,2018,ATM Cash Withdrawal,General,20,661
18,1,2018,Starbucks Coffee,Eating Out,1,660
18,1,2018,McDonalds,Eating Out,6,654
19,1,2018,ASDA,Groceries,68,586
19,1,2018,Caffe Nero,Eating Out,2,584
19,1,2018,Chicken Cottage,Eating Out,7,577
19,1,2018,Dominos Pizza,Eating Out,32,545
20,1,2018,VIRGIN MEDIA PYMTS,Bills,48,497
20,1,2018,Red Shop,,4,493
22,1,2018,South West Trains,Transport,30,463
22,1,2018,Wild Bean Cafe,Eating Out,1,462
22,1,2018,ATM Cash Withdrawal,General,10,452
23,1,2018,Caffe Nero,Eating Out,2,450
23,1,2018,Subway,Eating Out,4,446
24,1,2018,O2,Bills,37,409
24,1,2018,The West Cornwall Pasty Company,Eating Out,5,404
26,1,2018,Tescos,Groceries,65,339
26,1,2018,Subway,Eating Out,8,331
26,1,2018,ATM Cash Withdrawal,General,20,311
27,1,2018,ATM Cash Withdrawal,General,20,291
28,1,2018,ATM Cash Withdrawal,General,10,281
29,1,2018,South West Trains,Transport,35,246
29,1,2018,Starbucks Coffee,Eating Out,1,245
30,1,2018,Chicken Cottage,Eating Out,5,240
30,1,2018,ATM Cash Withdrawal,General,10,230
31,1,2018,The West Cornwall Pasty Company,Eating Out,6,224
31,1,2018,ATM Cash Withdrawal,General,10,214
1,2,2018,Rhino Sports salary,General,1700,1914
1,2,2018,Caffe Nero,Eating Out,1,1913
1,2,2018,ATM Cash Withdrawal,General,10,1903
2,2,2018,Tescos,Groceries,80,1823
2,2,2018,Caffe Nero,Eating Out,1,1822
2,2,2018,The West Cornwall Pasty Company,Eating Out,7,1815
2,2,2018,Anglo restaurant,Eating Out,25,1790
4,2,2018,Anglo restaurant,Eating Out,52,1738
4,2,2018,ATM Cash Withdrawal,General,20,1718
5,2,2018,South West Trains,Transport,30,1688
5,2,2018,Civic Shop,,2,1686
6,2,2018,Costa Coffee,Eating Out,2,1684
6,2,2018,The West Cornwall Pasty Company,Eating Out,8,1676
6,2,2018,ATM Cash Withdrawal,General,20,1656
7,2,2018,Cubit and West rent,Rent,550,1106
7,2,2018,Costa Coffee,Eating Out,2,1104
7,2,2018,Chicken Cottage,Eating Out,8,1096
8,2,2018,Starbucks Coffee,Eating Out,2,1094
9,2,2018,Waitrose,Groceries,45,1049
9,2,2018,Caffe Nero,Eating Out,2,1047
9,2,2018,ATM Cash Withdrawal,General,10,1037
9,2,2018,Red Shop,,5,1032
11,2,2018,Scott's Restaurant,Eating Out,24,1008
11,2,2018,Paying back James,,1,1007
12,2,2018,South West Trains,Transport,27,980
12,2,2018,Costa Coffee,Eating Out,2,978
14,2,2018,Starbucks Coffee,Eating Out,2,976
15,2,2018,BRGAS-Electricity,Bills,41,935
15,2,2018,BRGAS-Gas,Bills,41,894
15,2,2018,Caffe Nero,Eating Out,2,892
15,2,2018,Paying back James,,4,888
16,2,2018,LBS Council Tax,Bills,50,838
16,2,2018,Waitrose,Groceries,69,769
16,2,2018,Caffe Nero,Eating Out,2,767
16,2,2018,Chicken Cottage,Eating Out,4,763
17,2,2018,Heaven Club,Eating Out,13,750
17,2,2018,ATM Cash Withdrawal,General,20,730
17,2,2018,Paying back James,,5,725
18,2,2018,Dominos Pizza,Eating Out,46,679
18,2,2018,Cheam Service Station,,3,676
19,2,2018,South West Trains,Transport,34,642
19,2,2018,Starbucks Coffee,Eating Out,1,641
19,2,2018,Subway,Eating Out,8,633
19,2,2018,Tool Tec,,7,626
20,2,2018,VIRGIN MEDIA PYMTS,Bills,30,596
20,2,2018,Pret A Manger,Eating Out,4,592
21,2,2018,Starbucks Coffee,Eating Out,2,590
21,2,2018,ATM Cash Withdrawal,General,20,570
22,2,2018,Costa Coffee,Eating Out,1,569
23,2,2018,ASDA,Groceries,87,482
23,2,2018,The West Cornwall Pasty Company,Eating Out,7,475
24,2,2018,O2,Bills,31,444
24,2,2018,Paying back James,,2,442
25,2,2018,Restaurant Gordon RamsayPortland Restaurant,Eating Out,38,404
26,2,2018,South West Trains,Transport,35,369
26,2,2018,Wild Bean Cafe,Eating Out,1,368
27,2,2018,Costa Coffee,Eating Out,2,366
27,2,2018,Greggs,Eating Out,7,359
27,2,2018,Tool Shop,,1,358
28,2,2018,Starbucks Coffee,Eating Out,2,356
1,3,2018,Rhino Sports salary,General,1700,2056
1,3,2018,ATM Cash Withdrawal,General,10,2046
2,3,2018,Waitrose,Groceries,85,1961
2,3,2018,Caffe Nero,Eating Out,2,1959
2,3,2018,Chicken Cottage,Eating Out,6,1953
3,3,2018,Pizza Express,Eating Out,28,1925
4,3,2018,Dominos Pizza,Eating Out,46,1879
5,3,2018,South West Trains,Transport,37,1842
5,3,2018,Starbucks Coffee,Eating Out,1,1841
5,3,2018,Subway,Eating Out,7,1834
5,3,2018,ATM Cash Withdrawal,General,10,1824
6,3,2018,Caffe Nero,Eating Out,1,1823
7,3,2018,Cubit and West rent,Rent,550,1273
7,3,2018,Costa Coffee,Eating Out,2,1271
7,3,2018,Chicken Cottage,Eating Out,8,1263
8,3,2018,Costa Coffee,Eating Out,2,1261
8,3,2018,Subway,Eating Out,5,1256
8,3,2018,ATM Cash Withdrawal,General,10,1246
9,3,2018,Waitrose,Groceries,81,1165
9,3,2018,Caffe Nero,Eating Out,2,1163
9,3,2018,Chicken Cottage,Eating Out,6,1157
9,3,2018,Heaven Club,Eating Out,5,1152
9,3,2018,Heaven Club,Eating Out,14,1138
9,3,2018,Heaven Club,Eating Out,9,1129
11,3,2018,ATM Cash Withdrawal,General,10,1119
11,3,2018,Tool Tec,,1,1118
12,3,2018,South West Trains,Transport,30,1088
12,3,2018,Caffe Nero,Eating Out,2,1086
12,3,2018,Subway,Eating Out,7,1079
13,3,2018,Costa Coffee,Eating Out,2,1077
13,3,2018,ATM Cash Withdrawal,General,20,1057
14,3,2018,Wild Bean Cafe,Eating Out,2,1055
14,3,2018,Pret A Manger,Eating Out,8,1047
15,3,2018,BRGAS-Electricity,Bills,37,1010
15,3,2018,BRGAS-Gas,Bills,41,969
15,3,2018,ATM Cash Withdrawal,General,10,959
16,3,2018,LBS Council Tax,Bills,50,909
16,3,2018,Waitrose,Groceries,75,834
16,3,2018,The West Cornwall Pasty Company,Eating Out,6,828
16,3,2018,ATM Cash Withdrawal,General,10,818
17,3,2018,Dominos Pizza,Eating Out,50,768
18,3,2018,Restaurant Gordon RamsayPortland Restaurant,Eating Out,30,738
19,3,2018,South West Trains,Transport,27,711
19,3,2018,Starbucks Coffee,Eating Out,1,710
19,3,2018,Greggs,Eating Out,4,706
20,3,2018,VIRGIN MEDIA PYMTS,Bills,32,674
20,3,2018,Starbucks Coffee,Eating Out,1,673
20,3,2018,Greggs,Eating Out,6,667
20,3,2018,ATM Cash Withdrawal,General,10,657
21,3,2018,Costa Coffee,Eating Out,1,656
21,3,2018,Greggs,Eating Out,6,650
21,3,2018,Tool Shop,,2,648
22,3,2018,Pret A Manger,Eating Out,5,643
22,3,2018,ATM Cash Withdrawal,General,10,633
23,3,2018,Tescos,Groceries,45,588
23,3,2018,Caffe Nero,Eating Out,2,586
23,3,2018,The West Cornwall Pasty Company,Eating Out,6,580
23,3,2018,Dominos Pizza,Eating Out,58,522
24,3,2018,O2,Bills,31,491
25,3,2018,ATM Cash Withdrawal,General,20,471
26,3,2018,South West Trains,Transport,28,443
26,3,2018,Wild Bean Cafe,Eating Out,1,442
26,3,2018,Chicken Cottage,Eating Out,7,435
27,3,2018,Wild Bean Cafe,Eating Out,1,434
27,3,2018,Chicken Cottage,Eating Out,6,428
28,3,2018,Costa Coffee,Eating Out,1,427
28,3,2018,Greggs,Eating Out,5,422
30,3,2018,Sainsburys,Groceries,87,335
30,3,2018,Subway,Eating Out,5,330
31,3,2018,Dominos Pizza,Eating Out,53,277
1,4,2018,Rhino Sports salary,General,1700,1977
2,4,2018,South West Trains,Transport,30,1947
2,4,2018,Caffe Nero,Eating Out,2,1945
2,4,2018,Pret A Manger,Eating Out,4,1941
3,4,2018,Wild Bean Cafe,Eating Out,1,1940
3,4,2018,Chicken Cottage,Eating Out,6,1934
3,4,2018,ATM Cash Withdrawal,General,10,1924
3,4,2018,Cheam Service Station,,1,1923
4,4,2018,Costa Coffee,Eating Out,1,1922
4,4,2018,Greggs,Eating Out,8,1914
4,4,2018,ATM Cash Withdrawal,General,20,1894
4,4,2018,Cheam Service Station,,4,1890
5,4,2018,Starbucks Coffee,Eating Out,1,1889
5,4,2018,Chicken Cottage,Eating Out,6,1883
5,4,2018,Paying back James,,4,1879
6,4,2018,Sainsburys,Groceries,73,1806
6,4,2018,Caffe Nero,Eating Out,1,1805
6,4,2018,Greggs,Eating Out,4,1801
6,4,2018,ATM Cash Withdrawal,General,10,1791
7,4,2018,Cubit and West rent,Rent,550,1241
7,4,2018,The Grand Pub,Eating Out,9,1232
7,4,2018,The Grand Pub,Eating Out,8,1224
7,4,2018,The Grand Pub,Eating Out,13,1211
7,4,2018,The Grand Pub,Eating Out,12,1199
8,4,2018,Anglo restaurant,Eating Out,48,1151
8,4,2018,Cheam Service Station,,2,1149
9,4,2018,South West Trains,Transport,32,1117
9,4,2018,ATM Cash Withdrawal,General,20,1097
10,4,2018,Wild Bean Cafe,Eating Out,2,1095
10,4,2018,Greggs,Eating Out,6,1089
11,4,2018,Caffe Nero,Eating Out,2,1087
11,4,2018,Chicken Cottage,Eating Out,5,1082
12,4,2018,Starbucks Coffee,Eating Out,2,1080
12,4,2018,Subway,Eating Out,5,1075
13,4,2018,Tescos,Groceries,83,992
13,4,2018,Costa Coffee,Eating Out,2,990
13,4,2018,Chicken Cottage,Eating Out,5,985
13,4,2018,Heaven Club,Eating Out,7,978
13,4,2018,Heaven Club,Eating Out,8,970
13,4,2018,Heaven Club,Eating Out,10,960
13,4,2018,Heaven Club,Eating Out,15,945
13,4,2018,Anglo restaurant,Eating Out,43,902
14,4,2018,Ministry of Sound ClubXOYO Club,Eating Out,11,891
14,4,2018,Ministry of Sound ClubXOYO Club,Eating Out,11,880
14,4,2018,Ministry of Sound ClubXOYO Club,Eating Out,6,874
14,4,2018,Ministry of Sound ClubXOYO Club,Eating Out,15,859
14,4,2018,Dominos Pizza,Eating Out,58,801
15,4,2018,BRGAS-Electricity,Bills,40,761
15,4,2018,BRGAS-Gas,Bills,36,725
15,4,2018,Tool Shop,,1,724
16,4,2018,LBS Council Tax,Bills,50,674
16,4,2018,South West Trains,Transport,31,643
16,4,2018,Wild Bean Cafe,Eating Out,1,642
16,4,2018,Greggs,Eating Out,6,636
16,4,2018,Paying back James,,2,634
17,4,2018,Caffe Nero,Eating Out,1,633
17,4,2018,Paying back Julie,,6,627
18,4,2018,Caffe Nero,Eating Out,2,625
18,4,2018,The West Cornwall Pasty Company,Eating Out,4,621
19,4,2018,Wild Bean Cafe,Eating Out,1,620
19,4,2018,Subway,Eating Out,7,613
20,4,2018,VIRGIN MEDIA PYMTS,Bills,56,557
20,4,2018,ASDA,Groceries,66,491
20,4,2018,Starbucks Coffee,Eating Out,2,489
20,4,2018,Greggs,Eating Out,8,481
20,4,2018,ATM Cash Withdrawal,General,20,461
20,4,2018,Civic Shop,,6,455
21,4,2018,Restaurant Gordon RamsayPortland Restaurant,Eating Out,43,412
