Day,Month,Year,Description,Category,Value,Balance
1,1,2010,Rhino Sports salary,General,1700,1700
1,1,2010,ASDA,Groceries,66,1634
1,1,2010,Paying back Julie,,3,1631
3,1,2010,ATM Cash Withdrawal,General,20,1611
4,1,2010,South West Trains,Transport,34,1577
4,1,2010,Caffe Nero,Eating Out,2,1575
4,1,2010,ATM Cash Withdrawal,General,20,1555
5,1,2010,Costa Coffee,Eating Out,1,1554
6,1,2010,Costa Coffee,Eating Out,1,1553
6,1,2010,Chicken Cottage,Eating Out,8,1545
7,1,2010,Cubit and West rent,Rent,550,995
7,1,2010,Wild Bean Cafe,Eating Out,1,994
7,1,2010,Subway,Eating Out,5,989
7,1,2010,ATM Cash Withdrawal,General,10,979
8,1,2010,Sainsburys,Groceries,48,931
8,1,2010,Wild Bean Cafe,Eating Out,1,930
8,1,2010,Subway,Eating Out,5,925
9,1,2010,Anglo restaurant,Eating Out,41,884
9,1,2010,ATM Cash Withdrawal,General,20,864
11,1,2010,South West Trains,Transport,27,837
11,1,2010,Starbucks Coffee,Eating Out,1,836
12,1,2010,Wild Bean Cafe,Eating Out,1,835
12,1,2010,Greggs,Eating Out,6,829
13,1,2010,ATM Cash Withdrawal,General,10,819
14,1,2010,Caffe Nero,Eating Out,2,817
14,1,2010,ATM Cash Withdrawal,General,10,807
15,1,2010,BRGAS-Electricity,Bills,62,745
15,1,2010,BRGAS-Gas,Bills,65,680
15,1,2010,ASDA,Groceries,61,619
15,1,2010,Caffe Nero,Eating Out,1,618
15,1,2010,Pret A Manger,Eating Out,8,610
15,1,2010,Scott's Restaurant,Eating Out,32,578
15,1,2010,Tool Tec,,4,574
16,1,2010,LBS Council Tax,Bills,50,524
16,1,2010,Dominos Pizza,Eating Out,47,477
17,1,2010,ATM Cash Withdrawal,General,20,457
18,1,2010,South West Trains,Transport,36,421
18,1,2010,Chicken Cottage,Eating Out,7,414
18,1,2010,ATM Cash Withdrawal,General,20,394
19,1,2010,Chicken Cottage,Eating Out,7,387
19,1,2010,ATM Cash Withdrawal,General,20,367
20,1,2010,VIRGIN MEDIA PYMTS,Bills,33,334
20,1,2010,Caffe Nero,Eating Out,2,332
20,1,2010,The West Cornwall Pasty Company,Eating Out,7,325
21,1,2010,Starbucks Coffee,Eating Out,2,323
21,1,2010,Paying back Julie,,5,318
22,1,2010,Sainsburys,Groceries,73,245
22,1,2010,Caffe Nero,Eating Out,1,244
22,1,2010,The West Cornwall Pasty Company,Eating Out,6,238
24,1,2010,O2,Bills,32,206
24,1,2010,Pizza Express,Eating Out,51,155
25,1,2010,South West Trains,Transport,24,131
25,1,2010,Caffe Nero,Eating Out,2,129
25,1,2010,Pret A Manger,Eating Out,7,122
26,1,2010,The West Cornwall Pasty Company,Eating Out,6,116
26,1,2010,ATM Cash Withdrawal,General,10,106
27,1,2010,Costa Coffee,Eating Out,1,105
28,1,2010,Caffe Nero,Eating Out,2,103
28,1,2010,Pret A Manger,Eating Out,7,96
29,1,2010,ASDA,Groceries,88,8
29,1,2010,Costa Coffee,Eating Out,2,6
29,1,2010,ATM Cash Withdrawal,General,20,-14
29,1,2010,Paying back James,,5,-19
31,1,2010,Anglo restaurant,Eating Out,58,-77
1,2,2010,Rhino Sports salary,General,1700,1623
1,2,2010,South West Trains,Transport,38,1585
1,2,2010,Caffe Nero,Eating Out,2,1583
1,2,2010,The West Cornwall Pasty Company,Eating Out,8,1575
2,2,2010,Wild Bean Cafe,Eating Out,1,1574
2,2,2010,Pret A Manger,Eating Out,5,1569
2,2,2010,Tool Shop,,7,1562
3,2,2010,Costa Coffee,Eating Out,2,1560
3,2,2010,Chicken Cottage,Eating Out,4,1556
4,2,2010,Starbucks Coffee,Eating Out,2,1554
4,2,2010,Subway,Eating Out,6,1548
5,2,2010,Tescos,Groceries,60,1488
5,2,2010,Caffe Nero,Eating Out,1,1487
5,2,2010,McDonalds,Eating Out,6,1481
7,2,2010,Cubit and West rent,Rent,550,931
8,2,2010,South West Trains,Transport,32,899
8,2,2010,Caffe Nero,Eating Out,1,898
8,2,2010,The West Cornwall Pasty Company,Eating Out,4,894
9,2,2010,Subway,Eating Out,7,887
10,2,2010,Caffe Nero,Eating Out,2,885
10,2,2010,ATM Cash Withdrawal,General,10,875
11,2,2010,Pret A Manger,Eating Out,7,868
11,2,2010,ATM Cash Withdrawal,General,10,858
12,2,2010,Morrisons,Groceries,73,785
12,2,2010,Wild Bean Cafe,Eating Out,2,783
12,2,2010,Pret A Manger,Eating Out,6,777
14,2,2010,ATM Cash Withdrawal,General,10,767
15,2,2010,BRGAS-Electricity,Bills,23,744
15,2,2010,BRGAS-Gas,Bills,25,719
15,2,2010,South West Trains,Transport,35,684
15,2,2010,Wild Bean Cafe,Eating Out,2,682
15,2,2010,Chicken Cottage,Eating Out,5,677
16,2,2010,LBS Council Tax,Bills,50,627
16,2,2010,Greggs,Eating Out,8,619
16,2,2010,Tool Tec,,8,611
17,2,2010,Caffe Nero,Eating Out,1,610
17,2,2010,ATM Cash Withdrawal,General,20,590
18,2,2010,Wild Bean Cafe,Eating Out,2,588
18,2,2010,Subway,Eating Out,4,584
19,2,2010,Sainsburys,Groceries,77,507
19,2,2010,Caffe Nero,Eating Out,2,505
20,2,2010,VIRGIN MEDIA PYMTS,Bills,30,475
21,2,2010,ATM Cash Withdrawal,General,10,465
22,2,2010,South West Trains,Transport,28,437
22,2,2010,Wild Bean Cafe,Eating Out,1,436
22,2,2010,Chicken Cottage,Eating Out,6,430
23,2,2010,Starbucks Coffee,Eating Out,2,428
23,2,2010,Subway,Eating Out,5,423
24,2,2010,O2,Bills,33,390
24,2,2010,ATM Cash Withdrawal,General,20,370
24,2,2010,Paying back Julie,,1,369
25,2,2010,Caffe Nero,Eating Out,1,368
25,2,2010,Greggs,Eating Out,4,364
26,2,2010,ASDA,Groceries,58,306
26,2,2010,Subway,Eating Out,6,300
26,2,2010,Pizza Express,Eating Out,39,261
28,2,2010,Pizza Express,Eating Out,37,224
1,3,2010,Rhino Sports salary,General,1700,1924
1,3,2010,South West Trains,Transport,33,1891
1,3,2010,Caffe Nero,Eating Out,1,1890
1,3,2010,ATM Cash Withdrawal,General,20,1870
1,3,2010,Paying back Julie,,5,1865
2,3,2010,Caffe Nero,Eating Out,2,1863
2,3,2010,McDonalds,Eating Out,7,1856
3,3,2010,Chicken Cottage,Eating Out,7,1849
4,3,2010,Wild Bean Cafe,Eating Out,2,1847
4,3,2010,Pret A Manger,Eating Out,7,1840
4,3,2010,ATM Cash Withdrawal,General,10,1830
5,3,2010,Tescos,Groceries,59,1771
5,3,2010,The West Cornwall Pasty Company,Eating Out,5,1766
5,3,2010,Restaurant Gordon RamsayPortland Restaurant,Eating Out,49,1717
5,3,2010,Tool Shop,,2,1715
6,3,2010,Restaurant Gordon RamsayPortland Restaurant,Eating Out,31,1684
7,3,2010,Cubit and West rent,Rent,550,1134
8,3,2010,South West Trains,Transport,37,1097
8,3,2010,Greggs,Eating Out,6,1091
8,3,2010,ATM Cash Withdrawal,General,10,1081
9,3,2010,Costa Coffee,Eating Out,2,1079
9,3,2010,Pret A Manger,Eating Out,5,1074
11,3,2010,Starbucks Coffee,Eating Out,2,1072
11,3,2010,McDonalds,Eating Out,4,1068
11,3,2010,Tool Shop,,4,1064
12,3,2010,ASDA,Groceries,84,980
12,3,2010,Wild Bean Cafe,Eating Out,1,979
12,3,2010,The West Cornwall Pasty Company,Eating Out,5,974
12,3,2010,Restaurant Gordon RamsayPortland Restaurant,Eating Out,40,934
15,3,2010,BRGAS-Electricity,Bills,36,898
15,3,2010,BRGAS-Gas,Bills,22,876
15,3,2010,South West Trains,Transport,26,850
15,3,2010,Caffe Nero,Eating Out,2,848
15,3,2010,Chicken Cottage,Eating Out,7,841
16,3,2010,LBS Council Tax,Bills,50,791
16,3,2010,Paying back Julie,,8,783
17,3,2010,Starbucks Coffee,Eating Out,1,782
17,3,2010,ATM Cash Withdrawal,General,20,762
18,3,2010,Wild Bean Cafe,Eating Out,2,760
18,3,2010,Subway,Eating Out,7,753
19,3,2010,Tescos,Groceries,70,683
19,3,2010,Costa Coffee,Eating Out,2,681
19,3,2010,Greggs,Eating Out,7,674
19,3,2010,Cheam Service Station,,7,667
20,3,2010,VIRGIN MEDIA PYMTS,Bills,37,630
22,3,2010,South West Trains,Transport,28,602
22,3,2010,Starbucks Coffee,Eating Out,2,600
22,3,2010,Chicken Cottage,Eating Out,6,594
24,3,2010,O2,Bills,37,557
24,3,2010,Caffe Nero,Eating Out,2,555
24,3,2010,McDonalds,Eating Out,6,549
24,3,2010,Cheam Service Station,,4,545
25,3,2010,Costa Coffee,Eating Out,2,543
26,3,2010,Waitrose,Groceries,76,467
26,3,2010,Wild Bean Cafe,Eating Out,1,466
26,3,2010,Subway,Eating Out,7,459
26,3,2010,Anglo restaurant,Eating Out,58,401
27,3,2010,Heaven Club,Eating Out,11,390
27,3,2010,Heaven Club,Eating Out,11,379
28,3,2010,ATM Cash Withdrawal,General,10,369
29,3,2010,South West Trains,Transport,26,343
29,3,2010,Caffe Nero,Eating Out,1,342
29,3,2010,Subway,Eating Out,5,337
30,3,2010,Starbucks Coffee,Eating Out,2,335
30,3,2010,Pret A Manger,Eating Out,6,329
1,4,2010,Rhino Sports salary,General,1700,2029
1,4,2010,Starbucks Coffee,Eating Out,2,2027
2,4,2010,Morrisons,Groceries,53,1974
2,4,2010,Costa Coffee,Eating Out,2,1972
2,4,2010,The Grand Pub,Eating Out,5,1967
2,4,2010,The Grand Pub,Eating Out,12,1955
2,4,2010,The Grand Pub,Eating Out,5,1950
2,4,2010,The Grand Pub,Eating Out,12,1938
2,4,2010,The Grand Pub,Eating Out,12,1926
4,4,2010,Scott's Restaurant,Eating Out,53,1873
5,4,2010,South West Trains,Transport,27,1846
5,4,2010,Wild Bean Cafe,Eating Out,2,1844
5,4,2010,Greggs,Eating Out,5,1839
6,4,2010,Starbucks Coffee,Eating Out,1,1838
6,4,2010,ATM Cash Withdrawal,General,10,1828
7,4,2010,Cubit and West rent,Rent,550,1278
8,4,2010,Wild Bean Cafe,Eating Out,2,1276
8,4,2010,McDonalds,Eating Out,8,1268
8,4,2010,ATM Cash Withdrawal,General,20,1248
9,4,2010,Sainsburys,Groceries,81,1167
9,4,2010,Wild Bean Cafe,Eating Out,2,1165
9,4,2010,The West Cornwall Pasty Company,Eating Out,8,1157
10,4,2010,Anglo restaurant,Eating Out,46,1111
12,4,2010,South West Trains,Transport,37,1074
12,4,2010,Wild Bean Cafe,Eating Out,1,1073
12,4,2010,Greggs,Eating Out,6,1067
13,4,2010,Costa Coffee,Eating Out,1,1066
13,4,2010,Subway,Eating Out,7,1059
15,4,2010,BRGAS-Electricity,Bills,29,1030
15,4,2010,BRGAS-Gas,Bills,23,1007
15,4,2010,Wild Bean Cafe,Eating Out,1,1006
15,4,2010,The West Cornwall Pasty Company,Eating Out,7,999
15,4,2010,Tool Shop,,3,996
16,4,2010,LBS Council Tax,Bills,50,946
16,4,2010,Tescos,Groceries,78,868
16,4,2010,Wild Bean Cafe,Eating Out,2,866
16,4,2010,McDonalds,Eating Out,4,862
16,4,2010,Ministry of Sound ClubXOYO Club,Eating Out,14,848
16,4,2010,Ministry of Sound ClubXOYO Club,Eating Out,8,840
16,4,2010,Ministry of Sound ClubXOYO Club,Eating Out,15,825
16,4,2010,Ministry of Sound ClubXOYO Club,Eating Out,10,815
16,4,2010,Ministry of Sound ClubXOYO Club,Eating Out,12,803
16,4,2010,Ministry of Sound ClubXOYO Club,Eating Out,6,797
16,4,2010,ATM Cash Withdrawal,General,10,787
17,4,2010,Pizza Express,Eating Out,33,754
19,4,2010,South West Trains,Transport,36,718
19,4,2010,Wild Bean Cafe,Eating Out,2,716
19,4,2010,Greggs,Eating Out,5,711
19,4,2010,Cheam Service Station,,9,702
20,4,2010,VIRGIN MEDIA PYMTS,Bills,32,670
20,4,2010,ATM Cash Withdrawal,General,10,660
21,4,2010,Chicken Cottage,Eating Out,7,653
22,4,2010,Starbucks Coffee,Eating Out,1,652
22,4,2010,Chicken Cottage,Eating Out,8,644
22,4,2010,ATM Cash Withdrawal,General,10,634
23,4,2010,ASDA,Groceries,61,573
24,4,2010,O2,Bills,37,536
25,4,2010,Anglo restaurant,Eating Out,57,479
25,4,2010,Cheam Service Station,,5,474
26,4,2010,South West Trains,Transport,35,439
26,4,2010,Caffe Nero,Eating Out,1,438
26,4,2010,Chicken Cottage,Eating Out,7,431
26,4,2010,Paying back James,,1,430
27,4,2010,Wild Bean Cafe,Eating Out,2,428
28,4,2010,Wild Bean Cafe,Eating Out,1,427
28,4,2010,ATM Cash Withdrawal,General,10,417
29,4,2010,Caffe Nero,Eating Out,2,415
30,4,2010,Waitrose,Groceries,72,343
30,4,2010,Wild Bean Cafe,Eating Out,2,341
30,4,2010,Greggs,Eating Out,4,337
1,5,2010,Rhino Sports salary,General,1700,2037
1,5,2010,ATM Cash Withdrawal,General,10,2027
2,5,2010,Paying back James,,7,2020
3,5,2010,South West Trains,Transport,29,1991
3,5,2010,Starbucks Coffee,Eating Out,2,1989
3,5,2010,Chicken Cottage,Eating Out,6,1983
4,5,2010,Caffe Nero,Eating Out,2,1981
4,5,2010,Subway,Eating Out,8,1973
4,5,2010,ATM Cash Withdrawal,General,10,1963
5,5,2010,Caffe Nero,Eating Out,1,1962
5,5,2010,Cheam Service Station,,5,1957
6,5,2010,Costa Coffee,Eating Out,2,1955
7,5,2010,Cubit and West rent,Rent,550,1405
7,5,2010,Sainsburys,Groceries,75,1330
7,5,2010,Caffe Nero,Eating Out,2,1328
7,5,2010,Chicken Cottage,Eating Out,8,1320
7,5,2010,Heaven Club,Eating Out,13,1307
7,5,2010,Heaven Club,Eating Out,5,1302
9,5,2010,ATM Cash Withdrawal,General,20,1282
10,5,2010,South West Trains,Transport,36,1246
10,5,2010,Greggs,Eating Out,7,1239
11,5,2010,Wild Bean Cafe,Eating Out,1,1238
11,5,2010,Tool Tec,,3,1235
12,5,2010,Starbucks Coffee,Eating Out,2,1233
13,5,2010,Costa Coffee,Eating Out,1,1232
14,5,2010,ASDA,Groceries,79,1153
14,5,2010,Caffe Nero,Eating Out,2,1151
15,5,2010,BRGAS-Electricity,Bills,23,1128
15,5,2010,BRGAS-Gas,Bills,30,1098
15,5,2010,Pizza Express,Eating Out,45,1053
15,5,2010,ATM Cash Withdrawal,General,10,1043
16,5,2010,LBS Council Tax,Bills,50,993
16,5,2010,ATM Cash Withdrawal,General,20,973
17,5,2010,South West Trains,Transport,28,945
17,5,2010,Caffe Nero,Eating Out,2,943
18,5,2010,Wild Bean Cafe,Eating Out,2,941
18,5,2010,Paying back Julie,,8,933
19,5,2010,Wild Bean Cafe,Eating Out,2,931
19,5,2010,McDonalds,Eating Out,7,924
19,5,2010,ATM Cash Withdrawal,General,10,914
20,5,2010,VIRGIN MEDIA PYMTS,Bills,46,868
20,5,2010,Costa Coffee,Eating Out,2,866
20,5,2010,Subway,Eating Out,5,861
21,5,2010,Morrisons,Groceries,60,801
21,5,2010,Wild Bean Cafe,Eating Out,1,800
23,5,2010,Restaurant Gordon RamsayPortland Restaurant,Eating Out,41,759
23,5,2010,ATM Cash Withdrawal,General,20,739
24,5,2010,O2,Bills,33,706
24,5,2010,South West Trains,Transport,37,669
24,5,2010,Starbucks Coffee,Eating Out,2,667
24,5,2010,Tool Shop,,6,661
25,5,2010,Starbucks Coffee,Eating Out,2,659
25,5,2010,ATM Cash Withdrawal,General,10,649
26,5,2010,Starbucks Coffee,Eating Out,1,648
26,5,2010,Chicken Cottage,Eating Out,4,644
27,5,2010,Costa Coffee,Eating Out,2,642
27,5,2010,The West Cornwall Pasty Company,Eating Out,8,634
28,5,2010,Waitrose,Groceries,80,554
28,5,2010,Wild Bean Cafe,Eating Out,1,553
28,5,2010,Anglo restaurant,Eating Out,28,525
28,5,2010,Tool Shop,,3,522
29,5,2010,Scott's Restaurant,Eating Out,37,485
29,5,2010,ATM Cash Withdrawal,General,20,465
29,5,2010,Civic Shop,,3,462
30,5,2010,Anglo restaurant,Eating Out,30,432
30,5,2010,ATM Cash Withdrawal,General,10,422
30,5,2010,Tool Tec,,5,417
31,5,2010,South West Trains,Transport,24,393
31,5,2010,Costa Coffee,Eating Out,2,391
31,5,2010,ATM Cash Withdrawal,General,20,371
1,6,2010,Rhino Sports salary,General,1700,2071
1,6,2010,Caffe Nero,Eating Out,2,2069
2,6,2010,Starbucks Coffee,Eating Out,2,2067
2,6,2010,The West Cornwall Pasty Company,Eating Out,7,2060
3,6,2010,Caffe Nero,Eating Out,2,2058
3,6,2010,Greggs,Eating Out,6,2052
3,6,2010,ATM Cash Withdrawal,General,10,2042
4,6,2010,Tescos,Groceries,69,1973
4,6,2010,Wild Bean Cafe,Eating Out,2,1971
4,6,2010,McDonalds,Eating Out,7,1964
4,6,2010,Restaurant Gordon RamsayPortland Restaurant,Eating Out,40,1924
5,6,2010,Restaurant Gordon RamsayPortland Restaurant,Eating Out,58,1866
5,6,2010,British Airways,General,95,1771
6,6,2010,Anglo restaurant,Eating Out,31,1740
7,6,2010,Cubit and West rent,Rent,550,1190
7,6,2010,South West Trains,Transport,26,1164
7,6,2010,Costa Coffee,Eating Out,2,1162
8,6,2010,Starbucks Coffee,Eating Out,2,1160
8,6,2010,Pret A Manger,Eating Out,8,1152
9,6,2010,Costa Coffee,Eating Out,2,1150
9,6,2010,The West Cornwall Pasty Company,Eating Out,4,1146
10,6,2010,Caffe Nero,Eating Out,2,1144
10,6,2010,McDonalds,Eating Out,4,1140
10,6,2010,Tool Shop,,8,1132
11,6,2010,Waitrose,Groceries,74,1058
11,6,2010,Pret A Manger,Eating Out,7,1051
11,6,2010,Pizza Express,Eating Out,32,1019
11,6,2010,ATM Cash Withdrawal,General,20,999
13,6,2010,Civic Shop,,8,991
14,6,2010,South West Trains,Transport,31,960
14,6,2010,Wild Bean Cafe,Eating Out,2,958
14,6,2010,Pret A Manger,Eating Out,6,952
14,6,2010,Civic Shop,,2,950
15,6,2010,BRGAS-Electricity,Bills,34,916
15,6,2010,BRGAS-Gas,Bills,36,880
15,6,2010,Costa Coffee,Eating Out,2,878
15,6,2010,Chicken Cottage,Eating Out,6,872
16,6,2010,LBS Council Tax,Bills,50,822
16,6,2010,Costa Coffee,Eating Out,1,821
16,6,2010,Subway,Eating Out,4,817
16,6,2010,ATM Cash Withdrawal,General,20,797
17,6,2010,Caffe Nero,Eating Out,2,795
18,6,2010,ASDA,Groceries,52,743
18,6,2010,Starbucks Coffee,Eating Out,2,741
18,6,2010,The West Cornwall Pasty Company,Eating Out,4,737
20,6,2010,VIRGIN MEDIA PYMTS,Bills,58,679
20,6,2010,Pizza Express,Eating Out,24,655
20,6,2010,ATM Cash Withdrawal,General,20,635
21,6,2010,South West Trains,Transport,28,607
21,6,2010,Caffe Nero,Eating Out,2,605
21,6,2010,Red Shop,,3,602
22,6,2010,Wild Bean Cafe,Eating Out,2,600
22,6,2010,Pret A Manger,Eating Out,8,592
22,6,2010,Paying back Julie,,2,590
23,6,2010,Starbucks Coffee,Eating Out,2,588
23,6,2010,McDonalds,Eating Out,4,584
24,6,2010,O2,Bills,36,548
24,6,2010,Caffe Nero,Eating Out,1,547
24,6,2010,Pret A Manger,Eating Out,5,542
25,6,2010,ASDA,Groceries,49,493
25,6,2010,Costa Coffee,Eating Out,1,492
25,6,2010,Subway,Eating Out,5,487
25,6,2010,Fabric Club,Eating Out,14,473
25,6,2010,Fabric Club,Eating Out,7,466
25,6,2010,Fabric Club,Eating Out,11,455
25,6,2010,Fabric Club,Eating Out,14,441
25,6,2010,Fabric Club,Eating Out,6,435
25,6,2010,Anglo restaurant,Eating Out,25,410
25,6,2010,ATM Cash Withdrawal,General,20,390
27,6,2010,Scott's Restaurant,Eating Out,46,344
28,6,2010,South West Trains,Transport,30,314
28,6,2010,Wild Bean Cafe,Eating Out,1,313
28,6,2010,Greggs,Eating Out,8,305
28,6,2010,ATM Cash Withdrawal,General,20,285
29,6,2010,Costa Coffee,Eating Out,2,283
30,6,2010,Wild Bean Cafe,Eating Out,2,281
30,6,2010,Subway,Eating Out,6,275
30,6,2010,Tool Tec,,7,268
1,7,2010,Rhino Sports salary,General,1700,1968
1,7,2010,Costa Coffee,Eating Out,2,1966
1,7,2010,The West Cornwall Pasty Company,Eating Out,6,1960
2,7,2010,Tescos,Groceries,85,1875
2,7,2010,Caffe Nero,Eating Out,2,1873
2,7,2010,Chicken Cottage,Eating Out,8,1865
2,7,2010,ATM Cash Withdrawal,General,10,1855
4,7,2010,Pizza Express,Eating Out,36,1819
5,7,2010,South West Trains,Transport,25,1794
6,7,2010,Wild Bean Cafe,Eating Out,2,1792
7,7,2010,Cubit and West rent,Rent,550,1242
7,7,2010,Costa Coffee,Eating Out,2,1240
7,7,2010,Pret A Manger,Eating Out,4,1236
8,7,2010,Costa Coffee,Eating Out,2,1234
8,7,2010,Pret A Manger,Eating Out,4,1230
9,7,2010,Waitrose,Groceries,58,1172
9,7,2010,Pret A Manger,Eating Out,5,1167
12,7,2010,South West Trains,Transport,34,1133
12,7,2010,Wild Bean Cafe,Eating Out,2,1131
12,7,2010,Greggs,Eating Out,6,1125
13,7,2010,Starbucks Coffee,Eating Out,2,1123
13,7,2010,Pret A Manger,Eating Out,4,1119
14,7,2010,Starbucks Coffee,Eating Out,1,1118
14,7,2010,Subway,Eating Out,7,1111
15,7,2010,BRGAS-Electricity,Bills,30,1081
15,7,2010,BRGAS-Gas,Bills,32,1049
15,7,2010,Caffe Nero,Eating Out,2,1047
16,7,2010,LBS Council Tax,Bills,50,997
16,7,2010,Waitrose,Groceries,50,947
16,7,2010,Costa Coffee,Eating Out,2,945
16,7,2010,ATM Cash Withdrawal,General,10,935
16,7,2010,Tool Tec,,2,933
17,7,2010,Paying back James,,6,927
18,7,2010,Scott's Restaurant,Eating Out,47,880
18,7,2010,Tool Shop,,5,875
19,7,2010,South West Trains,Transport,35,840
19,7,2010,Starbucks Coffee,Eating Out,1,839
20,7,2010,VIRGIN MEDIA PYMTS,Bills,29,810
20,7,2010,Starbucks Coffee,Eating Out,2,808
20,7,2010,Tool Tec,,9,799
21,7,2010,Wild Bean Cafe,Eating Out,2,797
21,7,2010,McDonalds,Eating Out,4,793
22,7,2010,Caffe Nero,Eating Out,2,791
23,7,2010,Morrisons,Groceries,47,744
23,7,2010,Wild Bean Cafe,Eating Out,2,742
23,7,2010,Ministry of Sound ClubXOYO Club,Eating Out,7,735
23,7,2010,Ministry of Sound ClubXOYO Club,Eating Out,13,722
23,7,2010,Ministry of Sound ClubXOYO Club,Eating Out,12,710
23,7,2010,Ministry of Sound ClubXOYO Club,Eating Out,12,698
23,7,2010,Ministry of Sound ClubXOYO Club,Eating Out,5,693
23,7,2010,Ministry of Sound ClubXOYO Club,Eating Out,6,687
24,7,2010,O2,Bills,34,653
24,7,2010,Restaurant Gordon RamsayPortland Restaurant,Eating Out,29,624
25,7,2010,Scott's Restaurant,Eating Out,33,591
26,7,2010,South West Trains,Transport,28,563
26,7,2010,Caffe Nero,Eating Out,2,561
26,7,2010,McDonalds,Eating Out,7,554
27,7,2010,Costa Coffee,Eating Out,2,552
27,7,2010,The West Cornwall Pasty Company,Eating Out,5,547
28,7,2010,Costa Coffee,Eating Out,2,545
28,7,2010,Subway,Eating Out,8,537
28,7,2010,ATM Cash Withdrawal,General,20,517
29,7,2010,Chicken Cottage,Eating Out,7,510
30,7,2010,Waitrose,Groceries,65,445
30,7,2010,Costa Coffee,Eating Out,2,443
30,7,2010,Chicken Cottage,Eating Out,6,437
1,8,2010,Rhino Sports salary,General,1700,2137
2,8,2010,South West Trains,Transport,29,2108
2,8,2010,Wild Bean Cafe,Eating Out,2,2106
2,8,2010,McDonalds,Eating Out,7,2099
3,8,2010,Wild Bean Cafe,Eating Out,2,2097
3,8,2010,Chicken Cottage,Eating Out,7,2090
4,8,2010,Starbucks Coffee,Eating Out,2,2088
4,8,2010,Pret A Manger,Eating Out,7,2081
4,8,2010,ATM Cash Withdrawal,General,10,2071
5,8,2010,The West Cornwall Pasty Company,Eating Out,4,2067
5,8,2010,ATM Cash Withdrawal,General,10,2057
6,8,2010,Waitrose,Groceries,51,2006
6,8,2010,Wild Bean Cafe,Eating Out,1,2005
7,8,2010,Cubit and West rent,Rent,550,1455
7,8,2010,Anglo restaurant,Eating Out,49,1406
7,8,2010,ATM Cash Withdrawal,General,20,1386
9,8,2010,South West Trains,Transport,29,1357
9,8,2010,Caffe Nero,Eating Out,1,1356
9,8,2010,Pret A Manger,Eating Out,5,1351
9,8,2010,ATM Cash Withdrawal,General,10,1341
10,8,2010,Starbucks Coffee,Eating Out,1,1340
10,8,2010,Greggs,Eating Out,8,1332
11,8,2010,Starbucks Coffee,Eating Out,2,1330
11,8,2010,ATM Cash Withdrawal,General,10,1320
12,8,2010,Caffe Nero,Eating Out,2,1318
12,8,2010,Pret A Manger,Eating Out,7,1311
12,8,2010,ATM Cash Withdrawal,General,10,1301
12,8,2010,Tool Shop,,3,1298
13,8,2010,Tescos,Groceries,59,1239
13,8,2010,Caffe Nero,Eating Out,2,1237
13,8,2010,Greggs,Eating Out,5,1232
15,8,2010,BRGAS-Electricity,Bills,33,1199
15,8,2010,BRGAS-Gas,Bills,43,1156
15,8,2010,Scott's Restaurant,Eating Out,25,1131
16,8,2010,LBS Council Tax,Bills,50,1081
16,8,2010,South West Trains,Transport,38,1043
16,8,2010,McDonalds,Eating Out,8,1035
17,8,2010,Starbucks Coffee,Eating Out,1,1034
17,8,2010,Pret A Manger,Eating Out,5,1029
18,8,2010,Caffe Nero,Eating Out,2,1027
18,8,2010,Greggs,Eating Out,5,1022
19,8,2010,Costa Coffee,Eating Out,1,1021
20,8,2010,VIRGIN MEDIA PYMTS,Bills,46,975
20,8,2010,ASDA,Groceries,80,895
20,8,2010,Starbucks Coffee,Eating Out,2,893
21,8,2010,Pizza Express,Eating Out,55,838
23,8,2010,South West Trains,Transport,31,807
23,8,2010,Starbucks Coffee,Eating Out,2,805
24,8,2010,O2,Bills,32,773
24,8,2010,Starbucks Coffee,Eating Out,2,771
25,8,2010,Costa Coffee,Eating Out,1,770
25,8,2010,Greggs,Eating Out,6,764
25,8,2010,ATM Cash Withdrawal,General,20,744
26,8,2010,Subway,Eating Out,8,736
26,8,2010,ATM Cash Withdrawal,General,20,716
27,8,2010,Morrisons,Groceries,64,652
27,8,2010,Wild Bean Cafe,Eating Out,2,650
27,8,2010,Chicken Cottage,Eating Out,6,644
27,8,2010,Restaurant Gordon RamsayPortland Restaurant,Eating Out,53,591
27,8,2010,ATM Cash Withdrawal,General,20,571
28,8,2010,ATM Cash Withdrawal,General,10,561
29,8,2010,Scott's Restaurant,Eating Out,55,506
30,8,2010,South West Trains,Transport,36,470
30,8,2010,Caffe Nero,Eating Out,1,469
31,8,2010,The West Cornwall Pasty Company,Eating Out,6,463
1,9,2010,Rhino Sports salary,General,1700,2163
1,9,2010,Costa Coffee,Eating Out,2,2161
1,9,2010,McDonalds,Eating Out,8,2153
2,9,2010,Caffe Nero,Eating Out,1,2152
3,9,2010,Waitrose,Groceries,49,2103
3,9,2010,Caffe Nero,Eating Out,1,2102
3,9,2010,Restaurant Gordon RamsayPortland Restaurant,Eating Out,28,2074
3,9,2010,Red Shop,,5,2069
4,9,2010,Tool Tec,,8,2061
5,9,2010,Restaurant Gordon RamsayPortland Restaurant,Eating Out,41,2020
6,9,2010,South West Trains,Transport,26,1994
6,9,2010,Starbucks Coffee,Eating Out,2,1992
6,9,2010,ATM Cash Withdrawal,General,20,1972
7,9,2010,Cubit and West rent,Rent,550,1422
7,9,2010,Costa Coffee,Eating Out,2,1420
7,9,2010,Greggs,Eating Out,8,1412
8,9,2010,Caffe Nero,Eating Out,1,1411
8,9,2010,Subway,Eating Out,8,1403
9,9,2010,Caffe Nero,Eating Out,2,1401
9,9,2010,ATM Cash Withdrawal,General,10,1391
9,9,2010,Cheam Service Station,,1,1390
10,9,2010,ASDA,Groceries,59,1331
10,9,2010,Starbucks Coffee,Eating Out,2,1329
10,9,2010,The West Cornwall Pasty Company,Eating Out,4,1325
10,9,2010,The Grand Pub,Eating Out,10,1315
10,9,2010,The Grand Pub,Eating Out,16,1299
10,9,2010,The Grand Pub,Eating Out,11,1288
10,9,2010,The Grand Pub,Eating Out,7,1281
10,9,2010,The Grand Pub,Eating Out,11,1270
13,9,2010,South West Trains,Transport,32,1238
13,9,2010,Starbucks Coffee,Eating Out,2,1236
13,9,2010,McDonalds,Eating Out,7,1229
14,9,2010,Starbucks Coffee,Eating Out,2,1227
14,9,2010,McDonalds,Eating Out,5,1222
15,9,2010,BRGAS-Electricity,Bills,30,1192
15,9,2010,BRGAS-Gas,Bills,32,1160
15,9,2010,Starbucks Coffee,Eating Out,1,1159
16,9,2010,LBS Council Tax,Bills,50,1109
16,9,2010,Starbucks Coffee,Eating Out,2,1107
16,9,2010,Paying back Julie,,8,1099
17,9,2010,ASDA,Groceries,80,1019
17,9,2010,Starbucks Coffee,Eating Out,2,1017
17,9,2010,Subway,Eating Out,4,1013
20,9,2010,VIRGIN MEDIA PYMTS,Bills,49,964
20,9,2010,South West Trains,Transport,25,939
20,9,2010,Starbucks Coffee,Eating Out,1,938
20,9,2010,McDonalds,Eating Out,6,932
21,9,2010,Chicken Cottage,Eating Out,7,925
22,9,2010,Caffe Nero,Eating Out,2,923
22,9,2010,McDonalds,Eating Out,5,918
23,9,2010,Starbucks Coffee,Eating Out,1,917
23,9,2010,ATM Cash Withdrawal,General,20,897
24,9,2010,O2,Bills,30,867
24,9,2010,Tescos,Groceries,71,796
24,9,2010,Wild Bean Cafe,Eating Out,2,794
24,9,2010,The West Cornwall Pasty Company,Eating Out,5,789
25,9,2010,Dominos Pizza,Eating Out,43,746
25,9,2010,Tool Shop,,6,740
27,9,2010,South West Trains,Transport,26,714
27,9,2010,Caffe Nero,Eating Out,2,712
27,9,2010,Greggs,Eating Out,7,705
28,9,2010,ATM Cash Withdrawal,General,20,685
29,9,2010,Wild Bean Cafe,Eating Out,1,684
29,9,2010,Greggs,Eating Out,7,677
30,9,2010,Wild Bean Cafe,Eating Out,2,675
30,9,2010,Pret A Manger,Eating Out,4,671
1,10,2010,Rhino Sports salary,General,1700,2371
1,10,2010,ASDA,Groceries,87,2284
1,10,2010,Costa Coffee,Eating Out,1,2283
4,10,2010,South West Trains,Transport,33,2250
4,10,2010,McDonalds,Eating Out,4,2246
4,10,2010,ATM Cash Withdrawal,General,20,2226
5,10,2010,Costa Coffee,Eating Out,1,2225
5,10,2010,Pret A Manger,Eating Out,6,2219
6,10,2010,Subway,Eating Out,4,2215
7,10,2010,Cubit and West rent,Rent,550,1665
7,10,2010,Starbucks Coffee,Eating Out,1,1664
7,10,2010,The West Cornwall Pasty Company,Eating Out,5,1659
7,10,2010,ATM Cash Withdrawal,General,10,1649
8,10,2010,ASDA,Groceries,60,1589
8,10,2010,Caffe Nero,Eating Out,2,1587
9,10,2010,Restaurant Gordon RamsayPortland Restaurant,Eating Out,33,1554
10,10,2010,Anglo restaurant,Eating Out,33,1521
10,10,2010,ATM Cash Withdrawal,General,20,1501
11,10,2010,South West Trains,Transport,27,1474
11,10,2010,Wild Bean Cafe,Eating Out,1,1473
12,10,2010,Costa Coffee,Eating Out,1,1472
12,10,2010,The West Cornwall Pasty Company,Eating Out,6,1466
12,10,2010,ATM Cash Withdrawal,General,10,1456
12,10,2010,Paying back James,,1,1455
13,10,2010,Wild Bean Cafe,Eating Out,2,1453
13,10,2010,Pret A Manger,Eating Out,4,1449
13,10,2010,ATM Cash Withdrawal,General,10,1439
14,10,2010,Starbucks Coffee,Eating Out,2,1437
14,10,2010,Chicken Cottage,Eating Out,7,1430
14,10,2010,ATM Cash Withdrawal,General,20,1410
15,10,2010,BRGAS-Electricity,Bills,31,1379
15,10,2010,BRGAS-Gas,Bills,24,1355
15,10,2010,Waitrose,Groceries,45,1310
15,10,2010,Wild Bean Cafe,Eating Out,2,1308
15,10,2010,Ministry of Sound ClubXOYO Club,Eating Out,15,1293
15,10,2010,Ministry of Sound ClubXOYO Club,Eating Out,7,1286
15,10,2010,ATM Cash Withdrawal,General,20,1266
16,10,2010,LBS Council Tax,Bills,50,1216
16,10,2010,Restaurant Gordon RamsayPortland Restaurant,Eating Out,29,1187
16,10,2010,ATM Cash Withdrawal,General,20,1167
17,10,2010,ATM Cash Withdrawal,General,20,1147
18,10,2010,South West Trains,Transport,34,1113
18,10,2010,Wild Bean Cafe,Eating Out,1,1112
18,10,2010,ATM Cash Withdrawal,General,10,1102
19,10,2010,Pret A Manger,Eating Out,4,1098
20,10,2010,VIRGIN MEDIA PYMTS,Bills,28,1070
20,10,2010,Wild Bean Cafe,Eating Out,1,1069
20,10,2010,Greggs,Eating Out,8,1061
20,10,2010,ATM Cash Withdrawal,General,20,1041
20,10,2010,Cheam Service Station,,2,1039
22,10,2010,Tescos,Groceries,63,976
22,10,2010,Greggs,Eating Out,7,969
22,10,2010,Anglo restaurant,Eating Out,41,928
23,10,2010,The Grand Pub,Eating Out,8,920
23,10,2010,ATM Cash Withdrawal,General,10,910
24,10,2010,O2,Bills,32,878
24,10,2010,Dominos Pizza,Eating Out,59,819
24,10,2010,ATM Cash Withdrawal,General,10,809
25,10,2010,South West Trains,Transport,28,781
25,10,2010,Starbucks Coffee,Eating Out,1,780
26,10,2010,ATM Cash Withdrawal,General,10,770
27,10,2010,Costa Coffee,Eating Out,1,769
27,10,2010,Subway,Eating Out,6,763
28,10,2010,Chicken Cottage,Eating Out,8,755
29,10,2010,Tescos,Groceries,48,707
29,10,2010,Caffe Nero,Eating Out,1,706
29,10,2010,Dominos Pizza,Eating Out,38,668
30,10,2010,ATM Cash Withdrawal,General,20,648
31,10,2010,Anglo restaurant,Eating Out,37,611
31,10,2010,ATM Cash Withdrawal,General,10,601
1,11,2010,Rhino Sports salary,General,1700,2301
1,11,2010,South West Trains,Transport,26,2275
1,11,2010,Caffe Nero,Eating Out,2,2273
1,11,2010,Greggs,Eating Out,4,2269
2,11,2010,Wild Bean Cafe,Eating Out,2,2267
2,11,2010,Greggs,Eating Out,8,2259
2,11,2010,Civic Shop,,4,2255
3,11,2010,Wild Bean Cafe,Eating Out,2,2253
3,11,2010,Chicken Cottage,Eating Out,6,2247
3,11,2010,ATM Cash Withdrawal,General,20,2227
3,11,2010,Paying back James,,7,2220
4,11,2010,Costa Coffee,Eating Out,2,2218
4,11,2010,Chicken Cottage,Eating Out,6,2212
4,11,2010,ATM Cash Withdrawal,General,20,2192
5,11,2010,ASDA,Groceries,60,2132
5,11,2010,Costa Coffee,Eating Out,1,2131
5,11,2010,Chicken Cottage,Eating Out,7,2124
5,11,2010,Dominos Pizza,Eating Out,59,2065
6,11,2010,The Grand Pub,Eating Out,9,2056
6,11,2010,The Grand Pub,Eating Out,10,2046
6,11,2010,The Grand Pub,Eating Out,7,2039
6,11,2010,The Grand Pub,Eating Out,12,2027
6,11,2010,The Grand Pub,Eating Out,13,2014
6,11,2010,The Grand Pub,Eating Out,16,1998
6,11,2010,Anglo restaurant,Eating Out,58,1940
6,11,2010,ATM Cash Withdrawal,General,20,1920
7,11,2010,Cubit and West rent,Rent,550,1370
8,11,2010,South West Trains,Transport,30,1340
8,11,2010,Starbucks Coffee,Eating Out,2,1338
8,11,2010,ATM Cash Withdrawal,General,20,1318
8,11,2010,Red Shop,,4,1314
9,11,2010,Costa Coffee,Eating Out,1,1313
9,11,2010,Chicken Cottage,Eating Out,7,1306
9,11,2010,ATM Cash Withdrawal,General,20,1286
10,11,2010,Caffe Nero,Eating Out,1,1285
10,11,2010,ATM Cash Withdrawal,General,20,1265
11,11,2010,The West Cornwall Pasty Company,Eating Out,7,1258
12,11,2010,Morrisons,Groceries,55,1203
12,11,2010,Costa Coffee,Eating Out,1,1202
12,11,2010,Scott's Restaurant,Eating Out,29,1173
12,11,2010,ATM Cash Withdrawal,General,20,1153
13,11,2010,Scott's Restaurant,Eating Out,53,1100
15,11,2010,BRGAS-Electricity,Bills,56,1044
15,11,2010,BRGAS-Gas,Bills,46,998
15,11,2010,South West Trains,Transport,25,973
15,11,2010,Caffe Nero,Eating Out,2,971
16,11,2010,LBS Council Tax,Bills,50,921
16,11,2010,Caffe Nero,Eating Out,1,920
16,11,2010,Subway,Eating Out,6,914
17,11,2010,Caffe Nero,Eating Out,1,913
17,11,2010,Greggs,Eating Out,8,905
18,11,2010,Caffe Nero,Eating Out,1,904
18,11,2010,McDonalds,Eating Out,4,900
19,11,2010,Tescos,Groceries,73,827
19,11,2010,Caffe Nero,Eating Out,1,826
19,11,2010,The West Cornwall Pasty Company,Eating Out,7,819
19,11,2010,ATM Cash Withdrawal,General,10,809
20,11,2010,VIRGIN MEDIA PYMTS,Bills,50,759
20,11,2010,Restaurant Gordon RamsayPortland Restaurant,Eating Out,49,710
22,11,2010,South West Trains,Transport,28,682
22,11,2010,Starbucks Coffee,Eating Out,2,680
22,11,2010,Pret A Manger,Eating Out,4,676
22,11,2010,ATM Cash Withdrawal,General,10,666
24,11,2010,O2,Bills,37,629
24,11,2010,ATM Cash Withdrawal,General,20,609
25,11,2010,Costa Coffee,Eating Out,2,607
25,11,2010,McDonalds,Eating Out,5,602
25,11,2010,Civic Shop,,8,594
26,11,2010,ASDA,Groceries,50,544
26,11,2010,Wild Bean Cafe,Eating Out,2,542
26,11,2010,Pret A Manger,Eating Out,4,538
26,11,2010,The Grand Pub,Eating Out,16,522
26,11,2010,The Grand Pub,Eating Out,7,515
27,11,2010,Pizza Express,Eating Out,40,475
27,11,2010,ATM Cash Withdrawal,General,20,455
29,11,2010,South West Trains,Transport,27,428
30,11,2010,McDonalds,Eating Out,6,422
1,12,2010,Rhino Sports salary,General,1700,2122
1,12,2010,Caffe Nero,Eating Out,2,2120
1,12,2010,Chicken Cottage,Eating Out,5,2115
2,12,2010,The West Cornwall Pasty Company,Eating Out,4,2111
3,12,2010,Sainsburys,Groceries,87,2024
3,12,2010,Wild Bean Cafe,Eating Out,1,2023
3,12,2010,Greggs,Eating Out,8,2015
4,12,2010,Dominos Pizza,Eating Out,41,1974
4,12,2010,Civic Shop,,5,1969
6,12,2010,South West Trains,Transport,28,1941
7,12,2010,Cubit and West rent,Rent,550,1391
7,12,2010,Caffe Nero,Eating Out,2,1389
7,12,2010,The West Cornwall Pasty Company,Eating Out,5,1384
8,12,2010,Wild Bean Cafe,Eating Out,2,1382
8,12,2010,Greggs,Eating Out,4,1378
9,12,2010,Starbucks Coffee,Eating Out,2,1376
9,12,2010,Pret A Manger,Eating Out,6,1370
10,12,2010,Tescos,Groceries,65,1305
10,12,2010,Costa Coffee,Eating Out,2,1303
10,12,2010,Greggs,Eating Out,8,1295
10,12,2010,Ministry of Sound ClubXOYO Club,Eating Out,6,1289
10,12,2010,Ministry of Sound ClubXOYO Club,Eating Out,15,1274
10,12,2010,Ministry of Sound ClubXOYO Club,Eating Out,6,1268
10,12,2010,Ministry of Sound ClubXOYO Club,Eating Out,9,1259
10,12,2010,Ministry of Sound ClubXOYO Club,Eating Out,7,1252
10,12,2010,Pizza Express,Eating Out,54,1198
10,12,2010,ATM Cash Withdrawal,General,20,1178
11,12,2010,Tool Tec,,7,1171
12,12,2010,Civic Shop,,7,1164
13,12,2010,South West Trains,Transport,30,1134
13,12,2010,Wild Bean Cafe,Eating Out,2,1132
13,12,2010,Greggs,Eating Out,6,1126
14,12,2010,The West Cornwall Pasty Company,Eating Out,7,1119
15,12,2010,BRGAS-Electricity,Bills,42,1077
15,12,2010,BRGAS-Gas,Bills,35,1042
15,12,2010,ATM Cash Withdrawal,General,20,1022
16,12,2010,LBS Council Tax,Bills,50,972
16,12,2010,Paying back Julie,,1,971
17,12,2010,Waitrose,Groceries,84,887
17,12,2010,Costa Coffee,Eating Out,2,885
17,12,2010,Chicken Cottage,Eating Out,6,879
17,12,2010,Dominos Pizza,Eating Out,49,830
18,12,2010,ATM Cash Withdrawal,General,20,810
20,12,2010,VIRGIN MEDIA PYMTS,Bills,30,780
20,12,2010,South West Trains,Transport,29,751
20,12,2010,Wild Bean Cafe,Eating Out,2,749
20,12,2010,ATM Cash Withdrawal,General,10,739
21,12,2010,Caffe Nero,Eating Out,2,737
21,12,2010,McDonalds,Eating Out,7,730
21,12,2010,ATM Cash Withdrawal,General,20,710
22,12,2010,Caffe Nero,Eating Out,2,708
22,12,2010,Pret A Manger,Eating Out,7,701
23,12,2010,Starbucks Coffee,Eating Out,1,700
23,12,2010,McDonalds,Eating Out,7,693
24,12,2010,O2,Bills,37,656
24,12,2010,Tescos,Groceries,66,590
24,12,2010,Costa Coffee,Eating Out,1,589
27,12,2010,South West Trains,Transport,24,565
27,12,2010,The West Cornwall Pasty Company,Eating Out,7,558
28,12,2010,Starbucks Coffee,Eating Out,2,556
28,12,2010,ATM Cash Withdrawal,General,10,546
29,12,2010,Caffe Nero,Eating Out,2,544
29,12,2010,Tool Shop,,8,536
30,12,2010,Starbucks Coffee,Eating Out,2,534
30,12,2010,ATM Cash Withdrawal,General,20,514
31,12,2010,Waitrose,Groceries,46,468
31,12,2010,Greggs,Eating Out,7,461
31,12,2010,ATM Cash Withdrawal,General,20,441
1,1,2011,Rhino Sports salary,General,1700,2141
3,1,2011,South West Trains,Transport,36,2105
3,1,2011,Costa Coffee,Eating Out,1,2104
3,1,2011,McDonalds,Eating Out,7,2097
4,1,2011,Caffe Nero,Eating Out,1,2096
5,1,2011,Caffe Nero,Eating Out,2,2094
5,1,2011,The West Cornwall Pasty Company,Eating Out,7,2087
6,1,2011,Starbucks Coffee,Eating Out,1,2086
6,1,2011,Subway,Eating Out,7,2079
6,1,2011,ATM Cash Withdrawal,General,20,2059
7,1,2011,Cubit and West rent,Rent,550,1509
7,1,2011,Tescos,Groceries,88,1421
7,1,2011,Caffe Nero,Eating Out,1,1420
7,1,2011,Chicken Cottage,Eating Out,8,1412
7,1,2011,ATM Cash Withdrawal,General,20,1392
8,1,2011,The Grand Pub,Eating Out,16,1376
8,1,2011,The Grand Pub,Eating Out,14,1362
8,1,2011,The Grand Pub,Eating Out,15,1347
8,1,2011,The Grand Pub,Eating Out,11,1336
8,1,2011,The Grand Pub,Eating Out,13,1323
8,1,2011,The Grand Pub,Eating Out,6,1317
9,1,2011,ATM Cash Withdrawal,General,20,1297
10,1,2011,South West Trains,Transport,27,1270
10,1,2011,Subway,Eating Out,5,1265
11,1,2011,Costa Coffee,Eating Out,2,1263
12,1,2011,Starbucks Coffee,Eating Out,2,1261
12,1,2011,The West Cornwall Pasty Company,Eating Out,6,1255
13,1,2011,Caffe Nero,Eating Out,2,1253
13,1,2011,Greggs,Eating Out,5,1248
13,1,2011,ATM Cash Withdrawal,General,20,1228
13,1,2011,Cheam Service Station,,4,1224
14,1,2011,Morrisons,Groceries,42,1182
14,1,2011,Wild Bean Cafe,Eating Out,2,1180
15,1,2011,BRGAS-Electricity,Bills,54,1126
15,1,2011,BRGAS-Gas,Bills,77,1049
15,1,2011,The Grand Pub,Eating Out,5,1044
15,1,2011,The Grand Pub,Eating Out,15,1029
15,1,2011,The Grand Pub,Eating Out,5,1024
16,1,2011,LBS Council Tax,Bills,50,974
16,1,2011,Anglo restaurant,Eating Out,57,917
17,1,2011,South West Trains,Transport,27,890
18,1,2011,Starbucks Coffee,Eating Out,2,888
19,1,2011,Costa Coffee,Eating Out,2,886
20,1,2011,VIRGIN MEDIA PYMTS,Bills,36,850
20,1,2011,Greggs,Eating Out,8,842
21,1,2011,Waitrose,Groceries,76,766
21,1,2011,Costa Coffee,Eating Out,1,765
21,1,2011,Scott's Restaurant,Eating Out,36,729
23,1,2011,Pizza Express,Eating Out,30,699
23,1,2011,ATM Cash Withdrawal,General,10,689
24,1,2011,O2,Bills,32,657
24,1,2011,South West Trains,Transport,36,621
24,1,2011,Costa Coffee,Eating Out,2,619
24,1,2011,ATM Cash Withdrawal,General,10,609
25,1,2011,Costa Coffee,Eating Out,1,608
26,1,2011,ATM Cash Withdrawal,General,20,588
27,1,2011,Wild Bean Cafe,Eating Out,2,586
28,1,2011,Waitrose,Groceries,81,505
28,1,2011,Starbucks Coffee,Eating Out,2,503
28,1,2011,Scott's Restaurant,Eating Out,51,452
28,1,2011,ATM Cash Withdrawal,General,10,442
29,1,2011,Dominos Pizza,Eating Out,32,410
29,1,2011,Paying back James,,8,402
30,1,2011,Scott's Restaurant,Eating Out,37,365
31,1,2011,South West Trains,Transport,28,337
31,1,2011,Wild Bean Cafe,Eating Out,2,335
31,1,2011,Pret A Manger,Eating Out,4,331
1,2,2011,Rhino Sports salary,General,1700,2031
1,2,2011,Caffe Nero,Eating Out,2,2029
1,2,2011,Pret A Manger,Eating Out,5,2024
2,2,2011,Caffe Nero,Eating Out,2,2022
2,2,2011,McDonalds,Eating Out,5,2017
3,2,2011,Subway,Eating Out,5,2012
3,2,2011,ATM Cash Withdrawal,General,10,2002
3,2,2011,Paying back James,,2,2000
4,2,2011,Morrisons,Groceries,71,1929
4,2,2011,Starbucks Coffee,Eating Out,2,1927
4,2,2011,McDonalds,Eating Out,5,1922
5,2,2011,Heaven Club,Eating Out,11,1911
5,2,2011,Heaven Club,Eating Out,5,1906
6,2,2011,Dominos Pizza,Eating Out,26,1880
6,2,2011,ATM Cash Withdrawal,General,20,1860
7,2,2011,Cubit and West rent,Rent,550,1310
7,2,2011,South West Trains,Transport,33,1277
7,2,2011,Costa Coffee,Eating Out,1,1276
7,2,2011,Chicken Cottage,Eating Out,8,1268
8,2,2011,Starbucks Coffee,Eating Out,2,1266
8,2,2011,Civic Shop,,8,1258
9,2,2011,Wild Bean Cafe,Eating Out,2,1256
9,2,2011,The West Cornwall Pasty Company,Eating Out,6,1250
10,2,2011,Wild Bean Cafe,Eating Out,1,1249
10,2,2011,Greggs,Eating Out,6,1243
10,2,2011,ATM Cash Withdrawal,General,10,1233
11,2,2011,ASDA,Groceries,75,1158
11,2,2011,Subway,Eating Out,7,1151
12,2,2011,Ministry of Sound ClubXOYO Club,Eating Out,11,1140
12,2,2011,Ministry of Sound ClubXOYO Club,Eating Out,10,1130
12,2,2011,Ministry of Sound ClubXOYO Club,Eating Out,15,1115
12,2,2011,Ministry of Sound ClubXOYO Club,Eating Out,14,1101
12,2,2011,Ministry of Sound ClubXOYO Club,Eating Out,10,1091
12,2,2011,Ministry of Sound ClubXOYO Club,Eating Out,9,1082
12,2,2011,Anglo restaurant,Eating Out,25,1057
12,2,2011,ATM Cash Withdrawal,General,10,1047
13,2,2011,ATM Cash Withdrawal,General,10,1037
14,2,2011,South West Trains,Transport,25,1012
14,2,2011,Subway,Eating Out,6,1006
15,2,2011,BRGAS-Electricity,Bills,40,966
15,2,2011,BRGAS-Gas,Bills,34,932
15,2,2011,Wild Bean Cafe,Eating Out,1,931
15,2,2011,Subway,Eating Out,6,925
15,2,2011,ATM Cash Withdrawal,General,20,905
16,2,2011,LBS Council Tax,Bills,50,855
16,2,2011,The West Cornwall Pasty Company,Eating Out,4,851
17,2,2011,Starbucks Coffee,Eating Out,2,849
18,2,2011,ASDA,Groceries,65,784
18,2,2011,Costa Coffee,Eating Out,1,783
18,2,2011,The West Cornwall Pasty Company,Eating Out,4,779
18,2,2011,Ministry of Sound ClubXOYO Club,Eating Out,11,768
18,2,2011,Pizza Express,Eating Out,31,737
18,2,2011,ATM Cash Withdrawal,General,20,717
19,2,2011,Fabric Club,Eating Out,14,703
19,2,2011,Fabric Club,Eating Out,11,692
19,2,2011,Fabric Club,Eating Out,9,683
19,2,2011,Fabric Club,Eating Out,8,675
19,2,2011,Fabric Club,Eating Out,10,665
19,2,2011,Pizza Express,Eating Out,25,640
20,2,2011,VIRGIN MEDIA PYMTS,Bills,37,603
20,2,2011,ATM Cash Withdrawal,General,20,583
21,2,2011,South West Trains,Transport,38,545
21,2,2011,Wild Bean Cafe,Eating Out,1,544
22,2,2011,Caffe Nero,Eating Out,1,543
23,2,2011,McDonalds,Eating Out,4,539
24,2,2011,O2,Bills,38,501
24,2,2011,Wild Bean Cafe,Eating Out,2,499
24,2,2011,Greggs,Eating Out,6,493
24,2,2011,ATM Cash Withdrawal,General,20,473
25,2,2011,ASDA,Groceries,66,407
25,2,2011,Wild Bean Cafe,Eating Out,1,406
25,2,2011,Tool Tec,,4,402
27,2,2011,ATM Cash Withdrawal,General,10,392
27,2,2011,Civic Shop,,9,383
28,2,2011,South West Trains,Transport,29,354
28,2,2011,Wild Bean Cafe,Eating Out,2,352
28,2,2011,Pret A Manger,Eating Out,8,344
1,3,2011,Rhino Sports salary,General,1700,2044
1,3,2011,Wild Bean Cafe,Eating Out,2,2042
1,3,2011,ATM Cash Withdrawal,General,20,2022
2,3,2011,Caffe Nero,Eating Out,1,2021
3,3,2011,Wild Bean Cafe,Eating Out,2,2019
3,3,2011,ATM Cash Withdrawal,General,10,2009
4,3,2011,Sainsburys,Groceries,68,1941
4,3,2011,Pret A Manger,Eating Out,7,1934
4,3,2011,Heaven Club,Eating Out,5,1929
4,3,2011,Heaven Club,Eating Out,13,1916
4,3,2011,Heaven Club,Eating Out,7,1909
4,3,2011,Heaven Club,Eating Out,15,1894
4,3,2011,Heaven Club,Eating Out,14,1880
7,3,2011,Cubit and West rent,Rent,550,1330
7,3,2011,South West Trains,Transport,30,1300
7,3,2011,Starbucks Coffee,Eating Out,1,1299
7,3,2011,Chicken Cottage,Eating Out,6,1293
7,3,2011,ATM Cash Withdrawal,General,10,1283
8,3,2011,Caffe Nero,Eating Out,1,1282
8,3,2011,ATM Cash Withdrawal,General,10,1272
9,3,2011,ATM Cash Withdrawal,General,20,1252
10,3,2011,Costa Coffee,Eating Out,2,1250
10,3,2011,ATM Cash Withdrawal,General,10,1240
11,3,2011,Sainsburys,Groceries,50,1190
12,3,2011,ATM Cash Withdrawal,General,20,1170
13,3,2011,Pizza Express,Eating Out,31,1139
14,3,2011,South West Trains,Transport,26,1113
14,3,2011,Caffe Nero,Eating Out,2,1111
14,3,2011,Chicken Cottage,Eating Out,5,1106
15,3,2011,BRGAS-Electricity,Bills,32,1074
15,3,2011,BRGAS-Gas,Bills,22,1052
15,3,2011,Subway,Eating Out,5,1047
16,3,2011,LBS Council Tax,Bills,50,997
16,3,2011,Wild Bean Cafe,Eating Out,1,996
16,3,2011,Pret A Manger,Eating Out,8,988
16,3,2011,ATM Cash Withdrawal,General,20,968
17,3,2011,Starbucks Coffee,Eating Out,1,967
17,3,2011,Chicken Cottage,Eating Out,7,960
18,3,2011,Waitrose,Groceries,58,902
18,3,2011,Starbucks Coffee,Eating Out,2,900
18,3,2011,Scott's Restaurant,Eating Out,29,871
18,3,2011,ATM Cash Withdrawal,General,10,861
19,3,2011,The Grand Pub,Eating Out,14,847
19,3,2011,The Grand Pub,Eating Out,15,832
19,3,2011,The Grand Pub,Eating Out,6,826
19,3,2011,The Grand Pub,Eating Out,5,821
19,3,2011,The Grand Pub,Eating Out,11,810
20,3,2011,VIRGIN MEDIA PYMTS,Bills,40,770
20,3,2011,ATM Cash Withdrawal,General,20,750
21,3,2011,South West Trains,Transport,34,716
21,3,2011,Costa Coffee,Eating Out,2,714
21,3,2011,Pret A Manger,Eating Out,5,709
21,3,2011,ATM Cash Withdrawal,General,20,689
22,3,2011,Wild Bean Cafe,Eating Out,2,687
22,3,2011,McDonalds,Eating Out,7,680
22,3,2011,ATM Cash Withdrawal,General,20,660
23,3,2011,Starbucks Coffee,Eating Out,1,659
24,3,2011,O2,Bills,35,624
24,3,2011,Starbucks Coffee,Eating Out,2,622
24,3,2011,Subway,Eating Out,5,617
25,3,2011,Morrisons,Groceries,48,569
25,3,2011,Costa Coffee,Eating Out,2,567
25,3,2011,ATM Cash Withdrawal,General,10,557
25,3,2011,Paying back James,,3,554
26,3,2011,Dominos Pizza,Eating Out,45,509
26,3,2011,ATM Cash Withdrawal,General,20,489
26,3,2011,Red Shop,,7,482
27,3,2011,Scott's Restaurant,Eating Out,42,440
28,3,2011,South West Trains,Transport,32,408
28,3,2011,Costa Coffee,Eating Out,1,407
28,3,2011,The West Cornwall Pasty Company,Eating Out,8,399
29,3,2011,Starbucks Coffee,Eating Out,2,397
29,3,2011,The West Cornwall Pasty Company,Eating Out,6,391
30,3,2011,Wild Bean Cafe,Eating Out,1,390
30,3,2011,The West Cornwall Pasty Company,Eating Out,8,382
31,3,2011,Starbucks Coffee,Eating Out,2,380
1,4,2011,Rhino Sports salary,General,1700,2080
1,4,2011,Sainsburys,Groceries,62,2018
1,4,2011,Caffe Nero,Eating Out,2,2016
1,4,2011,The West Cornwall Pasty Company,Eating Out,8,2008
1,4,2011,The Grand Pub,Eating Out,10,1998
1,4,2011,The Grand Pub,Eating Out,14,1984
1,4,2011,The Grand Pub,Eating Out,13,1971
1,4,2011,The Grand Pub,Eating Out,10,1961
1,4,2011,The Grand Pub,Eating Out,12,1949
1,4,2011,The Grand Pub,Eating Out,13,1936
2,4,2011,Pizza Express,Eating Out,34,1902
2,4,2011,ATM Cash Withdrawal,General,20,1882
3,4,2011,Anglo restaurant,Eating Out,36,1846
3,4,2011,ATM Cash Withdrawal,General,20,1826
4,4,2011,South West Trains,Transport,29,1797
4,4,2011,Costa Coffee,Eating Out,2,1795
4,4,2011,ATM Cash Withdrawal,General,20,1775
5,4,2011,Costa Coffee,Eating Out,1,1774
5,4,2011,McDonalds,Eating Out,5,1769
6,4,2011,Wild Bean Cafe,Eating Out,2,1767
7,4,2011,Cubit and West rent,Rent,550,1217
7,4,2011,Costa Coffee,Eating Out,2,1215
8,4,2011,Waitrose,Groceries,77,1138
8,4,2011,Pret A Manger,Eating Out,4,1134
9,4,2011,Dominos Pizza,Eating Out,25,1109
11,4,2011,South West Trains,Transport,38,1071
11,4,2011,Caffe Nero,Eating Out,2,1069
11,4,2011,Subway,Eating Out,5,1064
11,4,2011,ATM Cash Withdrawal,General,20,1044
12,4,2011,Starbucks Coffee,Eating Out,1,1043
13,4,2011,Wild Bean Cafe,Eating Out,2,1041
13,4,2011,McDonalds,Eating Out,6,1035
14,4,2011,Caffe Nero,Eating Out,2,1033
15,4,2011,BRGAS-Electricity,Bills,41,992
15,4,2011,BRGAS-Gas,Bills,22,970
15,4,2011,Tescos,Groceries,46,924
15,4,2011,Starbucks Coffee,Eating Out,1,923
15,4,2011,Chicken Cottage,Eating Out,4,919
15,4,2011,Scott's Restaurant,Eating Out,35,884
15,4,2011,ATM Cash Withdrawal,General,10,874
15,4,2011,Tool Shop,,5,869
16,4,2011,LBS Council Tax,Bills,50,819
16,4,2011,Ministry of Sound ClubXOYO Club,Eating Out,13,806
16,4,2011,Ministry of Sound ClubXOYO Club,Eating Out,13,793
16,4,2011,Ministry of Sound ClubXOYO Club,Eating Out,7,786
16,4,2011,Ministry of Sound ClubXOYO Club,Eating Out,6,780
16,4,2011,Ministry of Sound ClubXOYO Club,Eating Out,9,771
16,4,2011,Ministry of Sound ClubXOYO Club,Eating Out,5,766
17,4,2011,Civic Shop,,1,765
18,4,2011,South West Trains,Transport,26,739
18,4,2011,Starbucks Coffee,Eating Out,2,737
19,4,2011,Caffe Nero,Eating Out,2,735
19,4,2011,Greggs,Eating Out,6,729
20,4,2011,VIRGIN MEDIA PYMTS,Bills,39,690
20,4,2011,Starbucks Coffee,Eating Out,2,688
20,4,2011,Subway,Eating Out,5,683
20,4,2011,ATM Cash Withdrawal,General,10,673
21,4,2011,Caffe Nero,Eating Out,2,671
22,4,2011,ASDA,Groceries,60,611
22,4,2011,Chicken Cottage,Eating Out,6,605
23,4,2011,Scott's Restaurant,Eating Out,36,569
23,4,2011,ATM Cash Withdrawal,General,10,559
23,4,2011,Civic Shop,,9,550
24,4,2011,O2,Bills,34,516
25,4,2011,South West Trains,Transport,26,490
25,4,2011,Caffe Nero,Eating Out,2,488
25,4,2011,ATM Cash Withdrawal,General,10,478
28,4,2011,Costa Coffee,Eating Out,2,476
29,4,2011,ASDA,Groceries,79,397
29,4,2011,Greggs,Eating Out,6,391
29,4,2011,ATM Cash Withdrawal,General,20,371
1,5,2011,Rhino Sports salary,General,1700,2071
2,5,2011,South West Trains,Transport,38,2033
2,5,2011,Caffe Nero,Eating Out,1,2032
2,5,2011,ATM Cash Withdrawal,General,10,2022
3,5,2011,Wild Bean Cafe,Eating Out,2,2020
3,5,2011,The West Cornwall Pasty Company,Eating Out,5,2015
4,5,2011,Costa Coffee,Eating Out,2,2013
5,5,2011,Starbucks Coffee,Eating Out,1,2012
5,5,2011,Subway,Eating Out,7,2005
5,5,2011,ATM Cash Withdrawal,General,20,1985
6,5,2011,Waitrose,Groceries,48,1937
6,5,2011,McDonalds,Eating Out,4,1933
6,5,2011,Anglo restaurant,Eating Out,47,1886
7,5,2011,Cubit and West rent,Rent,550,1336
9,5,2011,South West Trains,Transport,35,1301
9,5,2011,Wild Bean Cafe,Eating Out,1,1300
9,5,2011,Pret A Manger,Eating Out,7,1293
10,5,2011,Costa Coffee,Eating Out,2,1291
10,5,2011,Pret A Manger,Eating Out,7,1284
11,5,2011,Chicken Cottage,Eating Out,5,1279
11,5,2011,ATM Cash Withdrawal,General,20,1259
11,5,2011,Cheam Service Station,,6,1253
12,5,2011,Starbucks Coffee,Eating Out,2,1251
12,5,2011,Chicken Cottage,Eating Out,6,1245
13,5,2011,Waitrose,Groceries,47,1198
13,5,2011,Costa Coffee,Eating Out,1,1197
15,5,2011,BRGAS-Electricity,Bills,33,1164
15,5,2011,BRGAS-Gas,Bills,38,1126
16,5,2011,LBS Council Tax,Bills,50,1076
16,5,2011,South West Trains,Transport,37,1039
16,5,2011,Costa Coffee,Eating Out,1,1038
16,5,2011,Pret A Manger,Eating Out,5,1033
16,5,2011,ATM Cash Withdrawal,General,10,1023
16,5,2011,Tool Shop,,2,1021
17,5,2011,Caffe Nero,Eating Out,2,1019
17,5,2011,ATM Cash Withdrawal,General,20,999
17,5,2011,Tool Shop,,2,997
18,5,2011,Chicken Cottage,Eating Out,8,989
19,5,2011,Wild Bean Cafe,Eating Out,2,987
19,5,2011,Pret A Manger,Eating Out,7,980
20,5,2011,VIRGIN MEDIA PYMTS,Bills,58,922
20,5,2011,Sainsburys,Groceries,72,850
20,5,2011,Costa Coffee,Eating Out,1,849
20,5,2011,Greggs,Eating Out,7,842
21,5,2011,ATM Cash Withdrawal,General,20,822
23,5,2011,South West Trains,Transport,35,787
23,5,2011,Wild Bean Cafe,Eating Out,2,785
24,5,2011,O2,Bills,38,747
24,5,2011,Costa Coffee,Eating Out,2,745
24,5,2011,McDonalds,Eating Out,6,739
24,5,2011,ATM Cash Withdrawal,General,10,729
25,5,2011,Starbucks Coffee,Eating Out,1,728
25,5,2011,Chicken Cottage,Eating Out,8,720
26,5,2011,Starbucks Coffee,Eating Out,2,718
27,5,2011,Waitrose,Groceries,57,661
27,5,2011,Wild Bean Cafe,Eating Out,2,659
27,5,2011,The West Cornwall Pasty Company,Eating Out,6,653
28,5,2011,Dominos Pizza,Eating Out,26,627
28,5,2011,ATM Cash Withdrawal,General,20,607
30,5,2011,South West Trains,Transport,26,581
30,5,2011,ATM Cash Withdrawal,General,20,561
31,5,2011,Subway,Eating Out,8,553
1,6,2011,Rhino Sports salary,General,1700,2253
1,6,2011,Caffe Nero,Eating Out,1,2252
2,6,2011,Wild Bean Cafe,Eating Out,2,2250
2,6,2011,Greggs,Eating Out,6,2244
3,6,2011,Morrisons,Groceries,61,2183
3,6,2011,Costa Coffee,Eating Out,2,2181
3,6,2011,Pizza Express,Eating Out,56,2125
4,6,2011,Pizza Express,Eating Out,42,2083
4,6,2011,ATM Cash Withdrawal,General,10,2073
5,6,2011,Scott's Restaurant,Eating Out,53,2020
6,6,2011,South West Trains,Transport,35,1985
6,6,2011,Starbucks Coffee,Eating Out,2,1983
6,6,2011,ATM Cash Withdrawal,General,20,1963
7,6,2011,Cubit and West rent,Rent,550,1413
7,6,2011,Greggs,Eating Out,7,1406
8,6,2011,Starbucks Coffee,Eating Out,2,1404
8,6,2011,Chicken Cottage,Eating Out,5,1399
9,6,2011,Caffe Nero,Eating Out,2,1397
9,6,2011,The West Cornwall Pasty Company,Eating Out,6,1391
10,6,2011,Sainsburys,Groceries,60,1331
10,6,2011,Starbucks Coffee,Eating Out,1,1330
10,6,2011,Greggs,Eating Out,6,1324
12,6,2011,Paying back Julie,,9,1315
13,6,2011,South West Trains,Transport,34,1281
13,6,2011,Starbucks Coffee,Eating Out,2,1279
14,6,2011,Wild Bean Cafe,Eating Out,2,1277
14,6,2011,Chicken Cottage,Eating Out,6,1271
14,6,2011,ATM Cash Withdrawal,General,20,1251
15,6,2011,BRGAS-Electricity,Bills,40,1211
15,6,2011,BRGAS-Gas,Bills,37,1174
15,6,2011,Wild Bean Cafe,Eating Out,2,1172
15,6,2011,ATM Cash Withdrawal,General,20,1152
16,6,2011,LBS Council Tax,Bills,50,1102
16,6,2011,Starbucks Coffee,Eating Out,1,1101
16,6,2011,Subway,Eating Out,8,1093
16,6,2011,ATM Cash Withdrawal,General,20,1073
17,6,2011,Sainsburys,Groceries,81,992
17,6,2011,Starbucks Coffee,Eating Out,1,991
17,6,2011,Chicken Cottage,Eating Out,4,987
17,6,2011,Ministry of Sound ClubXOYO Club,Eating Out,7,980
17,6,2011,Ministry of Sound ClubXOYO Club,Eating Out,5,975
17,6,2011,Red Shop,,3,972
18,6,2011,Scott's Restaurant,Eating Out,36,936
19,6,2011,Restaurant Gordon RamsayPortland Restaurant,Eating Out,28,908
19,6,2011,ATM Cash Withdrawal,General,20,888
20,6,2011,VIRGIN MEDIA PYMTS,Bills,47,841
20,6,2011,South West Trains,Transport,24,817
20,6,2011,Pret A Manger,Eating Out,8,809
21,6,2011,Caffe Nero,Eating Out,2,807
22,6,2011,Costa Coffee,Eating Out,1,806
22,6,2011,Subway,Eating Out,8,798
23,6,2011,Starbucks Coffee,Eating Out,2,796
23,6,2011,Greggs,Eating Out,8,788
24,6,2011,O2,Bills,34,754
24,6,2011,Morrisons,Groceries,45,709
24,6,2011,Pret A Manger,Eating Out,4,705
25,6,2011,Scott's Restaurant,Eating Out,32,673
25,6,2011,Red Shop,,6,667
27,6,2011,South West Trains,Transport,33,634
27,6,2011,Tool Tec,,2,632
28,6,2011,Caffe Nero,Eating Out,2,630
28,6,2011,ATM Cash Withdrawal,General,20,610
30,6,2011,Subway,Eating Out,6,604
1,7,2011,Rhino Sports salary,General,1700,2304
1,7,2011,Sainsburys,Groceries,83,2221
1,7,2011,Caffe Nero,Eating Out,2,2219
1,7,2011,McDonalds,Eating Out,7,2212
3,7,2011,Dominos Pizza,Eating Out,32,2180
4,7,2011,South West Trains,Transport,34,2146
4,7,2011,Starbucks Coffee,Eating Out,2,2144
4,7,2011,Greggs,Eating Out,8,2136
4,7,2011,ATM Cash Withdrawal,General,20,2116
5,7,2011,Costa Coffee,Eating Out,2,2114
5,7,2011,The West Cornwall Pasty Company,Eating Out,4,2110
6,7,2011,Chicken Cottage,Eating Out,4,2106
6,7,2011,Tool Tec,,6,2100
7,7,2011,Cubit and West rent,Rent,550,1550
7,7,2011,Starbucks Coffee,Eating Out,2,1548
7,7,2011,McDonalds,Eating Out,8,1540
8,7,2011,Tescos,Groceries,67,1473
8,7,2011,Caffe Nero,Eating Out,1,1472
8,7,2011,The West Cornwall Pasty Company,Eating Out,8,1464
8,7,2011,Heaven Club,Eating Out,16,1448
10,7,2011,Dominos Pizza,Eating Out,28,1420
10,7,2011,Paying back Julie,,3,1417
11,7,2011,South West Trains,Transport,38,1379
11,7,2011,Wild Bean Cafe,Eating Out,1,1378
11,7,2011,Subway,Eating Out,7,1371
11,7,2011,ATM Cash Withdrawal,General,10,1361
12,7,2011,Subway,Eating Out,8,1353
12,7,2011,Red Shop,,4,1349
13,7,2011,Costa Coffee,Eating Out,1,1348
13,7,2011,Greggs,Eating Out,4,1344
14,7,2011,Costa Coffee,Eating Out,1,1343
14,7,2011,ATM Cash Withdrawal,General,20,1323
15,7,2011,BRGAS-Electricity,Bills,27,1296
15,7,2011,BRGAS-Gas,Bills,36,1260
15,7,2011,Tescos,Groceries,63,1197
15,7,2011,Starbucks Coffee,Eating Out,2,1195
16,7,2011,LBS Council Tax,Bills,50,1145
18,7,2011,South West Trains,Transport,24,1121
18,7,2011,Subway,Eating Out,4,1117
18,7,2011,Paying back Julie,,6,1111
19,7,2011,Wild Bean Cafe,Eating Out,2,1109
19,7,2011,Pret A Manger,Eating Out,5,1104
19,7,2011,ATM Cash Withdrawal,General,10,1094
20,7,2011,VIRGIN MEDIA PYMTS,Bills,56,1038
20,7,2011,The West Cornwall Pasty Company,Eating Out,7,1031
21,7,2011,Starbucks Coffee,Eating Out,2,1029
21,7,2011,ATM Cash Withdrawal,General,20,1009
22,7,2011,Morrisons,Groceries,60,949
22,7,2011,Starbucks Coffee,Eating Out,2,947
22,7,2011,Ministry of Sound ClubXOYO Club,Eating Out,10,937
22,7,2011,Ministry of Sound ClubXOYO Club,Eating Out,13,924
23,7,2011,Pizza Express,Eating Out,24,900
24,7,2011,O2,Bills,37,863
25,7,2011,South West Trains,Transport,38,825
25,7,2011,Caffe Nero,Eating Out,2,823
25,7,2011,ATM Cash Withdrawal,General,10,813
26,7,2011,McDonalds,Eating Out,5,808
27,7,2011,Subway,Eating Out,5,803
28,7,2011,Wild Bean Cafe,Eating Out,1,802
28,7,2011,The West Cornwall Pasty Company,Eating Out,8,794
29,7,2011,ASDA,Groceries,45,749
29,7,2011,Starbucks Coffee,Eating Out,2,747
30,7,2011,Red Shop,,8,739
31,7,2011,Restaurant Gordon RamsayPortland Restaurant,Eating Out,58,681
31,7,2011,Paying back James,,7,674
1,8,2011,Rhino Sports salary,General,1700,2374
1,8,2011,South West Trains,Transport,24,2350
1,8,2011,Costa Coffee,Eating Out,2,2348
1,8,2011,McDonalds,Eating Out,8,2340
1,8,2011,ATM Cash Withdrawal,General,10,2330
2,8,2011,Wild Bean Cafe,Eating Out,1,2329
2,8,2011,Pret A Manger,Eating Out,5,2324
3,8,2011,Caffe Nero,Eating Out,2,2322
3,8,2011,Pret A Manger,Eating Out,4,2318
4,8,2011,Subway,Eating Out,7,2311
5,8,2011,Tescos,Groceries,80,2231
5,8,2011,Chicken Cottage,Eating Out,6,2225
5,8,2011,ATM Cash Withdrawal,General,10,2215
6,8,2011,ATM Cash Withdrawal,General,20,2195
7,8,2011,Cubit and West rent,Rent,550,1645
7,8,2011,Dominos Pizza,Eating Out,51,1594
8,8,2011,South West Trains,Transport,24,1570
8,8,2011,Starbucks Coffee,Eating Out,2,1568
8,8,2011,Greggs,Eating Out,6,1562
9,8,2011,Wild Bean Cafe,Eating Out,2,1560
10,8,2011,Caffe Nero,Eating Out,1,1559
10,8,2011,Pret A Manger,Eating Out,7,1552
10,8,2011,ATM Cash Withdrawal,General,10,1542
11,8,2011,Wild Bean Cafe,Eating Out,1,1541
11,8,2011,Chicken Cottage,Eating Out,7,1534
11,8,2011,Civic Shop,,3,1531
12,8,2011,Tescos,Groceries,57,1474
12,8,2011,Caffe Nero,Eating Out,2,1472
12,8,2011,Pret A Manger,Eating Out,4,1468
12,8,2011,Restaurant Gordon RamsayPortland Restaurant,Eating Out,38,1430
14,8,2011,ATM Cash Withdrawal,General,20,1410
15,8,2011,BRGAS-Electricity,Bills,40,1370
15,8,2011,BRGAS-Gas,Bills,33,1337
15,8,2011,South West Trains,Transport,33,1304
15,8,2011,Wild Bean Cafe,Eating Out,1,1303
15,8,2011,Subway,Eating Out,7,1296
15,8,2011,ATM Cash Withdrawal,General,20,1276
16,8,2011,LBS Council Tax,Bills,50,1226
16,8,2011,Wild Bean Cafe,Eating Out,2,1224
16,8,2011,ATM Cash Withdrawal,General,20,1204
17,8,2011,Costa Coffee,Eating Out,2,1202
17,8,2011,ATM Cash Withdrawal,General,10,1192
18,8,2011,Pret A Manger,Eating Out,7,1185
19,8,2011,Tescos,Groceries,89,1096
19,8,2011,Greggs,Eating Out,6,1090
19,8,2011,Anglo restaurant,Eating Out,24,1066
19,8,2011,ATM Cash Withdrawal,General,20,1046
20,8,2011,VIRGIN MEDIA PYMTS,Bills,35,1011
20,8,2011,Dominos Pizza,Eating Out,50,961
21,8,2011,Anglo restaurant,Eating Out,55,906
22,8,2011,South West Trains,Transport,38,868
22,8,2011,Caffe Nero,Eating Out,1,867
22,8,2011,Greggs,Eating Out,8,859
23,8,2011,Starbucks Coffee,Eating Out,2,857
23,8,2011,The West Cornwall Pasty Company,Eating Out,5,852
23,8,2011,ATM Cash Withdrawal,General,20,832
24,8,2011,O2,Bills,34,798
24,8,2011,Caffe Nero,Eating Out,2,796
24,8,2011,ATM Cash Withdrawal,General,20,776
25,8,2011,Costa Coffee,Eating Out,2,774
25,8,2011,McDonalds,Eating Out,7,767
25,8,2011,ATM Cash Withdrawal,General,20,747
26,8,2011,Tescos,Groceries,48,699
26,8,2011,Costa Coffee,Eating Out,2,697
26,8,2011,Subway,Eating Out,7,690
26,8,2011,Scott's Restaurant,Eating Out,34,656
29,8,2011,South West Trains,Transport,32,624
29,8,2011,Costa Coffee,Eating Out,2,622
30,8,2011,Costa Coffee,Eating Out,2,620
30,8,2011,McDonalds,Eating Out,5,615
30,8,2011,Paying back Julie,,9,606
31,8,2011,Starbucks Coffee,Eating Out,1,605
31,8,2011,McDonalds,Eating Out,4,601
1,9,2011,Rhino Sports salary,General,1700,2301
1,9,2011,Starbucks Coffee,Eating Out,1,2300
1,9,2011,ATM Cash Withdrawal,General,20,2280
2,9,2011,Sainsburys,Groceries,88,2192
2,9,2011,Starbucks Coffee,Eating Out,2,2190
2,9,2011,Fabric Club,Eating Out,8,2182
2,9,2011,Fabric Club,Eating Out,8,2174
2,9,2011,Fabric Club,Eating Out,7,2167
2,9,2011,Fabric Club,Eating Out,15,2152
2,9,2011,Fabric Club,Eating Out,9,2143
2,9,2011,ATM Cash Withdrawal,General,20,2123
3,9,2011,Cheam Service Station,,3,2120
4,9,2011,Pizza Express,Eating Out,43,2077
5,9,2011,South West Trains,Transport,33,2044
5,9,2011,Costa Coffee,Eating Out,2,2042
5,9,2011,Tool Tec,,6,2036
7,9,2011,Cubit and West rent,Rent,550,1486
8,9,2011,Wild Bean Cafe,Eating Out,2,1484
8,9,2011,Pret A Manger,Eating Out,5,1479
8,9,2011,Cheam Service Station,,2,1477
9,9,2011,Morrisons,Groceries,77,1400
9,9,2011,Costa Coffee,Eating Out,1,1399
9,9,2011,Greggs,Eating Out,5,1394
9,9,2011,ATM Cash Withdrawal,General,10,1384
10,9,2011,Restaurant Gordon RamsayPortland Restaurant,Eating Out,29,1355
11,9,2011,Restaurant Gordon RamsayPortland Restaurant,Eating Out,55,1300
11,9,2011,ATM Cash Withdrawal,General,20,1280
12,9,2011,South West Trains,Transport,34,1246
12,9,2011,Wild Bean Cafe,Eating Out,2,1244
12,9,2011,Subway,Eating Out,4,1240
12,9,2011,ATM Cash Withdrawal,General,20,1220
13,9,2011,Caffe Nero,Eating Out,1,1219
13,9,2011,McDonalds,Eating Out,6,1213
14,9,2011,Costa Coffee,Eating Out,2,1211
15,9,2011,BRGAS-Electricity,Bills,35,1176
15,9,2011,BRGAS-Gas,Bills,36,1140
15,9,2011,Starbucks Coffee,Eating Out,1,1139
15,9,2011,McDonalds,Eating Out,4,1135
15,9,2011,ATM Cash Withdrawal,General,10,1125
16,9,2011,LBS Council Tax,Bills,50,1075
16,9,2011,ASDA,Groceries,84,991
16,9,2011,Wild Bean Cafe,Eating Out,2,989
16,9,2011,Pret A Manger,Eating Out,5,984
16,9,2011,Restaurant Gordon RamsayPortland Restaurant,Eating Out,49,935
17,9,2011,Anglo restaurant,Eating Out,35,900
19,9,2011,South West Trains,Transport,26,874
19,9,2011,Costa Coffee,Eating Out,2,872
19,9,2011,Chicken Cottage,Eating Out,6,866
20,9,2011,VIRGIN MEDIA PYMTS,Bills,40,826
20,9,2011,Caffe Nero,Eating Out,2,824
20,9,2011,The West Cornwall Pasty Company,Eating Out,8,816
21,9,2011,Caffe Nero,Eating Out,2,814
21,9,2011,Greggs,Eating Out,4,810
22,9,2011,Caffe Nero,Eating Out,2,808
22,9,2011,Greggs,Eating Out,8,800
23,9,2011,Waitrose,Groceries,72,728
23,9,2011,The West Cornwall Pasty Company,Eating Out,8,720
23,9,2011,Scott's Restaurant,Eating Out,38,682
23,9,2011,ATM Cash Withdrawal,General,20,662
24,9,2011,O2,Bills,34,628
26,9,2011,South West Trains,Transport,38,590
27,9,2011,Costa Coffee,Eating Out,2,588
27,9,2011,Subway,Eating Out,7,581
27,9,2011,ATM Cash Withdrawal,General,10,571
27,9,2011,Paying back Julie,,7,564
28,9,2011,Wild Bean Cafe,Eating Out,1,563
29,9,2011,Subway,Eating Out,7,556
29,9,2011,ATM Cash Withdrawal,General,20,536
30,9,2011,ASDA,Groceries,49,487
30,9,2011,Costa Coffee,Eating Out,1,486
30,9,2011,The West Cornwall Pasty Company,Eating Out,5,481
30,9,2011,Pizza Express,Eating Out,34,447
1,10,2011,Rhino Sports salary,General,1700,2147
2,10,2011,Dominos Pizza,Eating Out,52,2095
2,10,2011,ATM Cash Withdrawal,General,20,2075
3,10,2011,South West Trains,Transport,34,2041
3,10,2011,Starbucks Coffee,Eating Out,2,2039
4,10,2011,Starbucks Coffee,Eating Out,1,2038
4,10,2011,Greggs,Eating Out,8,2030
5,10,2011,Starbucks Coffee,Eating Out,1,2029
5,10,2011,The West Cornwall Pasty Company,Eating Out,5,2024
5,10,2011,ATM Cash Withdrawal,General,20,2004
6,10,2011,The West Cornwall Pasty Company,Eating Out,8,1996
7,10,2011,Cubit and West rent,Rent,550,1446
7,10,2011,Sainsburys,Groceries,73,1373
7,10,2011,Starbucks Coffee,Eating Out,2,1371
7,10,2011,Chicken Cottage,Eating Out,7,1364
8,10,2011,The Grand Pub,Eating Out,10,1354
8,10,2011,The Grand Pub,Eating Out,14,1340
8,10,2011,The Grand Pub,Eating Out,5,1335
8,10,2011,The Grand Pub,Eating Out,5,1330
8,10,2011,The Grand Pub,Eating Out,11,1319
8,10,2011,The Grand Pub,Eating Out,15,1304
10,10,2011,South West Trains,Transport,38,1266
10,10,2011,Starbucks Coffee,Eating Out,1,1265
10,10,2011,Greggs,Eating Out,5,1260
10,10,2011,ATM Cash Withdrawal,General,20,1240
11,10,2011,Pret A Manger,Eating Out,4,1236
11,10,2011,ATM Cash Withdrawal,General,20,1216
12,10,2011,Costa Coffee,Eating Out,2,1214
12,10,2011,McDonalds,Eating Out,5,1209
13,10,2011,Starbucks Coffee,Eating Out,2,1207
13,10,2011,ATM Cash Withdrawal,General,20,1187
14,10,2011,Morrisons,Groceries,68,1119
14,10,2011,Wild Bean Cafe,Eating Out,1,1118
14,10,2011,Pizza Express,Eating Out,41,1077
15,10,2011,BRGAS-Electricity,Bills,44,1033
15,10,2011,BRGAS-Gas,Bills,27,1006
15,10,2011,Scott's Restaurant,Eating Out,41,965
16,10,2011,LBS Council Tax,Bills,50,915
17,10,2011,South West Trains,Transport,33,882
18,10,2011,Starbucks Coffee,Eating Out,2,880
18,10,2011,Pret A Manger,Eating Out,6,874
19,10,2011,Caffe Nero,Eating Out,2,872
19,10,2011,Pret A Manger,Eating Out,8,864
20,10,2011,VIRGIN MEDIA PYMTS,Bills,57,807
20,10,2011,Caffe Nero,Eating Out,2,805
20,10,2011,Greggs,Eating Out,4,801
21,10,2011,Sainsburys,Groceries,53,748
21,10,2011,McDonalds,Eating Out,6,742
21,10,2011,Dominos Pizza,Eating Out,53,689
23,10,2011,Anglo restaurant,Eating Out,39,650
24,10,2011,O2,Bills,38,612
24,10,2011,South West Trains,Transport,29,583
24,10,2011,Costa Coffee,Eating Out,2,581
24,10,2011,The West Cornwall Pasty Company,Eating Out,5,576
25,10,2011,Wild Bean Cafe,Eating Out,2,574
25,10,2011,McDonalds,Eating Out,8,566
25,10,2011,Tool Shop,,3,563
26,10,2011,Chicken Cottage,Eating Out,6,557
27,10,2011,Caffe Nero,Eating Out,2,555
28,10,2011,ASDA,Groceries,57,498
28,10,2011,Costa Coffee,Eating Out,2,496
28,10,2011,Greggs,Eating Out,5,491
28,10,2011,Restaurant Gordon RamsayPortland Restaurant,Eating Out,52,439
28,10,2011,ATM Cash Withdrawal,General,10,429
29,10,2011,The Grand Pub,Eating Out,7,422
29,10,2011,The Grand Pub,Eating Out,7,415
29,10,2011,The Grand Pub,Eating Out,12,403
29,10,2011,The Grand Pub,Eating Out,13,390
30,10,2011,Pizza Express,Eating Out,53,337
31,10,2011,South West Trains,Transport,28,309
31,10,2011,Pret A Manger,Eating Out,7,302
1,11,2011,Rhino Sports salary,General,1700,2002
1,11,2011,Starbucks Coffee,Eating Out,1,2001
1,11,2011,McDonalds,Eating Out,8,1993
1,11,2011,ATM Cash Withdrawal,General,10,1983
2,11,2011,Subway,Eating Out,4,1979
3,11,2011,Caffe Nero,Eating Out,2,1977
3,11,2011,McDonalds,Eating Out,5,1972
4,11,2011,ASDA,Groceries,46,1926
4,11,2011,Wild Bean Cafe,Eating Out,1,1925
4,11,2011,Pizza Express,Eating Out,59,1866
4,11,2011,ATM Cash Withdrawal,General,10,1856
7,11,2011,Cubit and West rent,Rent,550,1306
7,11,2011,South West Trains,Transport,35,1271
7,11,2011,Caffe Nero,Eating Out,2,1269
7,11,2011,Greggs,Eating Out,4,1265
8,11,2011,Greggs,Eating Out,8,1257
8,11,2011,ATM Cash Withdrawal,General,20,1237
9,11,2011,Caffe Nero,Eating Out,2,1235
9,11,2011,ATM Cash Withdrawal,General,20,1215
9,11,2011,Paying back Julie,,2,1213
10,11,2011,Caffe Nero,Eating Out,2,1211
10,11,2011,Subway,Eating Out,5,1206
11,11,2011,Morrisons,Groceries,44,1162
11,11,2011,Scott's Restaurant,Eating Out,53,1109
11,11,2011,ATM Cash Withdrawal,General,10,1099
12,11,2011,Restaurant Gordon RamsayPortland Restaurant,Eating Out,51,1048
12,11,2011,ATM Cash Withdrawal,General,20,1028
13,11,2011,ATM Cash Withdrawal,General,10,1018
14,11,2011,South West Trains,Transport,24,994
14,11,2011,Costa Coffee,Eating Out,1,993
15,11,2011,BRGAS-Electricity,Bills,45,948
15,11,2011,BRGAS-Gas,Bills,65,883
15,11,2011,Starbucks Coffee,Eating Out,2,881
15,11,2011,Greggs,Eating Out,8,873
15,11,2011,Paying back Julie,,3,870
16,11,2011,LBS Council Tax,Bills,50,820
16,11,2011,Wild Bean Cafe,Eating Out,2,818
16,11,2011,Greggs,Eating Out,7,811
17,11,2011,Starbucks Coffee,Eating Out,1,810
18,11,2011,ASDA,Groceries,47,763
18,11,2011,Costa Coffee,Eating Out,1,762
18,11,2011,The West Cornwall Pasty Company,Eating Out,7,755
19,11,2011,Fabric Club,Eating Out,14,741
20,11,2011,VIRGIN MEDIA PYMTS,Bills,29,712
21,11,2011,South West Trains,Transport,27,685
21,11,2011,Caffe Nero,Eating Out,2,683
22,11,2011,Subway,Eating Out,8,675
23,11,2011,Wild Bean Cafe,Eating Out,2,673
23,11,2011,Subway,Eating Out,5,668
24,11,2011,O2,Bills,31,637
25,11,2011,Waitrose,Groceries,74,563
28,11,2011,South West Trains,Transport,27,536
28,11,2011,Wild Bean Cafe,Eating Out,2,534
28,11,2011,Greggs,Eating Out,8,526
28,11,2011,ATM Cash Withdrawal,General,20,506
29,11,2011,Greggs,Eating Out,4,502
29,11,2011,ATM Cash Withdrawal,General,10,492
30,11,2011,Starbucks Coffee,Eating Out,2,490
30,11,2011,The West Cornwall Pasty Company,Eating Out,8,482
1,12,2011,Rhino Sports salary,General,1700,2182
1,12,2011,Starbucks Coffee,Eating Out,2,2180
1,12,2011,Subway,Eating Out,4,2176
2,12,2011,Sainsburys,Groceries,58,2118
2,12,2011,Starbucks Coffee,Eating Out,2,2116
2,12,2011,Pret A Manger,Eating Out,4,2112
2,12,2011,Heaven Club,Eating Out,11,2101
2,12,2011,Heaven Club,Eating Out,6,2095
2,12,2011,Heaven Club,Eating Out,14,2081
2,12,2011,Heaven Club,Eating Out,14,2067
2,12,2011,Heaven Club,Eating Out,7,2060
3,12,2011,Anglo restaurant,Eating Out,32,2028
3,12,2011,Paying back Julie,,3,2025
4,12,2011,Pizza Express,Eating Out,44,1981
5,12,2011,South West Trains,Transport,30,1951
5,12,2011,Greggs,Eating Out,4,1947
6,12,2011,The West Cornwall Pasty Company,Eating Out,8,1939
7,12,2011,Cubit and West rent,Rent,550,1389
7,12,2011,Costa Coffee,Eating Out,2,1387
8,12,2011,Wild Bean Cafe,Eating Out,1,1386
9,12,2011,Morrisons,Groceries,66,1320
9,12,2011,ATM Cash Withdrawal,General,20,1300
10,12,2011,The Grand Pub,Eating Out,6,1294
10,12,2011,ATM Cash Withdrawal,General,10,1284
10,12,2011,Paying back Julie,,2,1282
11,12,2011,ATM Cash Withdrawal,General,20,1262
12,12,2011,South West Trains,Transport,30,1232
12,12,2011,McDonalds,Eating Out,7,1225
12,12,2011,Paying back James,,4,1221
13,12,2011,Starbucks Coffee,Eating Out,2,1219
13,12,2011,Subway,Eating Out,5,1214
14,12,2011,Costa Coffee,Eating Out,2,1212
14,12,2011,ATM Cash Withdrawal,General,10,1202
14,12,2011,Paying back James,,2,1200
15,12,2011,BRGAS-Electricity,Bills,28,1172
15,12,2011,BRGAS-Gas,Bills,30,1142
15,12,2011,Costa Coffee,Eating Out,1,1141
15,12,2011,Civic Shop,,9,1132
16,12,2011,LBS Council Tax,Bills,50,1082
16,12,2011,Sainsburys,Groceries,70,1012
16,12,2011,Costa Coffee,Eating Out,2,1010
16,12,2011,The West Cornwall Pasty Company,Eating Out,6,1004
16,12,2011,Restaurant Gordon RamsayPortland Restaurant,Eating Out,49,955
17,12,2011,ATM Cash Withdrawal,General,20,935
19,12,2011,South West Trains,Transport,30,905
19,12,2011,Wild Bean Cafe,Eating Out,1,904
20,12,2011,VIRGIN MEDIA PYMTS,Bills,30,874
20,12,2011,Starbucks Coffee,Eating Out,2,872
20,12,2011,Pret A Manger,Eating Out,4,868
20,12,2011,Tool Tec,,8,860
21,12,2011,Starbucks Coffee,Eating Out,1,859
21,12,2011,Pret A Manger,Eating Out,5,854
21,12,2011,ATM Cash Withdrawal,General,10,844
23,12,2011,Sainsburys,Groceries,55,789
23,12,2011,Wild Bean Cafe,Eating Out,2,787
23,12,2011,McDonalds,Eating Out,7,780
23,12,2011,The Grand Pub,Eating Out,16,764
23,12,2011,The Grand Pub,Eating Out,16,748
23,12,2011,The Grand Pub,Eating Out,14,734
24,12,2011,O2,Bills,32,702
25,12,2011,ATM Cash Withdrawal,General,10,692
26,12,2011,South West Trains,Transport,34,658
26,12,2011,Caffe Nero,Eating Out,1,657
26,12,2011,Pret A Manger,Eating Out,8,649
26,12,2011,ATM Cash Withdrawal,General,10,639
27,12,2011,Chicken Cottage,Eating Out,4,635
28,12,2011,Costa Coffee,Eating Out,2,633
28,12,2011,Subway,Eating Out,5,628
28,12,2011,ATM Cash Withdrawal,General,20,608
29,12,2011,Chicken Cottage,Eating Out,4,604
29,12,2011,ATM Cash Withdrawal,General,20,584
30,12,2011,Waitrose,Groceries,84,500
30,12,2011,Caffe Nero,Eating Out,1,499
31,12,2011,Anglo restaurant,Eating Out,43,456
31,12,2011,ATM Cash Withdrawal,General,10,446
1,1,2012,Rhino Sports salary,General,1700,2146
1,1,2012,Dominos Pizza,Eating Out,34,2112
1,1,2012,Red Shop,,7,2105
2,1,2012,South West Trains,Transport,33,2072
2,1,2012,Caffe Nero,Eating Out,2,2070
2,1,2012,Chicken Cottage,Eating Out,8,2062
3,1,2012,Costa Coffee,Eating Out,1,2061
3,1,2012,McDonalds,Eating Out,6,2055
4,1,2012,Wild Bean Cafe,Eating Out,2,2053
4,1,2012,Subway,Eating Out,5,2048
4,1,2012,ATM Cash Withdrawal,General,10,2038
5,1,2012,Pret A Manger,Eating Out,7,2031
6,1,2012,Morrisons,Groceries,50,1981
6,1,2012,Wild Bean Cafe,Eating Out,2,1979
6,1,2012,The Grand Pub,Eating Out,7,1972
6,1,2012,The Grand Pub,Eating Out,7,1965
6,1,2012,The Grand Pub,Eating Out,11,1954
6,1,2012,The Grand Pub,Eating Out,11,1943
6,1,2012,The Grand Pub,Eating Out,12,1931
6,1,2012,The Grand Pub,Eating Out,9,1922
6,1,2012,Restaurant Gordon RamsayPortland Restaurant,Eating Out,58,1864
6,1,2012,ATM Cash Withdrawal,General,20,1844
7,1,2012,Cubit and West rent,Rent,550,1294
8,1,2012,Restaurant Gordon RamsayPortland Restaurant,Eating Out,51,1243
9,1,2012,South West Trains,Transport,33,1210
9,1,2012,Costa Coffee,Eating Out,2,1208
9,1,2012,Greggs,Eating Out,4,1204
11,1,2012,Wild Bean Cafe,Eating Out,2,1202
11,1,2012,Chicken Cottage,Eating Out,6,1196
11,1,2012,ATM Cash Withdrawal,General,10,1186
12,1,2012,Starbucks Coffee,Eating Out,1,1185
12,1,2012,The West Cornwall Pasty Company,Eating Out,7,1178
12,1,2012,ATM Cash Withdrawal,General,10,1168
13,1,2012,Tescos,Groceries,71,1097
13,1,2012,Pizza Express,Eating Out,30,1067
14,1,2012,ATM Cash Withdrawal,General,10,1057
15,1,2012,BRGAS-Electricity,Bills,39,1018
15,1,2012,BRGAS-Gas,Bills,96,922
15,1,2012,Paying back Julie,,9,913
16,1,2012,LBS Council Tax,Bills,50,863
16,1,2012,South West Trains,Transport,36,827
16,1,2012,Starbucks Coffee,Eating Out,1,826
16,1,2012,The West Cornwall Pasty Company,Eating Out,6,820
17,1,2012,Costa Coffee,Eating Out,1,819
17,1,2012,ATM Cash Withdrawal,General,10,809
18,1,2012,Chicken Cottage,Eating Out,8,801
19,1,2012,ATM Cash Withdrawal,General,20,781
20,1,2012,VIRGIN MEDIA PYMTS,Bills,32,749
20,1,2012,Waitrose,Groceries,64,685
20,1,2012,Wild Bean Cafe,Eating Out,2,683
20,1,2012,The West Cornwall Pasty Company,Eating Out,6,677
20,1,2012,Fabric Club,Eating Out,11,666
20,1,2012,Fabric Club,Eating Out,14,652
20,1,2012,Fabric Club,Eating Out,11,641
20,1,2012,Pizza Express,Eating Out,38,603
20,1,2012,ATM Cash Withdrawal,General,20,583
20,1,2012,Tool Tec,,6,577
23,1,2012,South West Trains,Transport,26,551
23,1,2012,Caffe Nero,Eating Out,1,550
23,1,2012,Greggs,Eating Out,6,544
24,1,2012,O2,Bills,30,514
24,1,2012,Wild Bean Cafe,Eating Out,1,513
24,1,2012,Pret A Manger,Eating Out,5,508
25,1,2012,Wild Bean Cafe,Eating Out,2,506
25,1,2012,Chicken Cottage,Eating Out,7,499
25,1,2012,ATM Cash Withdrawal,General,20,479
26,1,2012,Caffe Nero,Eating Out,1,478
26,1,2012,Chicken Cottage,Eating Out,4,474
27,1,2012,Morrisons,Groceries,79,395
27,1,2012,Starbucks Coffee,Eating Out,2,393
27,1,2012,McDonalds,Eating Out,4,389
28,1,2012,The Grand Pub,Eating Out,8,381
28,1,2012,The Grand Pub,Eating Out,6,375
28,1,2012,Paying back James,,5,370
30,1,2012,South West Trains,Transport,37,333
30,1,2012,Chicken Cottage,Eating Out,8,325
30,1,2012,Tool Tec,,1,324
31,1,2012,McDonalds,Eating Out,5,319
31,1,2012,ATM Cash Withdrawal,General,10,309
1,2,2012,Rhino Sports salary,General,1700,2009
1,2,2012,Costa Coffee,Eating Out,2,2007
2,2,2012,The West Cornwall Pasty Company,Eating Out,8,1999
2,2,2012,ATM Cash Withdrawal,General,20,1979
3,2,2012,Waitrose,Groceries,52,1927
3,2,2012,Chicken Cottage,Eating Out,5,1922
4,2,2012,Fabric Club,Eating Out,15,1907
4,2,2012,Fabric Club,Eating Out,12,1895
5,2,2012,Pizza Express,Eating Out,38,1857
6,2,2012,South West Trains,Transport,28,1829
6,2,2012,Caffe Nero,Eating Out,2,1827
6,2,2012,Subway,Eating Out,7,1820
7,2,2012,Cubit and West rent,Rent,550,1270
7,2,2012,Caffe Nero,Eating Out,2,1268
8,2,2012,Costa Coffee,Eating Out,1,1267
8,2,2012,McDonalds,Eating Out,8,1259
9,2,2012,Costa Coffee,Eating Out,2,1257
9,2,2012,McDonalds,Eating Out,4,1253
10,2,2012,ASDA,Groceries,48,1205
10,2,2012,Subway,Eating Out,5,1200
11,2,2012,ATM Cash Withdrawal,General,20,1180
12,2,2012,Anglo restaurant,Eating Out,26,1154
13,2,2012,South West Trains,Transport,32,1122
13,2,2012,Costa Coffee,Eating Out,2,1120
13,2,2012,Red Shop,,5,1115
14,2,2012,Starbucks Coffee,Eating Out,2,1113
14,2,2012,Red Shop,,1,1112
15,2,2012,BRGAS-Electricity,Bills,32,1080
15,2,2012,BRGAS-Gas,Bills,30,1050
15,2,2012,Starbucks Coffee,Eating Out,1,1049
15,2,2012,Chicken Cottage,Eating Out,7,1042
15,2,2012,ATM Cash Withdrawal,General,20,1022
16,2,2012,LBS Council Tax,Bills,50,972
16,2,2012,Wild Bean Cafe,Eating Out,2,970
16,2,2012,Greggs,Eating Out,7,963
16,2,2012,ATM Cash Withdrawal,General,10,953
17,2,2012,Waitrose,Groceries,75,878
17,2,2012,Starbucks Coffee,Eating Out,1,877
17,2,2012,Subway,Eating Out,8,869
17,2,2012,Restaurant Gordon RamsayPortland Restaurant,Eating Out,29,840
18,2,2012,Fabric Club,Eating Out,7,833
18,2,2012,Fabric Club,Eating Out,5,828
18,2,2012,Fabric Club,Eating Out,13,815
18,2,2012,Fabric Club,Eating Out,8,807
18,2,2012,Fabric Club,Eating Out,10,797
18,2,2012,Paying back Julie,,6,791
19,2,2012,Scott's Restaurant,Eating Out,51,740
20,2,2012,VIRGIN MEDIA PYMTS,Bills,50,690
20,2,2012,South West Trains,Transport,33,657
21,2,2012,Starbucks Coffee,Eating Out,2,655
21,2,2012,Subway,Eating Out,5,650
21,2,2012,ATM Cash Withdrawal,General,10,640
22,2,2012,Starbucks Coffee,Eating Out,2,638
22,2,2012,Greggs,Eating Out,7,631
23,2,2012,Wild Bean Cafe,Eating Out,1,630
24,2,2012,O2,Bills,31,599
24,2,2012,Waitrose,Groceries,46,553
24,2,2012,Costa Coffee,Eating Out,2,551
25,2,2012,Fabric Club,Eating Out,12,539
25,2,2012,Fabric Club,Eating Out,8,531
25,2,2012,Fabric Club,Eating Out,7,524
27,2,2012,South West Trains,Transport,30,494
27,2,2012,Wild Bean Cafe,Eating Out,2,492
27,2,2012,The West Cornwall Pasty Company,Eating Out,8,484
27,2,2012,ATM Cash Withdrawal,General,10,474
27,2,2012,Tool Shop,,6,468
28,2,2012,Caffe Nero,Eating Out,2,466
29,2,2012,Costa Coffee,Eating Out,2,464
29,2,2012,Greggs,Eating Out,4,460
1,3,2012,Rhino Sports salary,General,1700,2160
1,3,2012,Wild Bean Cafe,Eating Out,2,2158
1,3,2012,Chicken Cottage,Eating Out,8,2150
2,3,2012,Sainsburys,Groceries,68,2082
2,3,2012,Starbucks Coffee,Eating Out,2,2080
2,3,2012,McDonalds,Eating Out,5,2075
3,3,2012,ATM Cash Withdrawal,General,20,2055
5,3,2012,South West Trains,Transport,34,2021
5,3,2012,Costa Coffee,Eating Out,2,2019
5,3,2012,Pret A Manger,Eating Out,5,2014
6,3,2012,Caffe Nero,Eating Out,2,2012
6,3,2012,Greggs,Eating Out,4,2008
7,3,2012,Cubit and West rent,Rent,550,1458
7,3,2012,Starbucks Coffee,Eating Out,2,1456
7,3,2012,McDonalds,Eating Out,5,1451
7,3,2012,ATM Cash Withdrawal,General,10,1441
8,3,2012,Starbucks Coffee,Eating Out,2,1439
8,3,2012,Paying back James,,5,1434
9,3,2012,Sainsburys,Groceries,59,1375
9,3,2012,Starbucks Coffee,Eating Out,2,1373
11,3,2012,Dominos Pizza,Eating Out,45,1328
11,3,2012,ATM Cash Withdrawal,General,20,1308
12,3,2012,South West Trains,Transport,35,1273
12,3,2012,Greggs,Eating Out,4,1269
14,3,2012,Starbucks Coffee,Eating Out,2,1267
14,3,2012,Greggs,Eating Out,6,1261
15,3,2012,BRGAS-Electricity,Bills,34,1227
15,3,2012,BRGAS-Gas,Bills,31,1196
15,3,2012,Costa Coffee,Eating Out,1,1195
15,3,2012,Paying back James,,2,1193
16,3,2012,LBS Council Tax,Bills,50,1143
16,3,2012,Tescos,Groceries,89,1054
16,3,2012,Starbucks Coffee,Eating Out,2,1052
16,3,2012,Subway,Eating Out,7,1045
16,3,2012,Paying back Julie,,2,1043
17,3,2012,Restaurant Gordon RamsayPortland Restaurant,Eating Out,38,1005
18,3,2012,Cheam Service Station,,6,999
19,3,2012,South West Trains,Transport,29,970
19,3,2012,Costa Coffee,Eating Out,2,968
19,3,2012,Greggs,Eating Out,7,961
20,3,2012,VIRGIN MEDIA PYMTS,Bills,53,908
20,3,2012,Subway,Eating Out,5,903
21,3,2012,Starbucks Coffee,Eating Out,2,901
21,3,2012,ATM Cash Withdrawal,General,10,891
22,3,2012,Wild Bean Cafe,Eating Out,2,889
22,3,2012,Pret A Manger,Eating Out,4,885
22,3,2012,ATM Cash Withdrawal,General,20,865
23,3,2012,Tescos,Groceries,68,797
23,3,2012,Wild Bean Cafe,Eating Out,1,796
23,3,2012,Subway,Eating Out,4,792
23,3,2012,Dominos Pizza,Eating Out,34,758
24,3,2012,O2,Bills,31,727
24,3,2012,Fabric Club,Eating Out,14,713
24,3,2012,Scott's Restaurant,Eating Out,25,688
25,3,2012,Restaurant Gordon RamsayPortland Restaurant,Eating Out,36,652
26,3,2012,South West Trains,Transport,24,628
26,3,2012,Costa Coffee,Eating Out,1,627
26,3,2012,Pret A Manger,Eating Out,8,619
27,3,2012,Starbucks Coffee,Eating Out,2,617
28,3,2012,Starbucks Coffee,Eating Out,2,615
28,3,2012,ATM Cash Withdrawal,General,10,605
29,3,2012,Costa Coffee,Eating Out,2,603
30,3,2012,Morrisons,Groceries,48,555
30,3,2012,Wild Bean Cafe,Eating Out,2,553
30,3,2012,McDonalds,Eating Out,7,546
31,3,2012,Scott's Restaurant,Eating Out,48,498
1,4,2012,Rhino Sports salary,General,1700,2198
1,4,2012,Dominos Pizza,Eating Out,42,2156
2,4,2012,South West Trains,Transport,26,2130
2,4,2012,Caffe Nero,Eating Out,2,2128
2,4,2012,Pret A Manger,Eating Out,8,2120
3,4,2012,Caffe Nero,Eating Out,2,2118
4,4,2012,Costa Coffee,Eating Out,1,2117
4,4,2012,Subway,Eating Out,6,2111
5,4,2012,Caffe Nero,Eating Out,2,2109
6,4,2012,Sainsburys,Groceries,66,2043
6,4,2012,Starbucks Coffee,Eating Out,2,2041
6,4,2012,Pret A Manger,Eating Out,7,2034
6,4,2012,Tool Shop,,9,2025
7,4,2012,Cubit and West rent,Rent,550,1475
7,4,2012,ATM Cash Withdrawal,General,20,1455
9,4,2012,South West Trains,Transport,36,1419
9,4,2012,Starbucks Coffee,Eating Out,1,1418
9,4,2012,Chicken Cottage,Eating Out,8,1410
9,4,2012,Paying back James,,9,1401
10,4,2012,Starbucks Coffee,Eating Out,2,1399
10,4,2012,Chicken Cottage,Eating Out,5,1394
10,4,2012,ATM Cash Withdrawal,General,20,1374
11,4,2012,McDonalds,Eating Out,6,1368
12,4,2012,Wild Bean Cafe,Eating Out,2,1366
12,4,2012,Subway,Eating Out,7,1359
13,4,2012,ASDA,Groceries,66,1293
13,4,2012,Greggs,Eating Out,5,1288
14,4,2012,Dominos Pizza,Eating Out,52,1236
15,4,2012,BRGAS-Electricity,Bills,22,1214
15,4,2012,BRGAS-Gas,Bills,43,1171
16,4,2012,LBS Council Tax,Bills,50,1121
16,4,2012,South West Trains,Transport,24,1097
16,4,2012,Caffe Nero,Eating Out,2,1095
16,4,2012,Pret A Manger,Eating Out,7,1088
17,4,2012,Starbucks Coffee,Eating Out,1,1087
17,4,2012,Pret A Manger,Eating Out,7,1080
18,4,2012,Starbucks Coffee,Eating Out,1,1079
18,4,2012,ATM Cash Withdrawal,General,10,1069
19,4,2012,Costa Coffee,Eating Out,2,1067
20,4,2012,VIRGIN MEDIA PYMTS,Bills,36,1031
20,4,2012,Waitrose,Groceries,72,959
20,4,2012,Pret A Manger,Eating Out,7,952
20,4,2012,Restaurant Gordon RamsayPortland Restaurant,Eating Out,42,910
21,4,2012,Anglo restaurant,Eating Out,32,878
21,4,2012,Red Shop,,3,875
23,4,2012,South West Trains,Transport,34,841
24,4,2012,O2,Bills,36,805
24,4,2012,McDonalds,Eating Out,8,797
24,4,2012,ATM Cash Withdrawal,General,20,777
25,4,2012,Costa Coffee,Eating Out,2,775
25,4,2012,ATM Cash Withdrawal,General,20,755
26,4,2012,Caffe Nero,Eating Out,1,754
26,4,2012,Pret A Manger,Eating Out,6,748
26,4,2012,ATM Cash Withdrawal,General,10,738
27,4,2012,Morrisons,Groceries,74,664
27,4,2012,Starbucks Coffee,Eating Out,1,663
27,4,2012,Chicken Cottage,Eating Out,6,657
27,4,2012,Ministry of Sound ClubXOYO Club,Eating Out,12,645
27,4,2012,Ministry of Sound ClubXOYO Club,Eating Out,9,636
27,4,2012,Ministry of Sound ClubXOYO Club,Eating Out,11,625
27,4,2012,Ministry of Sound ClubXOYO Club,Eating Out,11,614
27,4,2012,ATM Cash Withdrawal,General,20,594
27,4,2012,Civic Shop,,1,593
29,4,2012,Dominos Pizza,Eating Out,53,540
30,4,2012,South West Trains,Transport,25,515
30,4,2012,Costa Coffee,Eating Out,2,513
30,4,2012,Paying back Julie,,2,511
1,5,2012,Rhino Sports salary,General,1700,2211
1,5,2012,Costa Coffee,Eating Out,2,2209
1,5,2012,The West Cornwall Pasty Company,Eating Out,4,2205
2,5,2012,Caffe Nero,Eating Out,2,2203
2,5,2012,ATM Cash Withdrawal,General,20,2183
3,5,2012,Chicken Cottage,Eating Out,8,2175
4,5,2012,Sainsburys,Groceries,60,2115
4,5,2012,Starbucks Coffee,Eating Out,2,2113
4,5,2012,McDonalds,Eating Out,6,2107
4,5,2012,Scott's Restaurant,Eating Out,39,2068
5,5,2012,The Grand Pub,Eating Out,6,2062
5,5,2012,The Grand Pub,Eating Out,11,2051
5,5,2012,Anglo restaurant,Eating Out,44,2007
5,5,2012,Cheam Service Station,,9,1998
7,5,2012,Cubit and West rent,Rent,550,1448
7,5,2012,South West Trains,Transport,28,1420
7,5,2012,Starbucks Coffee,Eating Out,2,1418
7,5,2012,McDonalds,Eating Out,5,1413
8,5,2012,ATM Cash Withdrawal,General,10,1403
9,5,2012,Wild Bean Cafe,Eating Out,2,1401
10,5,2012,Wild Bean Cafe,Eating Out,2,1399
10,5,2012,The West Cornwall Pasty Company,Eating Out,7,1392
10,5,2012,Cheam Service Station,,6,1386
11,5,2012,Sainsburys,Groceries,63,1323
11,5,2012,Heaven Club,Eating Out,5,1318
11,5,2012,Heaven Club,Eating Out,6,1312
11,5,2012,Heaven Club,Eating Out,6,1306
11,5,2012,Heaven Club,Eating Out,7,1299
11,5,2012,Pizza Express,Eating Out,50,1249
13,5,2012,Restaurant Gordon RamsayPortland Restaurant,Eating Out,59,1190
13,5,2012,Paying back James,,8,1182
14,5,2012,South West Trains,Transport,31,1151
14,5,2012,Costa Coffee,Eating Out,2,1149
15,5,2012,BRGAS-Electricity,Bills,36,1113
15,5,2012,BRGAS-Gas,Bills,31,1082
15,5,2012,Wild Bean Cafe,Eating Out,2,1080
15,5,2012,McDonalds,Eating Out,8,1072
15,5,2012,ATM Cash Withdrawal,General,20,1052
15,5,2012,Paying back James,,4,1048
16,5,2012,LBS Council Tax,Bills,50,998
16,5,2012,Caffe Nero,Eating Out,1,997
16,5,2012,The West Cornwall Pasty Company,Eating Out,8,989
16,5,2012,ATM Cash Withdrawal,General,10,979
17,5,2012,Wild Bean Cafe,Eating Out,2,977
17,5,2012,ATM Cash Withdrawal,General,10,967
18,5,2012,Sainsburys,Groceries,59,908
18,5,2012,Starbucks Coffee,Eating Out,1,907
18,5,2012,Chicken Cottage,Eating Out,8,899
19,5,2012,Paying back Julie,,1,898
20,5,2012,VIRGIN MEDIA PYMTS,Bills,39,859
20,5,2012,Tool Tec,,4,855
21,5,2012,South West Trains,Transport,38,817
21,5,2012,Caffe Nero,Eating Out,2,815
21,5,2012,McDonalds,Eating Out,8,807
22,5,2012,Costa Coffee,Eating Out,2,805
23,5,2012,Wild Bean Cafe,Eating Out,2,803
23,5,2012,Pret A Manger,Eating Out,7,796
24,5,2012,O2,Bills,38,758
24,5,2012,Wild Bean Cafe,Eating Out,2,756
24,5,2012,Greggs,Eating Out,6,750
25,5,2012,Morrisons,Groceries,55,695
25,5,2012,Caffe Nero,Eating Out,2,693
25,5,2012,The West Cornwall Pasty Company,Eating Out,7,686
25,5,2012,Ministry of Sound ClubXOYO Club,Eating Out,10,676
25,5,2012,Ministry of Sound ClubXOYO Club,Eating Out,6,670
25,5,2012,Ministry of Sound ClubXOYO Club,Eating Out,12,658
25,5,2012,Ministry of Sound ClubXOYO Club,Eating Out,11,647
25,5,2012,Ministry of Sound ClubXOYO Club,Eating Out,16,631
25,5,2012,Ministry of Sound ClubXOYO Club,Eating Out,6,625
25,5,2012,Pizza Express,Eating Out,25,600
26,5,2012,Restaurant Gordon RamsayPortland Restaurant,Eating Out,47,553
28,5,2012,South West Trains,Transport,30,523
28,5,2012,Greggs,Eating Out,8,515
29,5,2012,Caffe Nero,Eating Out,1,514
29,5,2012,Chicken Cottage,Eating Out,8,506
30,5,2012,Starbucks Coffee,Eating Out,1,505
30,5,2012,Pret A Manger,Eating Out,5,500
31,5,2012,Costa Coffee,Eating Out,1,499
31,5,2012,Greggs,Eating Out,4,495
1,6,2012,Rhino Sports salary,General,1700,2195
1,6,2012,Morrisons,Groceries,85,2110
1,6,2012,Caffe Nero,Eating Out,2,2108
1,6,2012,Greggs,Eating Out,4,2104
1,6,2012,Fabric Club,Eating Out,13,2091
1,6,2012,ATM Cash Withdrawal,General,20,2071
3,6,2012,Dominos Pizza,Eating Out,35,2036
3,6,2012,ATM Cash Withdrawal,General,10,2026
3,6,2012,Paying back Julie,,6,2020
4,6,2012,South West Trains,Transport,34,1986
4,6,2012,Caffe Nero,Eating Out,2,1984
4,6,2012,Pret A Manger,Eating Out,4,1980
5,6,2012,Costa Coffee,Eating Out,2,1978
5,6,2012,Red Shop,,7,1971
6,6,2012,Starbucks Coffee,Eating Out,1,1970
6,6,2012,Pret A Manger,Eating Out,8,1962
7,6,2012,Cubit and West rent,Rent,550,1412
7,6,2012,Costa Coffee,Eating Out,2,1410
7,6,2012,Greggs,Eating Out,5,1405
8,6,2012,Waitrose,Groceries,43,1362
8,6,2012,Starbucks Coffee,Eating Out,1,1361
8,6,2012,Chicken Cottage,Eating Out,7,1354
10,6,2012,ATM Cash Withdrawal,General,10,1344
11,6,2012,South West Trains,Transport,33,1311
11,6,2012,Costa Coffee,Eating Out,1,1310
12,6,2012,Wild Bean Cafe,Eating Out,1,1309
13,6,2012,Caffe Nero,Eating Out,1,1308
13,6,2012,Subway,Eating Out,4,1304
13,6,2012,Red Shop,,7,1297
14,6,2012,Starbucks Coffee,Eating Out,2,1295
14,6,2012,Subway,Eating Out,4,1291
15,6,2012,BRGAS-Electricity,Bills,35,1256
15,6,2012,BRGAS-Gas,Bills,23,1233
15,6,2012,ASDA,Groceries,84,1149
15,6,2012,ATM Cash Withdrawal,General,20,1129
16,6,2012,LBS Council Tax,Bills,50,1079
16,6,2012,Restaurant Gordon RamsayPortland Restaurant,Eating Out,29,1050
18,6,2012,South West Trains,Transport,36,1014
18,6,2012,Wild Bean Cafe,Eating Out,2,1012
18,6,2012,ATM Cash Withdrawal,General,10,1002
19,6,2012,Caffe Nero,Eating Out,2,1000
20,6,2012,VIRGIN MEDIA PYMTS,Bills,56,944
20,6,2012,Wild Bean Cafe,Eating Out,1,943
21,6,2012,Caffe Nero,Eating Out,2,941
22,6,2012,Waitrose,Groceries,45,896
22,6,2012,Wild Bean Cafe,Eating Out,2,894
23,6,2012,ATM Cash Withdrawal,General,20,874
24,6,2012,O2,Bills,32,842
24,6,2012,Anglo restaurant,Eating Out,51,791
25,6,2012,South West Trains,Transport,36,755
25,6,2012,Caffe Nero,Eating Out,2,753
25,6,2012,McDonalds,Eating Out,6,747
26,6,2012,Wild Bean Cafe,Eating Out,2,745
26,6,2012,McDonalds,Eating Out,7,738
26,6,2012,ATM Cash Withdrawal,General,10,728
27,6,2012,Wild Bean Cafe,Eating Out,2,726
27,6,2012,The West Cornwall Pasty Company,Eating Out,5,721
28,6,2012,Caffe Nero,Eating Out,2,719
28,6,2012,The West Cornwall Pasty Company,Eating Out,8,711
29,6,2012,Waitrose,Groceries,42,669
29,6,2012,Wild Bean Cafe,Eating Out,1,668
29,6,2012,Pret A Manger,Eating Out,7,661
29,6,2012,Ministry of Sound ClubXOYO Club,Eating Out,15,646
29,6,2012,Ministry of Sound ClubXOYO Club,Eating Out,7,639
29,6,2012,Ministry of Sound ClubXOYO Club,Eating Out,15,624
29,6,2012,ATM Cash Withdrawal,General,20,604
1,7,2012,Rhino Sports salary,General,1700,2304
1,7,2012,Restaurant Gordon RamsayPortland Restaurant,Eating Out,30,2274
2,7,2012,South West Trains,Transport,33,2241
2,7,2012,Wild Bean Cafe,Eating Out,2,2239
2,7,2012,Chicken Cottage,Eating Out,5,2234
3,7,2012,Costa Coffee,Eating Out,1,2233
4,7,2012,Starbucks Coffee,Eating Out,2,2231
4,7,2012,Subway,Eating Out,7,2224
4,7,2012,ATM Cash Withdrawal,General,20,2204
5,7,2012,Wild Bean Cafe,Eating Out,2,2202
5,7,2012,Subway,Eating Out,5,2197
5,7,2012,ATM Cash Withdrawal,General,20,2177
6,7,2012,Waitrose,Groceries,71,2106
6,7,2012,Starbucks Coffee,Eating Out,2,2104
6,7,2012,The West Cornwall Pasty Company,Eating Out,4,2100
7,7,2012,Cubit and West rent,Rent,550,1550
7,7,2012,Pizza Express,Eating Out,25,1525
7,7,2012,ATM Cash Withdrawal,General,20,1505
9,7,2012,South West Trains,Transport,25,1480
9,7,2012,Wild Bean Cafe,Eating Out,2,1478
9,7,2012,Chicken Cottage,Eating Out,8,1470
10,7,2012,Subway,Eating Out,4,1466
10,7,2012,ATM Cash Withdrawal,General,20,1446
11,7,2012,Costa Coffee,Eating Out,2,1444
11,7,2012,Tool Shop,,4,1440
12,7,2012,Wild Bean Cafe,Eating Out,2,1438
13,7,2012,Morrisons,Groceries,80,1358
13,7,2012,Starbucks Coffee,Eating Out,2,1356
13,7,2012,McDonalds,Eating Out,6,1350
14,7,2012,Dominos Pizza,Eating Out,29,1321
14,7,2012,ATM Cash Withdrawal,General,20,1301
15,7,2012,BRGAS-Electricity,Bills,31,1270
15,7,2012,BRGAS-Gas,Bills,28,1242
15,7,2012,Anglo restaurant,Eating Out,36,1206
15,7,2012,ATM Cash Withdrawal,General,20,1186
16,7,2012,LBS Council Tax,Bills,50,1136
16,7,2012,South West Trains,Transport,37,1099
16,7,2012,Wild Bean Cafe,Eating Out,1,1098
16,7,2012,Pret A Manger,Eating Out,6,1092
17,7,2012,Caffe Nero,Eating Out,2,1090
17,7,2012,Pret A Manger,Eating Out,8,1082
17,7,2012,ATM Cash Withdrawal,General,20,1062
19,7,2012,Starbucks Coffee,Eating Out,2,1060
19,7,2012,ATM Cash Withdrawal,General,20,1040
20,7,2012,VIRGIN MEDIA PYMTS,Bills,50,990
20,7,2012,Sainsburys,Groceries,74,916
20,7,2012,Caffe Nero,Eating Out,1,915
20,7,2012,Pret A Manger,Eating Out,6,909
20,7,2012,ATM Cash Withdrawal,General,10,899
20,7,2012,Paying back Julie,,4,895
21,7,2012,Scott's Restaurant,Eating Out,49,846
22,7,2012,Scott's Restaurant,Eating Out,55,791
23,7,2012,South West Trains,Transport,36,755
23,7,2012,Starbucks Coffee,Eating Out,2,753
23,7,2012,Subway,Eating Out,8,745
23,7,2012,ATM Cash Withdrawal,General,20,725
24,7,2012,O2,Bills,36,689
24,7,2012,Costa Coffee,Eating Out,1,688
24,7,2012,The West Cornwall Pasty Company,Eating Out,7,681
25,7,2012,Caffe Nero,Eating Out,2,679
25,7,2012,McDonalds,Eating Out,7,672
26,7,2012,Starbucks Coffee,Eating Out,2,670
26,7,2012,Pret A Manger,Eating Out,8,662
27,7,2012,ASDA,Groceries,61,601
27,7,2012,Caffe Nero,Eating Out,2,599
27,7,2012,McDonalds,Eating Out,5,594
27,7,2012,The Grand Pub,Eating Out,5,589
27,7,2012,The Grand Pub,Eating Out,14,575
27,7,2012,The Grand Pub,Eating Out,12,563
29,7,2012,Anglo restaurant,Eating Out,29,534
29,7,2012,ATM Cash Withdrawal,General,10,524
30,7,2012,South West Trains,Transport,26,498
30,7,2012,Wild Bean Cafe,Eating Out,2,496
30,7,2012,ATM Cash Withdrawal,General,10,486
31,7,2012,Wild Bean Cafe,Eating Out,1,485
31,7,2012,ATM Cash Withdrawal,General,10,475
1,8,2012,Rhino Sports salary,General,1700,2175
1,8,2012,Starbucks Coffee,Eating Out,1,2174
1,8,2012,Greggs,Eating Out,5,2169
1,8,2012,Paying back James,,1,2168
2,8,2012,Costa Coffee,Eating Out,1,2167
2,8,2012,Subway,Eating Out,5,2162
2,8,2012,ATM Cash Withdrawal,General,20,2142
3,8,2012,Morrisons,Groceries,59,2083
3,8,2012,Caffe Nero,Eating Out,2,2081
3,8,2012,The West Cornwall Pasty Company,Eating Out,8,2073
3,8,2012,Restaurant Gordon RamsayPortland Restaurant,Eating Out,26,2047
4,8,2012,ATM Cash Withdrawal,General,20,2027
5,8,2012,Pizza Express,Eating Out,28,1999
5,8,2012,ATM Cash Withdrawal,General,20,1979
6,8,2012,South West Trains,Transport,27,1952
6,8,2012,Caffe Nero,Eating Out,1,1951
6,8,2012,Subway,Eating Out,8,1943
6,8,2012,ATM Cash Withdrawal,General,20,1923
7,8,2012,Cubit and West rent,Rent,550,1373
7,8,2012,Greggs,Eating Out,6,1367
8,8,2012,Caffe Nero,Eating Out,1,1366
8,8,2012,ATM Cash Withdrawal,General,10,1356
9,8,2012,Costa Coffee,Eating Out,2,1354
9,8,2012,McDonalds,Eating Out,7,1347
9,8,2012,ATM Cash Withdrawal,General,20,1327
10,8,2012,Waitrose,Groceries,46,1281
10,8,2012,Caffe Nero,Eating Out,1,1280
10,8,2012,Anglo restaurant,Eating Out,27,1253
10,8,2012,Paying back Julie,,5,1248
11,8,2012,Dominos Pizza,Eating Out,59,1189
13,8,2012,South West Trains,Transport,25,1164
13,8,2012,Costa Coffee,Eating Out,1,1163
13,8,2012,Chicken Cottage,Eating Out,5,1158
13,8,2012,ATM Cash Withdrawal,General,20,1138
14,8,2012,Costa Coffee,Eating Out,1,1137
14,8,2012,Chicken Cottage,Eating Out,4,1133
15,8,2012,BRGAS-Electricity,Bills,42,1091
15,8,2012,BRGAS-Gas,Bills,41,1050
15,8,2012,Starbucks Coffee,Eating Out,2,1048
15,8,2012,Pret A Manger,Eating Out,4,1044
15,8,2012,ATM Cash Withdrawal,General,10,1034
16,8,2012,LBS Council Tax,Bills,50,984
16,8,2012,Wild Bean Cafe,Eating Out,2,982
17,8,2012,Waitrose,Groceries,81,901
17,8,2012,Wild Bean Cafe,Eating Out,1,900
17,8,2012,Chicken Cottage,Eating Out,8,892
17,8,2012,ATM Cash Withdrawal,General,10,882
17,8,2012,Cheam Service Station,,5,877
18,8,2012,ATM Cash Withdrawal,General,20,857
20,8,2012,VIRGIN MEDIA PYMTS,Bills,53,804
20,8,2012,South West Trains,Transport,25,779
20,8,2012,Caffe Nero,Eating Out,1,778
21,8,2012,ATM Cash Withdrawal,General,10,768
22,8,2012,Caffe Nero,Eating Out,1,767
22,8,2012,Greggs,Eating Out,8,759
23,8,2012,Starbucks Coffee,Eating Out,2,757
23,8,2012,Pret A Manger,Eating Out,8,749
23,8,2012,ATM Cash Withdrawal,General,10,739
23,8,2012,Civic Shop,,2,737
24,8,2012,O2,Bills,33,704
24,8,2012,ASDA,Groceries,49,655
26,8,2012,Red Shop,,4,651
27,8,2012,South West Trains,Transport,25,626
27,8,2012,Starbucks Coffee,Eating Out,2,624
28,8,2012,Costa Coffee,Eating Out,1,623
28,8,2012,Subway,Eating Out,5,618
29,8,2012,Wild Bean Cafe,Eating Out,2,616
31,8,2012,Morrisons,Groceries,79,537
31,8,2012,Caffe Nero,Eating Out,2,535
31,8,2012,McDonalds,Eating Out,6,529
1,9,2012,Rhino Sports salary,General,1700,2229
1,9,2012,ATM Cash Withdrawal,General,10,2219
3,9,2012,South West Trains,Transport,28,2191
3,9,2012,Caffe Nero,Eating Out,1,2190
4,9,2012,Starbucks Coffee,Eating Out,1,2189
4,9,2012,The West Cornwall Pasty Company,Eating Out,8,2181
4,9,2012,ATM Cash Withdrawal,General,20,2161
5,9,2012,Costa Coffee,Eating Out,1,2160
5,9,2012,Subway,Eating Out,4,2156
6,9,2012,Pret A Manger,Eating Out,5,2151
7,9,2012,Cubit and West rent,Rent,550,1601
7,9,2012,Morrisons,Groceries,77,1524
7,9,2012,Costa Coffee,Eating Out,2,1522
7,9,2012,Greggs,Eating Out,8,1514
8,9,2012,ATM Cash Withdrawal,General,10,1504
10,9,2012,South West Trains,Transport,29,1475
10,9,2012,Caffe Nero,Eating Out,2,1473
10,9,2012,Subway,Eating Out,7,1466
11,9,2012,Caffe Nero,Eating Out,1,1465
12,9,2012,Starbucks Coffee,Eating Out,2,1463
12,9,2012,ATM Cash Withdrawal,General,20,1443
13,9,2012,Costa Coffee,Eating Out,1,1442
13,9,2012,The West Cornwall Pasty Company,Eating Out,7,1435
14,9,2012,Sainsburys,Groceries,43,1392
14,9,2012,Wild Bean Cafe,Eating Out,2,1390
14,9,2012,Restaurant Gordon RamsayPortland Restaurant,Eating Out,56,1334
14,9,2012,Cheam Service Station,,3,1331
15,9,2012,BRGAS-Electricity,Bills,27,1304
15,9,2012,BRGAS-Gas,Bills,44,1260
15,9,2012,Heaven Club,Eating Out,8,1252
15,9,2012,Heaven Club,Eating Out,8,1244
15,9,2012,Heaven Club,Eating Out,12,1232
15,9,2012,Heaven Club,Eating Out,12,1220
15,9,2012,Heaven Club,Eating Out,6,1214
15,9,2012,Heaven Club,Eating Out,6,1208
15,9,2012,Restaurant Gordon RamsayPortland Restaurant,Eating Out,46,1162
15,9,2012,ATM Cash Withdrawal,General,20,1142
16,9,2012,LBS Council Tax,Bills,50,1092
16,9,2012,ATM Cash Withdrawal,General,10,1082
17,9,2012,South West Trains,Transport,33,1049
17,9,2012,Costa Coffee,Eating Out,1,1048
18,9,2012,Costa Coffee,Eating Out,1,1047
18,9,2012,Chicken Cottage,Eating Out,4,1043
19,9,2012,Costa Coffee,Eating Out,1,1042
19,9,2012,Greggs,Eating Out,4,1038
20,9,2012,VIRGIN MEDIA PYMTS,Bills,37,1001
20,9,2012,Costa Coffee,Eating Out,2,999
20,9,2012,Chicken Cottage,Eating Out,5,994
21,9,2012,Tescos,Groceries,66,928
21,9,2012,Pret A Manger,Eating Out,5,923
21,9,2012,Paying back Julie,,5,918
22,9,2012,Pizza Express,Eating Out,26,892
22,9,2012,ATM Cash Withdrawal,General,10,882
23,9,2012,ATM Cash Withdrawal,General,20,862
24,9,2012,O2,Bills,37,825
24,9,2012,South West Trains,Transport,36,789
24,9,2012,Pret A Manger,Eating Out,4,785
26,9,2012,Starbucks Coffee,Eating Out,1,784
27,9,2012,The West Cornwall Pasty Company,Eating Out,8,776
28,9,2012,Morrisons,Groceries,86,690
28,9,2012,Wild Bean Cafe,Eating Out,2,688
28,9,2012,Chicken Cottage,Eating Out,7,681
29,9,2012,ATM Cash Withdrawal,General,20,661
30,9,2012,Restaurant Gordon RamsayPortland Restaurant,Eating Out,24,637
1,10,2012,Rhino Sports salary,General,1700,2337
1,10,2012,South West Trains,Transport,24,2313
1,10,2012,Pret A Manger,Eating Out,4,2309
1,10,2012,ATM Cash Withdrawal,General,10,2299
2,10,2012,Starbucks Coffee,Eating Out,1,2298
2,10,2012,Subway,Eating Out,8,2290
3,10,2012,Starbucks Coffee,Eating Out,2,2288
3,10,2012,Civic Shop,,6,2282
4,10,2012,Starbucks Coffee,Eating Out,2,2280
4,10,2012,The West Cornwall Pasty Company,Eating Out,4,2276
4,10,2012,ATM Cash Withdrawal,General,10,2266
5,10,2012,Tescos,Groceries,75,2191
5,10,2012,Caffe Nero,Eating Out,1,2190
5,10,2012,McDonalds,Eating Out,8,2182
5,10,2012,Anglo restaurant,Eating Out,56,2126
5,10,2012,ATM Cash Withdrawal,General,10,2116
6,10,2012,Anglo restaurant,Eating Out,29,2087
7,10,2012,Cubit and West rent,Rent,550,1537
7,10,2012,ATM Cash Withdrawal,General,10,1527
8,10,2012,South West Trains,Transport,29,1498
8,10,2012,The West Cornwall Pasty Company,Eating Out,4,1494
9,10,2012,ATM Cash Withdrawal,General,10,1484
10,10,2012,Costa Coffee,Eating Out,2,1482
10,10,2012,McDonalds,Eating Out,4,1478
10,10,2012,Paying back James,,3,1475
11,10,2012,Starbucks Coffee,Eating Out,1,1474
12,10,2012,Tescos,Groceries,83,1391
12,10,2012,Wild Bean Cafe,Eating Out,2,1389
12,10,2012,Greggs,Eating Out,5,1384
12,10,2012,ATM Cash Withdrawal,General,10,1374
13,10,2012,ATM Cash Withdrawal,General,10,1364
13,10,2012,Paying back Julie,,7,1357
15,10,2012,BRGAS-Electricity,Bills,44,1313
15,10,2012,BRGAS-Gas,Bills,40,1273
15,10,2012,South West Trains,Transport,36,1237
15,10,2012,Wild Bean Cafe,Eating Out,1,1236
15,10,2012,Pret A Manger,Eating Out,6,1230
16,10,2012,LBS Council Tax,Bills,50,1180
16,10,2012,Starbucks Coffee,Eating Out,2,1178
16,10,2012,Chicken Cottage,Eating Out,7,1171
16,10,2012,ATM Cash Withdrawal,General,10,1161
17,10,2012,Caffe Nero,Eating Out,1,1160
17,10,2012,Greggs,Eating Out,6,1154
17,10,2012,ATM Cash Withdrawal,General,20,1134
18,10,2012,Wild Bean Cafe,Eating Out,2,1132
18,10,2012,The West Cornwall Pasty Company,Eating Out,6,1126
19,10,2012,Morrisons,Groceries,78,1048
19,10,2012,Heaven Club,Eating Out,12,1036
19,10,2012,Heaven Club,Eating Out,14,1022
19,10,2012,Heaven Club,Eating Out,14,1008
19,10,2012,ATM Cash Withdrawal,General,20,988
20,10,2012,VIRGIN MEDIA PYMTS,Bills,57,931
21,10,2012,Dominos Pizza,Eating Out,28,903
22,10,2012,South West Trains,Transport,31,872
22,10,2012,McDonalds,Eating Out,5,867
23,10,2012,Wild Bean Cafe,Eating Out,1,866
23,10,2012,The West Cornwall Pasty Company,Eating Out,6,860
24,10,2012,O2,Bills,36,824
24,10,2012,Costa Coffee,Eating Out,1,823
24,10,2012,Pret A Manger,Eating Out,4,819
24,10,2012,ATM Cash Withdrawal,General,10,809
25,10,2012,Starbucks Coffee,Eating Out,2,807
25,10,2012,Tool Shop,,5,802
26,10,2012,Sainsburys,Groceries,45,757
26,10,2012,Caffe Nero,Eating Out,1,756
26,10,2012,Pret A Manger,Eating Out,8,748
26,10,2012,Pizza Express,Eating Out,47,701
27,10,2012,ATM Cash Withdrawal,General,10,691
28,10,2012,Scott's Restaurant,Eating Out,51,640
28,10,2012,ATM Cash Withdrawal,General,20,620
29,10,2012,South West Trains,Transport,31,589
29,10,2012,Starbucks Coffee,Eating Out,1,588
29,10,2012,ATM Cash Withdrawal,General,20,568
30,10,2012,Costa Coffee,Eating Out,2,566
31,10,2012,Greggs,Eating Out,8,558
1,11,2012,Rhino Sports salary,General,1700,2258
1,11,2012,Caffe Nero,Eating Out,2,2256
1,11,2012,Greggs,Eating Out,6,2250
1,11,2012,Tool Shop,,2,2248
2,11,2012,Tescos,Groceries,60,2188
2,11,2012,Starbucks Coffee,Eating Out,1,2187
2,11,2012,Greggs,Eating Out,7,2180
3,11,2012,Ministry of Sound ClubXOYO Club,Eating Out,14,2166
3,11,2012,Ministry of Sound ClubXOYO Club,Eating Out,15,2151
3,11,2012,Ministry of Sound ClubXOYO Club,Eating Out,7,2144
3,11,2012,Ministry of Sound ClubXOYO Club,Eating Out,13,2131
3,11,2012,ATM Cash Withdrawal,General,10,2121
5,11,2012,South West Trains,Transport,31,2090
5,11,2012,Starbucks Coffee,Eating Out,2,2088
5,11,2012,Subway,Eating Out,4,2084
6,11,2012,Costa Coffee,Eating Out,2,2082
6,11,2012,Subway,Eating Out,8,2074
7,11,2012,Cubit and West rent,Rent,550,1524
7,11,2012,Starbucks Coffee,Eating Out,2,1522
7,11,2012,ATM Cash Withdrawal,General,10,1512
8,11,2012,Wild Bean Cafe,Eating Out,2,1510
8,11,2012,McDonalds,Eating Out,7,1503
9,11,2012,Waitrose,Groceries,78,1425
9,11,2012,Wild Bean Cafe,Eating Out,1,1424
9,11,2012,Pret A Manger,Eating Out,6,1418
9,11,2012,Pizza Express,Eating Out,38,1380
10,11,2012,Anglo restaurant,Eating Out,30,1350
10,11,2012,Paying back Julie,,3,1347
11,11,2012,Dominos Pizza,Eating Out,40,1307
11,11,2012,Civic Shop,,2,1305
12,11,2012,South West Trains,Transport,28,1277
12,11,2012,Caffe Nero,Eating Out,2,1275
12,11,2012,Pret A Manger,Eating Out,8,1267
12,11,2012,ATM Cash Withdrawal,General,10,1257
13,11,2012,Costa Coffee,Eating Out,2,1255
13,11,2012,Subway,Eating Out,6,1249
13,11,2012,ATM Cash Withdrawal,General,20,1229
14,11,2012,Starbucks Coffee,Eating Out,2,1227
14,11,2012,Chicken Cottage,Eating Out,5,1222
14,11,2012,ATM Cash Withdrawal,General,10,1212
15,11,2012,BRGAS-Electricity,Bills,38,1174
15,11,2012,BRGAS-Gas,Bills,43,1131
15,11,2012,Subway,Eating Out,4,1127
15,11,2012,ATM Cash Withdrawal,General,10,1117
16,11,2012,LBS Council Tax,Bills,50,1067
16,11,2012,Waitrose,Groceries,67,1000
16,11,2012,Caffe Nero,Eating Out,1,999
16,11,2012,Subway,Eating Out,4,995
16,11,2012,Fabric Club,Eating Out,9,986
16,11,2012,Fabric Club,Eating Out,6,980
16,11,2012,Fabric Club,Eating Out,8,972
16,11,2012,Fabric Club,Eating Out,16,956
16,11,2012,Fabric Club,Eating Out,14,942
16,11,2012,ATM Cash Withdrawal,General,20,922
17,11,2012,Anglo restaurant,Eating Out,55,867
17,11,2012,ATM Cash Withdrawal,General,20,847
18,11,2012,Restaurant Gordon RamsayPortland Restaurant,Eating Out,31,816
19,11,2012,South West Trains,Transport,34,782
19,11,2012,Caffe Nero,Eating Out,2,780
19,11,2012,Greggs,Eating Out,4,776
20,11,2012,VIRGIN MEDIA PYMTS,Bills,34,742
20,11,2012,Wild Bean Cafe,Eating Out,1,741
20,11,2012,Subway,Eating Out,5,736
20,11,2012,ATM Cash Withdrawal,General,10,726
20,11,2012,Red Shop,,1,725
21,11,2012,Caffe Nero,Eating Out,1,724
22,11,2012,Starbucks Coffee,Eating Out,1,723
23,11,2012,Morrisons,Groceries,48,675
23,11,2012,Caffe Nero,Eating Out,2,673
24,11,2012,O2,Bills,33,640
24,11,2012,Heaven Club,Eating Out,15,625
24,11,2012,Heaven Club,Eating Out,16,609
24,11,2012,Heaven Club,Eating Out,12,597
24,11,2012,Heaven Club,Eating Out,5,592
24,11,2012,Heaven Club,Eating Out,12,580
24,11,2012,Heaven Club,Eating Out,14,566
24,11,2012,Restaurant Gordon RamsayPortland Restaurant,Eating Out,35,531
24,11,2012,Red Shop,,4,527
25,11,2012,Scott's Restaurant,Eating Out,57,470
25,11,2012,ATM Cash Withdrawal,General,20,450
26,11,2012,South West Trains,Transport,26,424
26,11,2012,Starbucks Coffee,Eating Out,2,422
26,11,2012,Greggs,Eating Out,5,417
26,11,2012,ATM Cash Withdrawal,General,20,397
26,11,2012,Civic Shop,,3,394
27,11,2012,Caffe Nero,Eating Out,2,392
27,11,2012,Pret A Manger,Eating Out,6,386
27,11,2012,Paying back Julie,,4,382
28,11,2012,Costa Coffee,Eating Out,2,380
28,11,2012,Greggs,Eating Out,6,374
30,11,2012,ASDA,Groceries,79,295
30,11,2012,Chicken Cottage,Eating Out,7,288
30,11,2012,The Grand Pub,Eating Out,11,277
30,11,2012,The Grand Pub,Eating Out,7,270
30,11,2012,The Grand Pub,Eating Out,9,261
30,11,2012,ATM Cash Withdrawal,General,20,241
1,12,2012,Rhino Sports salary,General,1700,1941
1,12,2012,Anglo restaurant,Eating Out,36,1905
1,12,2012,ATM Cash Withdrawal,General,20,1885
2,12,2012,Pizza Express,Eating Out,55,1830
3,12,2012,South West Trains,Transport,29,1801
3,12,2012,Starbucks Coffee,Eating Out,1,1800
4,12,2012,Caffe Nero,Eating Out,1,1799
4,12,2012,ATM Cash Withdrawal,General,20,1779
6,12,2012,Wild Bean Cafe,Eating Out,2,1777
6,12,2012,Greggs,Eating Out,8,1769
7,12,2012,Cubit and West rent,Rent,550,1219
7,12,2012,ASDA,Groceries,81,1138
7,12,2012,Starbucks Coffee,Eating Out,2,1136
7,12,2012,Pret A Manger,Eating Out,4,1132
7,12,2012,Pizza Express,Eating Out,48,1084
8,12,2012,Ministry of Sound ClubXOYO Club,Eating Out,10,1074
8,12,2012,ATM Cash Withdrawal,General,20,1054
9,12,2012,ATM Cash Withdrawal,General,20,1034
10,12,2012,South West Trains,Transport,28,1006
10,12,2012,Wild Bean Cafe,Eating Out,1,1005
11,12,2012,Wild Bean Cafe,Eating Out,2,1003
11,12,2012,Pret A Manger,Eating Out,6,997
11,12,2012,ATM Cash Withdrawal,General,10,987
12,12,2012,Costa Coffee,Eating Out,2,985
12,12,2012,ATM Cash Withdrawal,General,20,965
13,12,2012,Wild Bean Cafe,Eating Out,2,963
13,12,2012,Chicken Cottage,Eating Out,8,955
13,12,2012,ATM Cash Withdrawal,General,10,945
14,12,2012,Tescos,Groceries,87,858
14,12,2012,Costa Coffee,Eating Out,1,857
15,12,2012,BRGAS-Electricity,Bills,26,831
15,12,2012,BRGAS-Gas,Bills,29,802
15,12,2012,ATM Cash Withdrawal,General,20,782
15,12,2012,Tool Tec,,6,776
16,12,2012,LBS Council Tax,Bills,50,726
16,12,2012,Pizza Express,Eating Out,38,688
16,12,2012,ATM Cash Withdrawal,General,10,678
17,12,2012,South West Trains,Transport,31,647
18,12,2012,Starbucks Coffee,Eating Out,1,646
18,12,2012,Subway,Eating Out,6,640
18,12,2012,ATM Cash Withdrawal,General,10,630
19,12,2012,Caffe Nero,Eating Out,2,628
19,12,2012,The West Cornwall Pasty Company,Eating Out,7,621
20,12,2012,VIRGIN MEDIA PYMTS,Bills,48,573
20,12,2012,Costa Coffee,Eating Out,2,571
20,12,2012,Greggs,Eating Out,8,563
21,12,2012,Tescos,Groceries,66,497
21,12,2012,Wild Bean Cafe,Eating Out,2,495
23,12,2012,Cheam Service Station,,3,492
24,12,2012,O2,Bills,34,458
24,12,2012,South West Trains,Transport,26,432
24,12,2012,Wild Bean Cafe,Eating Out,1,431
24,12,2012,ATM Cash Withdrawal,General,20,411
25,12,2012,Caffe Nero,Eating Out,1,410
25,12,2012,Greggs,Eating Out,4,406
25,12,2012,ATM Cash Withdrawal,General,10,396
26,12,2012,Subway,Eating Out,6,390
26,12,2012,Cheam Service Station,,2,388
27,12,2012,Costa Coffee,Eating Out,1,387
28,12,2012,Sainsburys,Groceries,65,322
28,12,2012,Wild Bean Cafe,Eating Out,2,320
28,12,2012,McDonalds,Eating Out,7,313
29,12,2012,Scott's Restaurant,Eating Out,51,262
30,12,2012,ATM Cash Withdrawal,General,10,252
30,12,2012,Tool Tec,,2,250
31,12,2012,South West Trains,Transport,26,224
31,12,2012,Wild Bean Cafe,Eating Out,1,223
31,12,2012,Chicken Cottage,Eating Out,6,217
31,12,2012,ATM Cash Withdrawal,General,20,197
1,1,2013,Rhino Sports salary,General,1700,1897
1,1,2013,Costa Coffee,Eating Out,1,1896
1,1,2013,McDonalds,Eating Out,5,1891
1,1,2013,Paying back Julie,,4,1887
2,1,2013,ATM Cash Withdrawal,General,20,1867
2,1,2013,Cheam Service Station,,8,1859
3,1,2013,Caffe Nero,Eating Out,2,1857
3,1,2013,Subway,Eating Out,7,1850
4,1,2013,Morrisons,Groceries,60,1790
4,1,2013,Costa Coffee,Eating Out,1,1789
4,1,2013,ATM Cash Withdrawal,General,10,1779
5,1,2013,Paying back Julie,,9,1770
6,1,2013,Scott's Restaurant,Eating Out,25,1745
7,1,2013,Cubit and West rent,Rent,550,1195
7,1,2013,South West Trains,Transport,31,1164
8,1,2013,Wild Bean Cafe,Eating Out,1,1163
8,1,2013,McDonalds,Eating Out,4,1159
9,1,2013,Wild Bean Cafe,Eating Out,2,1157
9,1,2013,Pret A Manger,Eating Out,5,1152
10,1,2013,Starbucks Coffee,Eating Out,2,1150
10,1,2013,Subway,Eating Out,5,1145
11,1,2013,ASDA,Groceries,83,1062
11,1,2013,Starbucks Coffee,Eating Out,1,1061
11,1,2013,Ministry of Sound ClubXOYO Club,Eating Out,10,1051
11,1,2013,Ministry of Sound ClubXOYO Club,Eating Out,12,1039
11,1,2013,Ministry of Sound ClubXOYO Club,Eating Out,15,1024
12,1,2013,Pizza Express,Eating Out,34,990
13,1,2013,Dominos Pizza,Eating Out,54,936
14,1,2013,South West Trains,Transport,24,912
14,1,2013,Caffe Nero,Eating Out,1,911
14,1,2013,McDonalds,Eating Out,8,903
15,1,2013,BRGAS-Electricity,Bills,54,849
15,1,2013,BRGAS-Gas,Bills,72,777
15,1,2013,Costa Coffee,Eating Out,2,775
15,1,2013,The West Cornwall Pasty Company,Eating Out,7,768
15,1,2013,ATM Cash Withdrawal,General,10,758
16,1,2013,LBS Council Tax,Bills,50,708
16,1,2013,Costa Coffee,Eating Out,2,706
16,1,2013,Chicken Cottage,Eating Out,8,698
17,1,2013,Caffe Nero,Eating Out,2,696
17,1,2013,Chicken Cottage,Eating Out,4,692
18,1,2013,Tescos,Groceries,82,610
18,1,2013,Costa Coffee,Eating Out,1,609
18,1,2013,Restaurant Gordon RamsayPortland Restaurant,Eating Out,27,582
18,1,2013,Tool Shop,,1,581
20,1,2013,VIRGIN MEDIA PYMTS,Bills,52,529
20,1,2013,Scott's Restaurant,Eating Out,43,486
21,1,2013,South West Trains,Transport,37,449
21,1,2013,Caffe Nero,Eating Out,2,447
21,1,2013,Subway,Eating Out,7,440
22,1,2013,The West Cornwall Pasty Company,Eating Out,5,435
23,1,2013,Costa Coffee,Eating Out,1,434
23,1,2013,ATM Cash Withdrawal,General,10,424
24,1,2013,O2,Bills,30,394
24,1,2013,Costa Coffee,Eating Out,2,392
25,1,2013,Morrisons,Groceries,78,314
25,1,2013,Caffe Nero,Eating Out,2,312
25,1,2013,Subway,Eating Out,4,308
25,1,2013,Pizza Express,Eating Out,32,276
26,1,2013,The Grand Pub,Eating Out,9,267
26,1,2013,The Grand Pub,Eating Out,12,255
26,1,2013,The Grand Pub,Eating Out,10,245
26,1,2013,The Grand Pub,Eating Out,11,234
26,1,2013,Anglo restaurant,Eating Out,57,177
27,1,2013,Scott's Restaurant,Eating Out,41,136
28,1,2013,South West Trains,Transport,36,100
28,1,2013,Starbucks Coffee,Eating Out,2,98
28,1,2013,Chicken Cottage,Eating Out,4,94
29,1,2013,Caffe Nero,Eating Out,2,92
29,1,2013,Chicken Cottage,Eating Out,8,84
31,1,2013,Wild Bean Cafe,Eating Out,1,83
31,1,2013,Chicken Cottage,Eating Out,4,79
31,1,2013,ATM Cash Withdrawal,General,10,69
1,2,2013,Rhino Sports salary,General,1700,1769
1,2,2013,Morrisons,Groceries,81,1688
1,2,2013,Wild Bean Cafe,Eating Out,2,1686
1,2,2013,Chicken Cottage,Eating Out,5,1681
1,2,2013,Pizza Express,Eating Out,28,1653
3,2,2013,Scott's Restaurant,Eating Out,57,1596
4,2,2013,South West Trains,Transport,37,1559
5,2,2013,Costa Coffee,Eating Out,2,1557
5,2,2013,Greggs,Eating Out,5,1552
6,2,2013,Starbucks Coffee,Eating Out,2,1550
6,2,2013,Civic Shop,,4,1546
7,2,2013,Cubit and West rent,Rent,550,996
7,2,2013,Subway,Eating Out,5,991
7,2,2013,ATM Cash Withdrawal,General,10,981
7,2,2013,Cheam Service Station,,2,979
8,2,2013,Tescos,Groceries,50,929
8,2,2013,Costa Coffee,Eating Out,2,927
8,2,2013,Subway,Eating Out,4,923
8,2,2013,Pizza Express,Eating Out,54,869
8,2,2013,Tool Tec,,7,862
9,2,2013,Restaurant Gordon RamsayPortland Restaurant,Eating Out,40,822
9,2,2013,ATM Cash Withdrawal,General,20,802
9,2,2013,Tool Tec,,9,793
11,2,2013,South West Trains,Transport,27,766
11,2,2013,Costa Coffee,Eating Out,1,765
11,2,2013,Pret A Manger,Eating Out,6,759
12,2,2013,Costa Coffee,Eating Out,2,757
12,2,2013,Pret A Manger,Eating Out,4,753
12,2,2013,Tool Shop,,2,751
13,2,2013,ATM Cash Withdrawal,General,20,731
14,2,2013,Chicken Cottage,Eating Out,7,724
14,2,2013,ATM Cash Withdrawal,General,10,714
15,2,2013,BRGAS-Electricity,Bills,37,677
15,2,2013,BRGAS-Gas,Bills,38,639
15,2,2013,Tescos,Groceries,88,551
15,2,2013,Costa Coffee,Eating Out,1,550
16,2,2013,LBS Council Tax,Bills,50,500
17,2,2013,Restaurant Gordon RamsayPortland Restaurant,Eating Out,46,454
18,2,2013,South West Trains,Transport,25,429
18,2,2013,Pret A Manger,Eating Out,4,425
19,2,2013,Caffe Nero,Eating Out,1,424
19,2,2013,Greggs,Eating Out,7,417
19,2,2013,ATM Cash Withdrawal,General,10,407
20,2,2013,VIRGIN MEDIA PYMTS,Bills,31,376
20,2,2013,Caffe Nero,Eating Out,2,374
20,2,2013,The West Cornwall Pasty Company,Eating Out,8,366
21,2,2013,Wild Bean Cafe,Eating Out,2,364
21,2,2013,Paying back Julie,,8,356
22,2,2013,Sainsburys,Groceries,59,297
22,2,2013,Costa Coffee,Eating Out,2,295
22,2,2013,The West Cornwall Pasty Company,Eating Out,5,290
23,2,2013,Pizza Express,Eating Out,28,262
24,2,2013,O2,Bills,32,230
25,2,2013,South West Trains,Transport,31,199
25,2,2013,Costa Coffee,Eating Out,1,198
25,2,2013,Chicken Cottage,Eating Out,8,190
25,2,2013,ATM Cash Withdrawal,General,10,180
26,2,2013,Costa Coffee,Eating Out,2,178
27,2,2013,Starbucks Coffee,Eating Out,2,176
27,2,2013,McDonalds,Eating Out,4,172
27,2,2013,ATM Cash Withdrawal,General,20,152
27,2,2013,Paying back James,,5,147
28,2,2013,Wild Bean Cafe,Eating Out,2,145
1,3,2013,Rhino Sports salary,General,1700,1845
1,3,2013,Morrisons,Groceries,67,1778
1,3,2013,Wild Bean Cafe,Eating Out,2,1776
1,3,2013,Chicken Cottage,Eating Out,5,1771
2,3,2013,ATM Cash Withdrawal,General,10,1761
4,3,2013,South West Trains,Transport,37,1724
4,3,2013,Wild Bean Cafe,Eating Out,1,1723
4,3,2013,Pret A Manger,Eating Out,6,1717
5,3,2013,Caffe Nero,Eating Out,2,1715
6,3,2013,Costa Coffee,Eating Out,2,1713
7,3,2013,Cubit and West rent,Rent,550,1163
7,3,2013,Costa Coffee,Eating Out,2,1161
8,3,2013,Waitrose,Groceries,43,1118
8,3,2013,Wild Bean Cafe,Eating Out,1,1117
8,3,2013,Subway,Eating Out,7,1110
8,3,2013,Dominos Pizza,Eating Out,48,1062
8,3,2013,ATM Cash Withdrawal,General,20,1042
9,3,2013,Scott's Restaurant,Eating Out,46,996
9,3,2013,Civic Shop,,5,991
11,3,2013,South West Trains,Transport,35,956
11,3,2013,Pret A Manger,Eating Out,4,952
12,3,2013,Caffe Nero,Eating Out,1,951
12,3,2013,ATM Cash Withdrawal,General,20,931
13,3,2013,ATM Cash Withdrawal,General,20,911
14,3,2013,Starbucks Coffee,Eating Out,2,909
14,3,2013,Pret A Manger,Eating Out,8,901
15,3,2013,BRGAS-Electricity,Bills,29,872
15,3,2013,BRGAS-Gas,Bills,41,831
15,3,2013,Sainsburys,Groceries,50,781
15,3,2013,Costa Coffee,Eating Out,1,780
15,3,2013,Chicken Cottage,Eating Out,7,773
15,3,2013,Restaurant Gordon RamsayPortland Restaurant,Eating Out,33,740
16,3,2013,LBS Council Tax,Bills,50,690
17,3,2013,Pizza Express,Eating Out,59,631
18,3,2013,South West Trains,Transport,28,603
18,3,2013,Wild Bean Cafe,Eating Out,1,602
18,3,2013,Greggs,Eating Out,8,594
19,3,2013,Starbucks Coffee,Eating Out,2,592
19,3,2013,Greggs,Eating Out,7,585
20,3,2013,VIRGIN MEDIA PYMTS,Bills,29,556
20,3,2013,Starbucks Coffee,Eating Out,2,554
20,3,2013,Pret A Manger,Eating Out,8,546
20,3,2013,ATM Cash Withdrawal,General,10,536
21,3,2013,Costa Coffee,Eating Out,2,534
21,3,2013,McDonalds,Eating Out,4,530
22,3,2013,Sainsburys,Groceries,81,449
22,3,2013,Costa Coffee,Eating Out,2,447
22,3,2013,Dominos Pizza,Eating Out,42,405
23,3,2013,Restaurant Gordon RamsayPortland Restaurant,Eating Out,50,355
24,3,2013,O2,Bills,31,324
24,3,2013,ATM Cash Withdrawal,General,10,314
25,3,2013,South West Trains,Transport,33,281
25,3,2013,Costa Coffee,Eating Out,2,279
25,3,2013,Cheam Service Station,,8,271
26,3,2013,Starbucks Coffee,Eating Out,1,270
26,3,2013,The West Cornwall Pasty Company,Eating Out,7,263
27,3,2013,Caffe Nero,Eating Out,1,262
27,3,2013,Greggs,Eating Out,5,257
28,3,2013,Costa Coffee,Eating Out,2,255
28,3,2013,Pret A Manger,Eating Out,7,248
28,3,2013,Paying back James,,4,244
29,3,2013,Sainsburys,Groceries,46,198
29,3,2013,Wild Bean Cafe,Eating Out,2,196
29,3,2013,Chicken Cottage,Eating Out,6,190
29,3,2013,Scott's Restaurant,Eating Out,58,132
31,3,2013,Anglo restaurant,Eating Out,55,77
1,4,2013,Rhino Sports salary,General,1700,1777
1,4,2013,South West Trains,Transport,24,1753
1,4,2013,Wild Bean Cafe,Eating Out,2,1751
2,4,2013,Starbucks Coffee,Eating Out,1,1750
2,4,2013,Subway,Eating Out,4,1746
2,4,2013,Cheam Service Station,,7,1739
3,4,2013,Wild Bean Cafe,Eating Out,1,1738
3,4,2013,McDonalds,Eating Out,7,1731
4,4,2013,Wild Bean Cafe,Eating Out,1,1730
5,4,2013,ASDA,Groceries,80,1650
5,4,2013,Costa Coffee,Eating Out,2,1648
5,4,2013,Pret A Manger,Eating Out,5,1643
5,4,2013,ATM Cash Withdrawal,General,10,1633
6,4,2013,ATM Cash Withdrawal,General,10,1623
7,4,2013,Cubit and West rent,Rent,550,1073
7,4,2013,Scott's Restaurant,Eating Out,41,1032
7,4,2013,ATM Cash Withdrawal,General,10,1022
8,4,2013,South West Trains,Transport,27,995
8,4,2013,Wild Bean Cafe,Eating Out,1,994
8,4,2013,McDonalds,Eating Out,5,989
8,4,2013,ATM Cash Withdrawal,General,20,969
9,4,2013,Wild Bean Cafe,Eating Out,2,967
9,4,2013,Greggs,Eating Out,6,961
9,4,2013,ATM Cash Withdrawal,General,10,951
10,4,2013,Starbucks Coffee,Eating Out,2,949
12,4,2013,Morrisons,Groceries,85,864
12,4,2013,Wild Bean Cafe,Eating Out,1,863
12,4,2013,Dominos Pizza,Eating Out,54,809
12,4,2013,ATM Cash Withdrawal,General,20,789
13,4,2013,ATM Cash Withdrawal,General,10,779
14,4,2013,Scott's Restaurant,Eating Out,52,727
15,4,2013,BRGAS-Electricity,Bills,28,699
15,4,2013,BRGAS-Gas,Bills,23,676
15,4,2013,South West Trains,Transport,31,645
15,4,2013,Caffe Nero,Eating Out,2,643
15,4,2013,Chicken Cottage,Eating Out,7,636
15,4,2013,ATM Cash Withdrawal,General,20,616
16,4,2013,LBS Council Tax,Bills,50,566
16,4,2013,Starbucks Coffee,Eating Out,2,564
16,4,2013,Greggs,Eating Out,4,560
17,4,2013,Caffe Nero,Eating Out,2,558
17,4,2013,McDonalds,Eating Out,7,551
17,4,2013,ATM Cash Withdrawal,General,20,531
19,4,2013,Tescos,Groceries,42,489
19,4,2013,Starbucks Coffee,Eating Out,2,487
19,4,2013,McDonalds,Eating Out,6,481
20,4,2013,VIRGIN MEDIA PYMTS,Bills,56,425
22,4,2013,South West Trains,Transport,29,396
22,4,2013,Wild Bean Cafe,Eating Out,2,394
22,4,2013,Subway,Eating Out,5,389
23,4,2013,Wild Bean Cafe,Eating Out,2,387
24,4,2013,O2,Bills,38,349
24,4,2013,Pret A Manger,Eating Out,7,342
25,4,2013,Wild Bean Cafe,Eating Out,2,340
26,4,2013,Tescos,Groceries,69,271
26,4,2013,Costa Coffee,Eating Out,2,269
26,4,2013,Pret A Manger,Eating Out,4,265
27,4,2013,Dominos Pizza,Eating Out,35,230
29,4,2013,South West Trains,Transport,28,202
29,4,2013,Starbucks Coffee,Eating Out,2,200
29,4,2013,Pret A Manger,Eating Out,4,196
29,4,2013,ATM Cash Withdrawal,General,10,186
29,4,2013,Tool Tec,,2,184
30,4,2013,ATM Cash Withdrawal,General,20,164
1,5,2013,Rhino Sports salary,General,1700,1864
1,5,2013,Costa Coffee,Eating Out,1,1863
1,5,2013,Chicken Cottage,Eating Out,8,1855
2,5,2013,Starbucks Coffee,Eating Out,1,1854
2,5,2013,Chicken Cottage,Eating Out,6,1848
3,5,2013,ASDA,Groceries,81,1767
3,5,2013,Wild Bean Cafe,Eating Out,2,1765
3,5,2013,Subway,Eating Out,7,1758
3,5,2013,Pizza Express,Eating Out,37,1721
3,5,2013,Civic Shop,,2,1719
4,5,2013,Ministry of Sound ClubXOYO Club,Eating Out,5,1714
4,5,2013,Ministry of Sound ClubXOYO Club,Eating Out,6,1708
4,5,2013,Ministry of Sound ClubXOYO Club,Eating Out,7,1701
4,5,2013,Ministry of Sound ClubXOYO Club,Eating Out,16,1685
4,5,2013,Ministry of Sound ClubXOYO Club,Eating Out,15,1670
4,5,2013,Ministry of Sound ClubXOYO Club,Eating Out,8,1662
4,5,2013,Dominos Pizza,Eating Out,33,1629
5,5,2013,Anglo restaurant,Eating Out,58,1571
6,5,2013,South West Trains,Transport,25,1546
6,5,2013,Caffe Nero,Eating Out,2,1544
6,5,2013,The West Cornwall Pasty Company,Eating Out,7,1537
7,5,2013,Cubit and West rent,Rent,550,987
7,5,2013,Caffe Nero,Eating Out,1,986
7,5,2013,Greggs,Eating Out,5,981
8,5,2013,Costa Coffee,Eating Out,1,980
8,5,2013,Greggs,Eating Out,6,974
9,5,2013,Subway,Eating Out,5,969
10,5,2013,Tescos,Groceries,56,913
10,5,2013,Costa Coffee,Eating Out,2,911
12,5,2013,Dominos Pizza,Eating Out,59,852
13,5,2013,South West Trains,Transport,26,826
13,5,2013,Wild Bean Cafe,Eating Out,2,824
13,5,2013,Chicken Cottage,Eating Out,6,818
14,5,2013,Wild Bean Cafe,Eating Out,2,816
15,5,2013,BRGAS-Electricity,Bills,31,785
15,5,2013,BRGAS-Gas,Bills,27,758
15,5,2013,Starbucks Coffee,Eating Out,1,757
15,5,2013,Subway,Eating Out,6,751
16,5,2013,LBS Council Tax,Bills,50,701
16,5,2013,Caffe Nero,Eating Out,2,699
16,5,2013,McDonalds,Eating Out,4,695
16,5,2013,Red Shop,,5,690
17,5,2013,ASDA,Groceries,46,644
17,5,2013,Starbucks Coffee,Eating Out,2,642
17,5,2013,The West Cornwall Pasty Company,Eating Out,4,638
17,5,2013,Fabric Club,Eating Out,11,627
17,5,2013,Fabric Club,Eating Out,9,618
17,5,2013,Fabric Club,Eating Out,14,604
17,5,2013,Fabric Club,Eating Out,12,592
17,5,2013,ATM Cash Withdrawal,General,10,582
20,5,2013,VIRGIN MEDIA PYMTS,Bills,34,548
20,5,2013,South West Trains,Transport,38,510
20,5,2013,McDonalds,Eating Out,4,506
20,5,2013,ATM Cash Withdrawal,General,20,486
21,5,2013,Greggs,Eating Out,6,480
21,5,2013,Paying back Julie,,1,479
22,5,2013,Wild Bean Cafe,Eating Out,2,477
22,5,2013,ATM Cash Withdrawal,General,10,467
23,5,2013,Costa Coffee,Eating Out,1,466
23,5,2013,ATM Cash Withdrawal,General,10,456
24,5,2013,O2,Bills,31,425
24,5,2013,Sainsburys,Groceries,49,376
24,5,2013,Wild Bean Cafe,Eating Out,2,374
24,5,2013,Subway,Eating Out,8,366
25,5,2013,ATM Cash Withdrawal,General,10,356
25,5,2013,Tool Tec,,7,349
27,5,2013,South West Trains,Transport,29,320
27,5,2013,Costa Coffee,Eating Out,2,318
27,5,2013,Pret A Manger,Eating Out,7,311
28,5,2013,McDonalds,Eating Out,4,307
29,5,2013,Wild Bean Cafe,Eating Out,2,305
29,5,2013,Pret A Manger,Eating Out,6,299
30,5,2013,Greggs,Eating Out,8,291
31,5,2013,Sainsburys,Groceries,64,227
31,5,2013,Greggs,Eating Out,4,223
31,5,2013,Pizza Express,Eating Out,30,193
1,6,2013,Rhino Sports salary,General,1700,1893
2,6,2013,Restaurant Gordon RamsayPortland Restaurant,Eating Out,27,1866
3,6,2013,South West Trains,Transport,24,1842
3,6,2013,Wild Bean Cafe,Eating Out,2,1840
3,6,2013,Greggs,Eating Out,7,1833
4,6,2013,Costa Coffee,Eating Out,1,1832
4,6,2013,The West Cornwall Pasty Company,Eating Out,8,1824
4,6,2013,ATM Cash Withdrawal,General,10,1814
5,6,2013,Caffe Nero,Eating Out,1,1813
5,6,2013,Subway,Eating Out,4,1809
6,6,2013,Costa Coffee,Eating Out,1,1808
6,6,2013,McDonalds,Eating Out,6,1802
6,6,2013,Tool Shop,,6,1796
7,6,2013,Cubit and West rent,Rent,550,1246
7,6,2013,ASDA,Groceries,47,1199
7,6,2013,Starbucks Coffee,Eating Out,1,1198
7,6,2013,Pret A Manger,Eating Out,7,1191
7,6,2013,The Grand Pub,Eating Out,15,1176
7,6,2013,The Grand Pub,Eating Out,8,1168
7,6,2013,The Grand Pub,Eating Out,8,1160
7,6,2013,The Grand Pub,Eating Out,8,1152
7,6,2013,The Grand Pub,Eating Out,13,1139
7,6,2013,The Grand Pub,Eating Out,6,1133
9,6,2013,ATM Cash Withdrawal,General,10,1123
10,6,2013,South West Trains,Transport,31,1092
10,6,2013,Caffe Nero,Eating Out,2,1090
10,6,2013,Greggs,Eating Out,4,1086
11,6,2013,Subway,Eating Out,7,1079
11,6,2013,ATM Cash Withdrawal,General,10,1069
11,6,2013,Tool Shop,,3,1066
12,6,2013,Caffe Nero,Eating Out,1,1065
12,6,2013,ATM Cash Withdrawal,General,10,1055
13,6,2013,Costa Coffee,Eating Out,2,1053
13,6,2013,McDonalds,Eating Out,4,1049
13,6,2013,ATM Cash Withdrawal,General,10,1039
14,6,2013,Sainsburys,Groceries,71,968
14,6,2013,Caffe Nero,Eating Out,2,966
14,6,2013,Subway,Eating Out,5,961
14,6,2013,Pizza Express,Eating Out,54,907
14,6,2013,ATM Cash Withdrawal,General,20,887
15,6,2013,BRGAS-Electricity,Bills,30,857
15,6,2013,BRGAS-Gas,Bills,43,814
15,6,2013,Cheam Service Station,,9,805
16,6,2013,LBS Council Tax,Bills,50,755
17,6,2013,South West Trains,Transport,29,726
17,6,2013,Greggs,Eating Out,4,722
17,6,2013,ATM Cash Withdrawal,General,20,702
18,6,2013,Starbucks Coffee,Eating Out,1,701
18,6,2013,Greggs,Eating Out,4,697
19,6,2013,Starbucks Coffee,Eating Out,2,695
19,6,2013,Chicken Cottage,Eating Out,8,687
20,6,2013,VIRGIN MEDIA PYMTS,Bills,50,637
20,6,2013,Starbucks Coffee,Eating Out,2,635
20,6,2013,McDonalds,Eating Out,7,628
21,6,2013,ASDA,Groceries,65,563
21,6,2013,Pizza Express,Eating Out,39,524
24,6,2013,O2,Bills,36,488
24,6,2013,South West Trains,Transport,27,461
24,6,2013,Wild Bean Cafe,Eating Out,2,459
25,6,2013,Starbucks Coffee,Eating Out,1,458
26,6,2013,Wild Bean Cafe,Eating Out,1,457
26,6,2013,Pret A Manger,Eating Out,8,449
27,6,2013,Costa Coffee,Eating Out,1,448
27,6,2013,McDonalds,Eating Out,4,444
28,6,2013,Waitrose,Groceries,78,366
28,6,2013,Caffe Nero,Eating Out,1,365
28,6,2013,The West Cornwall Pasty Company,Eating Out,5,360
28,6,2013,Pizza Express,Eating Out,50,310
29,6,2013,Pizza Express,Eating Out,50,260
29,6,2013,ATM Cash Withdrawal,General,20,240
30,6,2013,ATM Cash Withdrawal,General,10,230
1,7,2013,Rhino Sports salary,General,1700,1930
1,7,2013,South West Trains,Transport,36,1894
1,7,2013,Wild Bean Cafe,Eating Out,2,1892
1,7,2013,Chicken Cottage,Eating Out,5,1887
1,7,2013,ATM Cash Withdrawal,General,10,1877
1,7,2013,Paying back Julie,,2,1875
2,7,2013,Starbucks Coffee,Eating Out,2,1873
2,7,2013,The West Cornwall Pasty Company,Eating Out,4,1869
2,7,2013,ATM Cash Withdrawal,General,20,1849
3,7,2013,McDonalds,Eating Out,8,1841
4,7,2013,Starbucks Coffee,Eating Out,2,1839
4,7,2013,ATM Cash Withdrawal,General,20,1819
5,7,2013,Tescos,Groceries,43,1776
5,7,2013,Costa Coffee,Eating Out,2,1774
5,7,2013,Chicken Cottage,Eating Out,7,1767
6,7,2013,Pizza Express,Eating Out,33,1734
7,7,2013,Cubit and West rent,Rent,550,1184
7,7,2013,Restaurant Gordon RamsayPortland Restaurant,Eating Out,28,1156
8,7,2013,South West Trains,Transport,28,1128
8,7,2013,Wild Bean Cafe,Eating Out,2,1126
8,7,2013,Greggs,Eating Out,6,1120
9,7,2013,Caffe Nero,Eating Out,1,1119
9,7,2013,ATM Cash Withdrawal,General,20,1099
10,7,2013,Costa Coffee,Eating Out,2,1097
10,7,2013,ATM Cash Withdrawal,General,20,1077
11,7,2013,Chicken Cottage,Eating Out,7,1070
12,7,2013,Sainsburys,Groceries,69,1001
12,7,2013,Caffe Nero,Eating Out,2,999
12,7,2013,Restaurant Gordon RamsayPortland Restaurant,Eating Out,55,944
12,7,2013,ATM Cash Withdrawal,General,10,934
13,7,2013,ATM Cash Withdrawal,General,10,924
14,7,2013,Anglo restaurant,Eating Out,32,892
15,7,2013,BRGAS-Electricity,Bills,31,861
15,7,2013,BRGAS-Gas,Bills,37,824
15,7,2013,South West Trains,Transport,32,792
15,7,2013,Costa Coffee,Eating Out,1,791
15,7,2013,The West Cornwall Pasty Company,Eating Out,8,783
16,7,2013,LBS Council Tax,Bills,50,733
16,7,2013,ATM Cash Withdrawal,General,20,713
17,7,2013,Starbucks Coffee,Eating Out,1,712
18,7,2013,Caffe Nero,Eating Out,1,711
19,7,2013,Tescos,Groceries,51,660
19,7,2013,Costa Coffee,Eating Out,2,658
19,7,2013,Chicken Cottage,Eating Out,4,654
20,7,2013,VIRGIN MEDIA PYMTS,Bills,40,614
20,7,2013,Pizza Express,Eating Out,31,583
20,7,2013,ATM Cash Withdrawal,General,20,563
21,7,2013,ATM Cash Withdrawal,General,20,543
22,7,2013,South West Trains,Transport,35,508
22,7,2013,Caffe Nero,Eating Out,2,506
23,7,2013,Costa Coffee,Eating Out,2,504
23,7,2013,Greggs,Eating Out,6,498
24,7,2013,O2,Bills,31,467
24,7,2013,Costa Coffee,Eating Out,2,465
24,7,2013,ATM Cash Withdrawal,General,10,455
25,7,2013,Costa Coffee,Eating Out,1,454
25,7,2013,Subway,Eating Out,5,449
26,7,2013,Morrisons,Groceries,45,404
26,7,2013,The West Cornwall Pasty Company,Eating Out,6,398
27,7,2013,ATM Cash Withdrawal,General,10,388
29,7,2013,South West Trains,Transport,37,351
29,7,2013,Wild Bean Cafe,Eating Out,2,349
29,7,2013,Chicken Cottage,Eating Out,8,341
29,7,2013,ATM Cash Withdrawal,General,10,331
30,7,2013,Wild Bean Cafe,Eating Out,1,330
30,7,2013,ATM Cash Withdrawal,General,20,310
31,7,2013,Caffe Nero,Eating Out,1,309
1,8,2013,Rhino Sports salary,General,1700,2009
1,8,2013,Greggs,Eating Out,7,2002
2,8,2013,Morrisons,Groceries,52,1950
2,8,2013,Starbucks Coffee,Eating Out,2,1948
2,8,2013,Scott's Restaurant,Eating Out,51,1897
2,8,2013,ATM Cash Withdrawal,General,10,1887
4,8,2013,Anglo restaurant,Eating Out,39,1848
5,8,2013,South West Trains,Transport,32,1816
5,8,2013,Wild Bean Cafe,Eating Out,2,1814
5,8,2013,Paying back James,,9,1805
6,8,2013,Starbucks Coffee,Eating Out,2,1803
7,8,2013,Cubit and West rent,Rent,550,1253
7,8,2013,Wild Bean Cafe,Eating Out,1,1252
8,8,2013,Caffe Nero,Eating Out,1,1251
8,8,2013,McDonalds,Eating Out,7,1244
9,8,2013,Waitrose,Groceries,75,1169
9,8,2013,The West Cornwall Pasty Company,Eating Out,4,1165
9,8,2013,Red Shop,,6,1159
10,8,2013,Heaven Club,Eating Out,10,1149
10,8,2013,Heaven Club,Eating Out,16,1133
10,8,2013,Heaven Club,Eating Out,13,1120
10,8,2013,Heaven Club,Eating Out,10,1110
10,8,2013,Heaven Club,Eating Out,10,1100
10,8,2013,Heaven Club,Eating Out,8,1092
12,8,2013,South West Trains,Transport,32,1060
12,8,2013,ATM Cash Withdrawal,General,20,1040
13,8,2013,Costa Coffee,Eating Out,2,1038
13,8,2013,Cheam Service Station,,3,1035
14,8,2013,Wild Bean Cafe,Eating Out,1,1034
14,8,2013,Paying back Julie,,7,1027
15,8,2013,BRGAS-Electricity,Bills,42,985
15,8,2013,BRGAS-Gas,Bills,39,946
15,8,2013,Starbucks Coffee,Eating Out,1,945
15,8,2013,Chicken Cottage,Eating Out,7,938
15,8,2013,ATM Cash Withdrawal,General,10,928
16,8,2013,LBS Council Tax,Bills,50,878
16,8,2013,Tescos,Groceries,74,804
16,8,2013,Starbucks Coffee,Eating Out,2,802
16,8,2013,Fabric Club,Eating Out,15,787
16,8,2013,Fabric Club,Eating Out,12,775
16,8,2013,Fabric Club,Eating Out,5,770
16,8,2013,Fabric Club,Eating Out,7,763
16,8,2013,Fabric Club,Eating Out,15,748
17,8,2013,Restaurant Gordon RamsayPortland Restaurant,Eating Out,41,707
17,8,2013,ATM Cash Withdrawal,General,20,687
19,8,2013,South West Trains,Transport,29,658
19,8,2013,Wild Bean Cafe,Eating Out,2,656
19,8,2013,Chicken Cottage,Eating Out,5,651
20,8,2013,VIRGIN MEDIA PYMTS,Bills,52,599
20,8,2013,Wild Bean Cafe,Eating Out,1,598
20,8,2013,Subway,Eating Out,7,591
21,8,2013,McDonalds,Eating Out,5,586
21,8,2013,ATM Cash Withdrawal,General,20,566
22,8,2013,Caffe Nero,Eating Out,2,564
22,8,2013,McDonalds,Eating Out,8,556
23,8,2013,Waitrose,Groceries,53,503
23,8,2013,Starbucks Coffee,Eating Out,1,502
23,8,2013,Pret A Manger,Eating Out,5,497
23,8,2013,Restaurant Gordon RamsayPortland Restaurant,Eating Out,38,459
23,8,2013,Civic Shop,,8,451
24,8,2013,O2,Bills,33,418
24,8,2013,Fabric Club,Eating Out,11,407
24,8,2013,Fabric Club,Eating Out,6,401
24,8,2013,Fabric Club,Eating Out,8,393
24,8,2013,Fabric Club,Eating Out,5,388
24,8,2013,Fabric Club,Eating Out,10,378
25,8,2013,Scott's Restaurant,Eating Out,58,320
26,8,2013,South West Trains,Transport,29,291
26,8,2013,Costa Coffee,Eating Out,1,290
26,8,2013,The West Cornwall Pasty Company,Eating Out,6,284
26,8,2013,ATM Cash Withdrawal,General,20,264
27,8,2013,Greggs,Eating Out,4,260
27,8,2013,ATM Cash Withdrawal,General,10,250
28,8,2013,Greggs,Eating Out,7,243
29,8,2013,Subway,Eating Out,4,239
30,8,2013,Morrisons,Groceries,81,158
30,8,2013,Pret A Manger,Eating Out,6,152
30,8,2013,Scott's Restaurant,Eating Out,57,95
1,9,2013,Rhino Sports salary,General,1700,1795
1,9,2013,Pizza Express,Eating Out,36,1759
1,9,2013,ATM Cash Withdrawal,General,20,1739
2,9,2013,South West Trains,Transport,24,1715
2,9,2013,Wild Bean Cafe,Eating Out,2,1713
2,9,2013,Chicken Cottage,Eating Out,8,1705
2,9,2013,ATM Cash Withdrawal,General,20,1685
3,9,2013,Costa Coffee,Eating Out,2,1683
3,9,2013,ATM Cash Withdrawal,General,20,1663
4,9,2013,Caffe Nero,Eating Out,2,1661
4,9,2013,Subway,Eating Out,7,1654
4,9,2013,ATM Cash Withdrawal,General,10,1644
5,9,2013,Caffe Nero,Eating Out,2,1642
5,9,2013,Chicken Cottage,Eating Out,7,1635
6,9,2013,Sainsburys,Groceries,59,1576
6,9,2013,Pret A Manger,Eating Out,4,1572
7,9,2013,Cubit and West rent,Rent,550,1022
7,9,2013,Fabric Club,Eating Out,8,1014
7,9,2013,Fabric Club,Eating Out,15,999
7,9,2013,Fabric Club,Eating Out,9,990
7,9,2013,Fabric Club,Eating Out,12,978
7,9,2013,Fabric Club,Eating Out,9,969
7,9,2013,Fabric Club,Eating Out,8,961
8,9,2013,Dominos Pizza,Eating Out,57,904
9,9,2013,South West Trains,Transport,24,880
9,9,2013,Costa Coffee,Eating Out,2,878
10,9,2013,Costa Coffee,Eating Out,1,877
11,9,2013,Greggs,Eating Out,4,873
12,9,2013,Caffe Nero,Eating Out,2,871
12,9,2013,Subway,Eating Out,5,866
12,9,2013,ATM Cash Withdrawal,General,10,856
13,9,2013,Morrisons,Groceries,65,791
13,9,2013,Caffe Nero,Eating Out,2,789
13,9,2013,Pret A Manger,Eating Out,8,781
13,9,2013,Fabric Club,Eating Out,8,773
13,9,2013,Fabric Club,Eating Out,11,762
13,9,2013,Fabric Club,Eating Out,8,754
13,9,2013,Fabric Club,Eating Out,5,749
13,9,2013,Fabric Club,Eating Out,7,742
13,9,2013,Fabric Club,Eating Out,13,729
14,9,2013,ATM Cash Withdrawal,General,20,709
15,9,2013,BRGAS-Electricity,Bills,34,675
15,9,2013,BRGAS-Gas,Bills,37,638
16,9,2013,LBS Council Tax,Bills,50,588
16,9,2013,South West Trains,Transport,24,564
16,9,2013,Costa Coffee,Eating Out,1,563
16,9,2013,The West Cornwall Pasty Company,Eating Out,7,556
17,9,2013,Caffe Nero,Eating Out,1,555
17,9,2013,ATM Cash Withdrawal,General,10,545
18,9,2013,Starbucks Coffee,Eating Out,2,543
18,9,2013,Cheam Service Station,,2,541
19,9,2013,Starbucks Coffee,Eating Out,2,539
19,9,2013,The West Cornwall Pasty Company,Eating Out,6,533
19,9,2013,ATM Cash Withdrawal,General,20,513
20,9,2013,VIRGIN MEDIA PYMTS,Bills,59,454
20,9,2013,Sainsburys,Groceries,51,403
21,9,2013,Ministry of Sound ClubXOYO Club,Eating Out,15,388
23,9,2013,South West Trains,Transport,25,363
23,9,2013,Starbucks Coffee,Eating Out,2,361
23,9,2013,Greggs,Eating Out,6,355
24,9,2013,O2,Bills,33,322
24,9,2013,Starbucks Coffee,Eating Out,1,321
24,9,2013,Greggs,Eating Out,7,314
25,9,2013,Costa Coffee,Eating Out,1,313
25,9,2013,Tool Shop,,8,305
26,9,2013,Starbucks Coffee,Eating Out,1,304
26,9,2013,ATM Cash Withdrawal,General,10,294
27,9,2013,Sainsburys,Groceries,65,229
27,9,2013,Wild Bean Cafe,Eating Out,2,227
27,9,2013,Greggs,Eating Out,5,222
27,9,2013,Anglo restaurant,Eating Out,31,191
27,9,2013,Paying back James,,3,188
28,9,2013,Restaurant Gordon RamsayPortland Restaurant,Eating Out,34,154
29,9,2013,Restaurant Gordon RamsayPortland Restaurant,Eating Out,33,121
29,9,2013,ATM Cash Withdrawal,General,20,101
30,9,2013,South West Trains,Transport,30,71
30,9,2013,Pret A Manger,Eating Out,5,66
30,9,2013,ATM Cash Withdrawal,General,10,56
1,10,2013,Rhino Sports salary,General,1700,1756
1,10,2013,Starbucks Coffee,Eating Out,2,1754
1,10,2013,Pret A Manger,Eating Out,4,1750
2,10,2013,Subway,Eating Out,5,1745
3,10,2013,Wild Bean Cafe,Eating Out,2,1743
3,10,2013,McDonalds,Eating Out,6,1737
4,10,2013,Morrisons,Groceries,70,1667
4,10,2013,The West Cornwall Pasty Company,Eating Out,6,1661
4,10,2013,The Grand Pub,Eating Out,6,1655
4,10,2013,The Grand Pub,Eating Out,8,1647
4,10,2013,The Grand Pub,Eating Out,12,1635
4,10,2013,The Grand Pub,Eating Out,9,1626
4,10,2013,The Grand Pub,Eating Out,16,1610
4,10,2013,The Grand Pub,Eating Out,7,1603
4,10,2013,ATM Cash Withdrawal,General,20,1583
5,10,2013,Restaurant Gordon RamsayPortland Restaurant,Eating Out,42,1541
7,10,2013,Cubit and West rent,Rent,550,991
7,10,2013,South West Trains,Transport,38,953
7,10,2013,Caffe Nero,Eating Out,2,951
7,10,2013,Greggs,Eating Out,4,947
8,10,2013,Costa Coffee,Eating Out,1,946
8,10,2013,ATM Cash Withdrawal,General,20,926
9,10,2013,Caffe Nero,Eating Out,2,924
10,10,2013,Red Shop,,8,916
11,10,2013,ASDA,Groceries,67,849
11,10,2013,Starbucks Coffee,Eating Out,2,847
11,10,2013,Chicken Cottage,Eating Out,7,840
11,10,2013,Pizza Express,Eating Out,44,796
11,10,2013,ATM Cash Withdrawal,General,10,786
12,10,2013,Heaven Club,Eating Out,14,772
12,10,2013,Heaven Club,Eating Out,12,760
12,10,2013,Heaven Club,Eating Out,7,753
12,10,2013,Heaven Club,Eating Out,10,743
12,10,2013,Anglo restaurant,Eating Out,29,714
12,10,2013,ATM Cash Withdrawal,General,20,694
14,10,2013,South West Trains,Transport,38,656
14,10,2013,Caffe Nero,Eating Out,2,654
14,10,2013,Pret A Manger,Eating Out,8,646
15,10,2013,BRGAS-Electricity,Bills,22,624
15,10,2013,BRGAS-Gas,Bills,42,582
15,10,2013,Wild Bean Cafe,Eating Out,1,581
15,10,2013,Pret A Manger,Eating Out,8,573
16,10,2013,LBS Council Tax,Bills,50,523
16,10,2013,Starbucks Coffee,Eating Out,1,522
17,10,2013,Caffe Nero,Eating Out,2,520
17,10,2013,The West Cornwall Pasty Company,Eating Out,7,513
17,10,2013,Civic Shop,,2,511
18,10,2013,Waitrose,Groceries,51,460
18,10,2013,Caffe Nero,Eating Out,2,458
18,10,2013,Subway,Eating Out,8,450
18,10,2013,Pizza Express,Eating Out,43,407
20,10,2013,VIRGIN MEDIA PYMTS,Bills,29,378
20,10,2013,Scott's Restaurant,Eating Out,41,337
20,10,2013,Tool Shop,,4,333
21,10,2013,South West Trains,Transport,37,296
21,10,2013,Costa Coffee,Eating Out,2,294
22,10,2013,Subway,Eating Out,4,290
23,10,2013,Subway,Eating Out,5,285
23,10,2013,ATM Cash Withdrawal,General,10,275
24,10,2013,O2,Bills,33,242
24,10,2013,Starbucks Coffee,Eating Out,1,241
25,10,2013,Tescos,Groceries,76,165
25,10,2013,Starbucks Coffee,Eating Out,1,164
26,10,2013,ATM Cash Withdrawal,General,20,144
28,10,2013,South West Trains,Transport,26,118
28,10,2013,Starbucks Coffee,Eating Out,2,116
28,10,2013,Greggs,Eating Out,6,110
29,10,2013,Costa Coffee,Eating Out,1,109
30,10,2013,Wild Bean Cafe,Eating Out,2,107
30,10,2013,McDonalds,Eating Out,8,99
30,10,2013,ATM Cash Withdrawal,General,10,89
31,10,2013,Caffe Nero,Eating Out,2,87
31,10,2013,Subway,Eating Out,8,79
1,11,2013,Rhino Sports salary,General,1700,1779
1,11,2013,Waitrose,Groceries,84,1695
1,11,2013,Wild Bean Cafe,Eating Out,2,1693
1,11,2013,Subway,Eating Out,7,1686
2,11,2013,Ministry of Sound ClubXOYO Club,Eating Out,14,1672
2,11,2013,Ministry of Sound ClubXOYO Club,Eating Out,12,1660
2,11,2013,Ministry of Sound ClubXOYO Club,Eating Out,12,1648
2,11,2013,Ministry of Sound ClubXOYO Club,Eating Out,6,1642
2,11,2013,Ministry of Sound ClubXOYO Club,Eating Out,16,1626
2,11,2013,ATM Cash Withdrawal,General,10,1616
3,11,2013,Restaurant Gordon RamsayPortland Restaurant,Eating Out,53,1563
4,11,2013,South West Trains,Transport,29,1534
4,11,2013,Wild Bean Cafe,Eating Out,1,1533
4,11,2013,ATM Cash Withdrawal,General,10,1523
5,11,2013,McDonalds,Eating Out,4,1519
6,11,2013,Chicken Cottage,Eating Out,6,1513
7,11,2013,Cubit and West rent,Rent,550,963
7,11,2013,ATM Cash Withdrawal,General,10,953
8,11,2013,Morrisons,Groceries,88,865
8,11,2013,Wild Bean Cafe,Eating Out,2,863
9,11,2013,Anglo restaurant,Eating Out,29,834
11,11,2013,South West Trains,Transport,38,796
11,11,2013,Costa Coffee,Eating Out,1,795
11,11,2013,Tool Tec,,7,788
12,11,2013,Caffe Nero,Eating Out,2,786
12,11,2013,Chicken Cottage,Eating Out,5,781
13,11,2013,Starbucks Coffee,Eating Out,1,780
13,11,2013,Greggs,Eating Out,7,773
13,11,2013,ATM Cash Withdrawal,General,10,763
13,11,2013,Paying back Julie,,6,757
14,11,2013,Caffe Nero,Eating Out,2,755
14,11,2013,McDonalds,Eating Out,4,751
15,11,2013,BRGAS-Electricity,Bills,66,685
15,11,2013,BRGAS-Gas,Bills,74,611
15,11,2013,Morrisons,Groceries,82,529
15,11,2013,Starbucks Coffee,Eating Out,1,528
15,11,2013,Subway,Eating Out,4,524
15,11,2013,Dominos Pizza,Eating Out,53,471
15,11,2013,ATM Cash Withdrawal,General,20,451
16,11,2013,LBS Council Tax,Bills,50,401
17,11,2013,Anglo restaurant,Eating Out,36,365
17,11,2013,Tool Tec,,1,364
18,11,2013,South West Trains,Transport,38,326
18,11,2013,Starbucks Coffee,Eating Out,2,324
18,11,2013,The West Cornwall Pasty Company,Eating Out,5,319
19,11,2013,Caffe Nero,Eating Out,2,317
19,11,2013,McDonalds,Eating Out,5,312
20,11,2013,VIRGIN MEDIA PYMTS,Bills,50,262
20,11,2013,Wild Bean Cafe,Eating Out,2,260
20,11,2013,Subway,Eating Out,7,253
20,11,2013,ATM Cash Withdrawal,General,20,233
20,11,2013,Red Shop,,7,226
21,11,2013,Starbucks Coffee,Eating Out,1,225
21,11,2013,The West Cornwall Pasty Company,Eating Out,8,217
22,11,2013,Waitrose,Groceries,52,165
22,11,2013,Scott's Restaurant,Eating Out,50,115
23,11,2013,Anglo restaurant,Eating Out,34,81
23,11,2013,ATM Cash Withdrawal,General,20,61
24,11,2013,O2,Bills,32,29
25,11,2013,South West Trains,Transport,32,-3
26,11,2013,Costa Coffee,Eating Out,2,-5
26,11,2013,The West Cornwall Pasty Company,Eating Out,4,-9
26,11,2013,ATM Cash Withdrawal,General,10,-19
27,11,2013,Caffe Nero,Eating Out,2,-21
27,11,2013,Chicken Cottage,Eating Out,7,-28
27,11,2013,ATM Cash Withdrawal,General,10,-38
28,11,2013,Starbucks Coffee,Eating Out,2,-40
28,11,2013,Chicken Cottage,Eating Out,5,-45
29,11,2013,Waitrose,Groceries,80,-125
29,11,2013,Costa Coffee,Eating Out,1,-126
1,12,2013,Rhino Sports salary,General,1700,1574
2,12,2013,South West Trains,Transport,29,1545
2,12,2013,Costa Coffee,Eating Out,1,1544
2,12,2013,McDonalds,Eating Out,6,1538
3,12,2013,Caffe Nero,Eating Out,1,1537
4,12,2013,Wild Bean Cafe,Eating Out,1,1536
4,12,2013,McDonalds,Eating Out,8,1528
5,12,2013,Starbucks Coffee,Eating Out,2,1526
6,12,2013,Sainsburys,Groceries,74,1452
6,12,2013,Subway,Eating Out,5,1447
6,12,2013,Heaven Club,Eating Out,8,1439
6,12,2013,Heaven Club,Eating Out,10,1429
6,12,2013,Heaven Club,Eating Out,13,1416
6,12,2013,Heaven Club,Eating Out,11,1405
6,12,2013,Heaven Club,Eating Out,10,1395
6,12,2013,Heaven Club,Eating Out,12,1383
6,12,2013,ATM Cash Withdrawal,General,10,1373
7,12,2013,Cubit and West rent,Rent,550,823
7,12,2013,Anglo restaurant,Eating Out,36,787
8,12,2013,ATM Cash Withdrawal,General,10,777
9,12,2013,South West Trains,Transport,33,744
9,12,2013,Costa Coffee,Eating Out,2,742
9,12,2013,Chicken Cottage,Eating Out,8,734
9,12,2013,ATM Cash Withdrawal,General,10,724
10,12,2013,Caffe Nero,Eating Out,1,723
10,12,2013,Subway,Eating Out,7,716
10,12,2013,ATM Cash Withdrawal,General,20,696
10,12,2013,Tool Shop,,7,689
11,12,2013,Starbucks Coffee,Eating Out,2,687
11,12,2013,ATM Cash Withdrawal,General,10,677
13,12,2013,Morrisons,Groceries,80,597
13,12,2013,Wild Bean Cafe,Eating Out,1,596
13,12,2013,Pret A Manger,Eating Out,7,589
14,12,2013,ATM Cash Withdrawal,General,10,579
14,12,2013,Paying back James,,5,574
15,12,2013,BRGAS-Electricity,Bills,36,538
15,12,2013,BRGAS-Gas,Bills,22,516
15,12,2013,Dominos Pizza,Eating Out,30,486
15,12,2013,ATM Cash Withdrawal,General,20,466
16,12,2013,LBS Council Tax,Bills,50,416
16,12,2013,South West Trains,Transport,34,382
16,12,2013,Costa Coffee,Eating Out,1,381
16,12,2013,Subway,Eating Out,4,377
17,12,2013,Chicken Cottage,Eating Out,8,369
18,12,2013,Starbucks Coffee,Eating Out,1,368
18,12,2013,The West Cornwall Pasty Company,Eating Out,6,362
19,12,2013,Starbucks Coffee,Eating Out,2,360
19,12,2013,Chicken Cottage,Eating Out,6,354
20,12,2013,VIRGIN MEDIA PYMTS,Bills,40,314
20,12,2013,Tescos,Groceries,68,246
20,12,2013,Costa Coffee,Eating Out,2,244
20,12,2013,Subway,Eating Out,8,236
20,12,2013,Heaven Club,Eating Out,10,226
20,12,2013,Heaven Club,Eating Out,16,210
21,12,2013,Anglo restaurant,Eating Out,54,156
21,12,2013,ATM Cash Withdrawal,General,10,146
22,12,2013,Anglo restaurant,Eating Out,41,105
22,12,2013,ATM Cash Withdrawal,General,20,85
23,12,2013,South West Trains,Transport,33,52
23,12,2013,Costa Coffee,Eating Out,2,50
24,12,2013,O2,Bills,32,18
24,12,2013,Wild Bean Cafe,Eating Out,2,16
24,12,2013,Chicken Cottage,Eating Out,5,11
24,12,2013,Paying back James,,7,4
25,12,2013,Caffe Nero,Eating Out,1,3
25,12,2013,Subway,Eating Out,6,-3
26,12,2013,Wild Bean Cafe,Eating Out,2,-5
26,12,2013,McDonalds,Eating Out,7,-12
27,12,2013,Tescos,Groceries,60,-72
27,12,2013,Costa Coffee,Eating Out,2,-74
27,12,2013,Greggs,Eating Out,6,-80
27,12,2013,Dominos Pizza,Eating Out,46,-126
27,12,2013,ATM Cash Withdrawal,General,20,-146
27,12,2013,Paying back Julie,,8,-154
28,12,2013,Heaven Club,Eating Out,11,-165
28,12,2013,Heaven Club,Eating Out,11,-176
28,12,2013,Heaven Club,Eating Out,10,-186
28,12,2013,Heaven Club,Eating Out,8,-194
28,12,2013,Heaven Club,Eating Out,9,-203
28,12,2013,Scott's Restaurant,Eating Out,34,-237
28,12,2013,ATM Cash Withdrawal,General,10,-247
30,12,2013,South West Trains,Transport,35,-282
30,12,2013,Costa Coffee,Eating Out,2,-284
30,12,2013,Subway,Eating Out,4,-288
30,12,2013,ATM Cash Withdrawal,General,20,-308
31,12,2013,Starbucks Coffee,Eating Out,2,-310
31,12,2013,Chicken Cottage,Eating Out,6,-316
1,1,2014,Rhino Sports salary,General,1700,1384
1,1,2014,Caffe Nero,Eating Out,1,1383
1,1,2014,The West Cornwall Pasty Company,Eating Out,7,1376
2,1,2014,Starbucks Coffee,Eating Out,2,1374
2,1,2014,Greggs,Eating Out,6,1368
3,1,2014,Morrisons,Groceries,49,1319
3,1,2014,Costa Coffee,Eating Out,1,1318
3,1,2014,McDonalds,Eating Out,6,1312
3,1,2014,Restaurant Gordon RamsayPortland Restaurant,Eating Out,57,1255
4,1,2014,Fabric Club,Eating Out,14,1241
4,1,2014,Fabric Club,Eating Out,15,1226
4,1,2014,Fabric Club,Eating Out,7,1219
4,1,2014,Fabric Club,Eating Out,6,1213
4,1,2014,Fabric Club,Eating Out,12,1201
6,1,2014,South West Trains,Transport,25,1176
6,1,2014,Caffe Nero,Eating Out,1,1175
6,1,2014,Pret A Manger,Eating Out,5,1170
7,1,2014,Cubit and West rent,Rent,550,620
7,1,2014,Tool Shop,,9,611
8,1,2014,Costa Coffee,Eating Out,2,609
8,1,2014,Greggs,Eating Out,4,605
8,1,2014,ATM Cash Withdrawal,General,20,585
9,1,2014,Wild Bean Cafe,Eating Out,2,583
10,1,2014,Waitrose,Groceries,69,514
10,1,2014,Costa Coffee,Eating Out,1,513
10,1,2014,Pret A Manger,Eating Out,7,506
12,1,2014,Dominos Pizza,Eating Out,28,478
12,1,2014,ATM Cash Withdrawal,General,10,468
13,1,2014,South West Trains,Transport,37,431
13,1,2014,Costa Coffee,Eating Out,2,429
13,1,2014,ATM Cash Withdrawal,General,20,409
14,1,2014,Caffe Nero,Eating Out,2,407
15,1,2014,BRGAS-Electricity,Bills,64,343
15,1,2014,BRGAS-Gas,Bills,95,248
15,1,2014,Wild Bean Cafe,Eating Out,2,246
15,1,2014,Chicken Cottage,Eating Out,6,240
16,1,2014,LBS Council Tax,Bills,50,190
16,1,2014,Starbucks Coffee,Eating Out,1,189
16,1,2014,Subway,Eating Out,7,182
17,1,2014,ASDA,Groceries,78,104
17,1,2014,Starbucks Coffee,Eating Out,2,102
17,1,2014,Subway,Eating Out,5,97
18,1,2014,Dominos Pizza,Eating Out,24,73
20,1,2014,VIRGIN MEDIA PYMTS,Bills,59,14
20,1,2014,South West Trains,Transport,29,-15
21,1,2014,Costa Coffee,Eating Out,2,-17
21,1,2014,Greggs,Eating Out,5,-22
22,1,2014,Starbucks Coffee,Eating Out,2,-24
24,1,2014,O2,Bills,38,-62
24,1,2014,Waitrose,Groceries,67,-129
24,1,2014,Greggs,Eating Out,5,-134
24,1,2014,Pizza Express,Eating Out,37,-171
25,1,2014,ATM Cash Withdrawal,General,10,-181
26,1,2014,ATM Cash Withdrawal,General,20,-201
27,1,2014,South West Trains,Transport,33,-234
27,1,2014,Caffe Nero,Eating Out,2,-236
27,1,2014,McDonalds,Eating Out,8,-244
28,1,2014,Caffe Nero,Eating Out,2,-246
28,1,2014,McDonalds,Eating Out,4,-250
28,1,2014,ATM Cash Withdrawal,General,20,-270
29,1,2014,Starbucks Coffee,Eating Out,2,-272
29,1,2014,ATM Cash Withdrawal,General,10,-282
29,1,2014,Tool Shop,,3,-285
30,1,2014,Starbucks Coffee,Eating Out,2,-287
30,1,2014,ATM Cash Withdrawal,General,20,-307
31,1,2014,Morrisons,Groceries,54,-361
31,1,2014,Caffe Nero,Eating Out,1,-362
31,1,2014,Greggs,Eating Out,8,-370
1,2,2014,Rhino Sports salary,General,1700,1330
1,2,2014,Heaven Club,Eating Out,6,1324
1,2,2014,Heaven Club,Eating Out,10,1314
1,2,2014,Heaven Club,Eating Out,14,1300
1,2,2014,Heaven Club,Eating Out,12,1288
1,2,2014,Heaven Club,Eating Out,12,1276
1,2,2014,Dominos Pizza,Eating Out,50,1226
1,2,2014,ATM Cash Withdrawal,General,20,1206
2,2,2014,Dominos Pizza,Eating Out,32,1174
2,2,2014,ATM Cash Withdrawal,General,20,1154
3,2,2014,South West Trains,Transport,27,1127
3,2,2014,McDonalds,Eating Out,6,1121
3,2,2014,ATM Cash Withdrawal,General,10,1111
4,2,2014,Wild Bean Cafe,Eating Out,2,1109
4,2,2014,Paying back Julie,,7,1102
5,2,2014,Subway,Eating Out,5,1097
6,2,2014,Subway,Eating Out,6,1091
6,2,2014,ATM Cash Withdrawal,General,10,1081
7,2,2014,Cubit and West rent,Rent,550,531
7,2,2014,Tescos,Groceries,63,468
7,2,2014,Costa Coffee,Eating Out,2,466
10,2,2014,South West Trains,Transport,34,432
10,2,2014,Starbucks Coffee,Eating Out,2,430
10,2,2014,Pret A Manger,Eating Out,5,425
11,2,2014,Wild Bean Cafe,Eating Out,1,424
11,2,2014,ATM Cash Withdrawal,General,20,404
12,2,2014,Costa Coffee,Eating Out,2,402
12,2,2014,The West Cornwall Pasty Company,Eating Out,5,397
12,2,2014,ATM Cash Withdrawal,General,20,377
13,2,2014,The West Cornwall Pasty Company,Eating Out,6,371
13,2,2014,ATM Cash Withdrawal,General,20,351
14,2,2014,ASDA,Groceries,53,298
14,2,2014,Starbucks Coffee,Eating Out,2,296
14,2,2014,Pizza Express,Eating Out,35,261
15,2,2014,BRGAS-Electricity,Bills,42,219
15,2,2014,BRGAS-Gas,Bills,36,183
15,2,2014,Anglo restaurant,Eating Out,57,126
15,2,2014,ATM Cash Withdrawal,General,10,116
16,2,2014,LBS Council Tax,Bills,50,66
16,2,2014,Dominos Pizza,Eating Out,48,18
16,2,2014,ATM Cash Withdrawal,General,10,8
17,2,2014,South West Trains,Transport,24,-16
17,2,2014,Starbucks Coffee,Eating Out,1,-17
17,2,2014,Chicken Cottage,Eating Out,7,-24
18,2,2014,Wild Bean Cafe,Eating Out,2,-26
18,2,2014,McDonalds,Eating Out,4,-30
18,2,2014,ATM Cash Withdrawal,General,10,-40
19,2,2014,Costa Coffee,Eating Out,2,-42
19,2,2014,Chicken Cottage,Eating Out,4,-46
20,2,2014,VIRGIN MEDIA PYMTS,Bills,59,-105
20,2,2014,Wild Bean Cafe,Eating Out,1,-106
20,2,2014,ATM Cash Withdrawal,General,10,-116
21,2,2014,Waitrose,Groceries,48,-164
21,2,2014,Pret A Manger,Eating Out,5,-169
21,2,2014,Ministry of Sound ClubXOYO Club,Eating Out,10,-179
21,2,2014,Ministry of Sound ClubXOYO Club,Eating Out,8,-187
21,2,2014,Pizza Express,Eating Out,59,-246
21,2,2014,ATM Cash Withdrawal,General,10,-256
21,2,2014,Cheam Service Station,,3,-259
23,2,2014,Pizza Express,Eating Out,38,-297
23,2,2014,ATM Cash Withdrawal,General,10,-307
23,2,2014,Civic Shop,,9,-316
24,2,2014,O2,Bills,37,-353
24,2,2014,South West Trains,Transport,31,-384
24,2,2014,Caffe Nero,Eating Out,2,-386
25,2,2014,Costa Coffee,Eating Out,2,-388
26,2,2014,Wild Bean Cafe,Eating Out,2,-390
26,2,2014,ATM Cash Withdrawal,General,20,-410
27,2,2014,Starbucks Coffee,Eating Out,1,-411
27,2,2014,Greggs,Eating Out,7,-418
27,2,2014,ATM Cash Withdrawal,General,10,-428
28,2,2014,Morrisons,Groceries,53,-481
28,2,2014,Starbucks Coffee,Eating Out,2,-483
28,2,2014,The West Cornwall Pasty Company,Eating Out,7,-490
1,3,2014,Rhino Sports salary,General,1700,1210
2,3,2014,ATM Cash Withdrawal,General,10,1200
3,3,2014,South West Trains,Transport,31,1169
3,3,2014,Pret A Manger,Eating Out,6,1163
3,3,2014,ATM Cash Withdrawal,General,20,1143
4,3,2014,Starbucks Coffee,Eating Out,2,1141
4,3,2014,Pret A Manger,Eating Out,5,1136
5,3,2014,Wild Bean Cafe,Eating Out,2,1134
5,3,2014,Greggs,Eating Out,7,1127
6,3,2014,Costa Coffee,Eating Out,2,1125
6,3,2014,Chicken Cottage,Eating Out,7,1118
6,3,2014,ATM Cash Withdrawal,General,20,1098
7,3,2014,Cubit and West rent,Rent,550,548
7,3,2014,Morrisons,Groceries,61,487
7,3,2014,The West Cornwall Pasty Company,Eating Out,4,483
7,3,2014,Tool Shop,,2,481
9,3,2014,ATM Cash Withdrawal,General,20,461
10,3,2014,South West Trains,Transport,25,436
10,3,2014,McDonalds,Eating Out,7,429
11,3,2014,Wild Bean Cafe,Eating Out,2,427
11,3,2014,The West Cornwall Pasty Company,Eating Out,6,421
12,3,2014,Starbucks Coffee,Eating Out,1,420
12,3,2014,Subway,Eating Out,4,416
13,3,2014,Wild Bean Cafe,Eating Out,2,414
13,3,2014,McDonalds,Eating Out,8,406
14,3,2014,Sainsburys,Groceries,85,321
14,3,2014,Starbucks Coffee,Eating Out,2,319
14,3,2014,Chicken Cottage,Eating Out,8,311
14,3,2014,Scott's Restaurant,Eating Out,44,267
15,3,2014,BRGAS-Electricity,Bills,43,224
15,3,2014,BRGAS-Gas,Bills,40,184
15,3,2014,Paying back Julie,,3,181
16,3,2014,LBS Council Tax,Bills,50,131
17,3,2014,South West Trains,Transport,32,99
17,3,2014,The West Cornwall Pasty Company,Eating Out,4,95
18,3,2014,Caffe Nero,Eating Out,2,93
18,3,2014,Chicken Cottage,Eating Out,5,88
19,3,2014,Caffe Nero,Eating Out,1,87
19,3,2014,Chicken Cottage,Eating Out,8,79
20,3,2014,VIRGIN MEDIA PYMTS,Bills,52,27
20,3,2014,Costa Coffee,Eating Out,2,25
20,3,2014,Pret A Manger,Eating Out,7,18
21,3,2014,Tescos,Groceries,55,-37
21,3,2014,Caffe Nero,Eating Out,2,-39
21,3,2014,Greggs,Eating Out,5,-44
21,3,2014,Fabric Club,Eating Out,11,-55
22,3,2014,Paying back James,,1,-56
23,3,2014,Scott's Restaurant,Eating Out,59,-115
24,3,2014,O2,Bills,36,-151
24,3,2014,South West Trains,Transport,35,-186
24,3,2014,Caffe Nero,Eating Out,1,-187
24,3,2014,Pret A Manger,Eating Out,6,-193
25,3,2014,Wild Bean Cafe,Eating Out,2,-195
25,3,2014,Greggs,Eating Out,7,-202
25,3,2014,Civic Shop,,1,-203
26,3,2014,Wild Bean Cafe,Eating Out,1,-204
27,3,2014,Wild Bean Cafe,Eating Out,2,-206
28,3,2014,Waitrose,Groceries,78,-284
28,3,2014,ATM Cash Withdrawal,General,20,-304
30,3,2014,Pizza Express,Eating Out,35,-339
30,3,2014,ATM Cash Withdrawal,General,20,-359
31,3,2014,South West Trains,Transport,38,-397
31,3,2014,Caffe Nero,Eating Out,1,-398
31,3,2014,ATM Cash Withdrawal,General,20,-418
1,4,2014,Rhino Sports salary,General,1700,1282
1,4,2014,Costa Coffee,Eating Out,2,1280
1,4,2014,McDonalds,Eating Out,4,1276
2,4,2014,Starbucks Coffee,Eating Out,1,1275
2,4,2014,The West Cornwall Pasty Company,Eating Out,4,1271
3,4,2014,Wild Bean Cafe,Eating Out,2,1269
3,4,2014,Greggs,Eating Out,8,1261
3,4,2014,Cheam Service Station,,4,1257
4,4,2014,Waitrose,Groceries,85,1172
4,4,2014,Starbucks Coffee,Eating Out,2,1170
4,4,2014,McDonalds,Eating Out,6,1164
4,4,2014,Pizza Express,Eating Out,41,1123
4,4,2014,Red Shop,,7,1116
7,4,2014,Cubit and West rent,Rent,550,566
7,4,2014,South West Trains,Transport,32,534
7,4,2014,Caffe Nero,Eating Out,1,533
8,4,2014,Caffe Nero,Eating Out,2,531
9,4,2014,Starbucks Coffee,Eating Out,1,530
9,4,2014,Paying back Julie,,7,523
10,4,2014,Caffe Nero,Eating Out,2,521
10,4,2014,McDonalds,Eating Out,6,515
11,4,2014,Sainsburys,Groceries,66,449
11,4,2014,Caffe Nero,Eating Out,2,447
11,4,2014,Pret A Manger,Eating Out,7,440
11,4,2014,ATM Cash Withdrawal,General,10,430
14,4,2014,South West Trains,Transport,24,406
14,4,2014,Costa Coffee,Eating Out,2,404
14,4,2014,Pret A Manger,Eating Out,5,399
14,4,2014,ATM Cash Withdrawal,General,20,379
15,4,2014,BRGAS-Electricity,Bills,33,346
15,4,2014,BRGAS-Gas,Bills,32,314
15,4,2014,Caffe Nero,Eating Out,2,312
15,4,2014,The West Cornwall Pasty Company,Eating Out,5,307
15,4,2014,ATM Cash Withdrawal,General,20,287
16,4,2014,LBS Council Tax,Bills,50,237
16,4,2014,ATM Cash Withdrawal,General,20,217
17,4,2014,Caffe Nero,Eating Out,2,215
17,4,2014,The West Cornwall Pasty Company,Eating Out,6,209
17,4,2014,ATM Cash Withdrawal,General,20,189
18,4,2014,Sainsburys,Groceries,50,139
18,4,2014,Costa Coffee,Eating Out,2,137
18,4,2014,McDonalds,Eating Out,6,131
18,4,2014,Anglo restaurant,Eating Out,40,91
18,4,2014,ATM Cash Withdrawal,General,10,81
20,4,2014,VIRGIN MEDIA PYMTS,Bills,32,49
20,4,2014,Dominos Pizza,Eating Out,53,-4
21,4,2014,South West Trains,Transport,34,-38
21,4,2014,Wild Bean Cafe,Eating Out,2,-40
21,4,2014,Subway,Eating Out,5,-45
21,4,2014,ATM Cash Withdrawal,General,20,-65
22,4,2014,Starbucks Coffee,Eating Out,2,-67
22,4,2014,Pret A Manger,Eating Out,4,-71
23,4,2014,McDonalds,Eating Out,7,-78
23,4,2014,ATM Cash Withdrawal,General,10,-88
24,4,2014,O2,Bills,31,-119
24,4,2014,Costa Coffee,Eating Out,2,-121
24,4,2014,Chicken Cottage,Eating Out,5,-126
25,4,2014,Tescos,Groceries,43,-169
25,4,2014,Wild Bean Cafe,Eating Out,1,-170
25,4,2014,ATM Cash Withdrawal,General,10,-180
26,4,2014,ATM Cash Withdrawal,General,20,-200
28,4,2014,South West Trains,Transport,26,-226
28,4,2014,Subway,Eating Out,8,-234
29,4,2014,Caffe Nero,Eating Out,2,-236
29,4,2014,Greggs,Eating Out,6,-242
29,4,2014,ATM Cash Withdrawal,General,20,-262
30,4,2014,ATM Cash Withdrawal,General,10,-272
1,5,2014,Rhino Sports salary,General,1700,1428
1,5,2014,Starbucks Coffee,Eating Out,1,1427
1,5,2014,Subway,Eating Out,8,1419
2,5,2014,Tescos,Groceries,89,1330
2,5,2014,Costa Coffee,Eating Out,2,1328
2,5,2014,Chicken Cottage,Eating Out,8,1320
2,5,2014,Civic Shop,,7,1313
4,5,2014,Scott's Restaurant,Eating Out,52,1261
4,5,2014,ATM Cash Withdrawal,General,20,1241
5,5,2014,South West Trains,Transport,26,1215
5,5,2014,Greggs,Eating Out,7,1208
6,5,2014,Starbucks Coffee,Eating Out,1,1207
6,5,2014,The West Cornwall Pasty Company,Eating Out,7,1200
7,5,2014,Cubit and West rent,Rent,550,650
7,5,2014,Caffe Nero,Eating Out,2,648
7,5,2014,Greggs,Eating Out,8,640
8,5,2014,Wild Bean Cafe,Eating Out,2,638
8,5,2014,The West Cornwall Pasty Company,Eating Out,8,630
8,5,2014,ATM Cash Withdrawal,General,20,610
9,5,2014,Sainsburys,Groceries,88,522
9,5,2014,Scott's Restaurant,Eating Out,33,489
10,5,2014,Restaurant Gordon RamsayPortland Restaurant,Eating Out,57,432
12,5,2014,South West Trains,Transport,32,400
12,5,2014,Greggs,Eating Out,5,395
12,5,2014,ATM Cash Withdrawal,General,10,385
14,5,2014,Starbucks Coffee,Eating Out,2,383
14,5,2014,Pret A Manger,Eating Out,6,377
15,5,2014,BRGAS-Electricity,Bills,26,351
15,5,2014,BRGAS-Gas,Bills,43,308
15,5,2014,Costa Coffee,Eating Out,2,306
15,5,2014,Chicken Cottage,Eating Out,8,298
16,5,2014,LBS Council Tax,Bills,50,248
16,5,2014,Tescos,Groceries,89,159
16,5,2014,Costa Coffee,Eating Out,2,157
16,5,2014,Subway,Eating Out,7,150
16,5,2014,ATM Cash Withdrawal,General,20,130
17,5,2014,Fabric Club,Eating Out,12,118
17,5,2014,Fabric Club,Eating Out,7,111
17,5,2014,Fabric Club,Eating Out,8,103
17,5,2014,ATM Cash Withdrawal,General,10,93
18,5,2014,Scott's Restaurant,Eating Out,37,56
19,5,2014,South West Trains,Transport,31,25
19,5,2014,Wild Bean Cafe,Eating Out,1,24
19,5,2014,Pret A Manger,Eating Out,7,17
20,5,2014,VIRGIN MEDIA PYMTS,Bills,35,-18
20,5,2014,Costa Coffee,Eating Out,2,-20
20,5,2014,Greggs,Eating Out,8,-28
21,5,2014,Starbucks Coffee,Eating Out,2,-30
22,5,2014,Costa Coffee,Eating Out,1,-31
22,5,2014,Pret A Manger,Eating Out,8,-39
23,5,2014,Sainsburys,Groceries,59,-98
23,5,2014,McDonalds,Eating Out,5,-103
23,5,2014,ATM Cash Withdrawal,General,10,-113
24,5,2014,O2,Bills,38,-151
26,5,2014,South West Trains,Transport,29,-180
26,5,2014,Costa Coffee,Eating Out,2,-182
26,5,2014,McDonalds,Eating Out,5,-187
27,5,2014,Costa Coffee,Eating Out,2,-189
27,5,2014,Red Shop,,1,-190
28,5,2014,Starbucks Coffee,Eating Out,2,-192
29,5,2014,Costa Coffee,Eating Out,1,-193
30,5,2014,Waitrose,Groceries,88,-281
30,5,2014,Wild Bean Cafe,Eating Out,1,-282
30,5,2014,Fabric Club,Eating Out,12,-294
30,5,2014,Fabric Club,Eating Out,11,-305
30,5,2014,ATM Cash Withdrawal,General,20,-325
31,5,2014,Fabric Club,Eating Out,15,-340
31,5,2014,Fabric Club,Eating Out,10,-350
31,5,2014,Pizza Express,Eating Out,47,-397
31,5,2014,ATM Cash Withdrawal,General,20,-417
1,6,2014,Rhino Sports salary,General,1700,1283
1,6,2014,Anglo restaurant,Eating Out,55,1228
2,6,2014,South West Trains,Transport,35,1193
2,6,2014,The West Cornwall Pasty Company,Eating Out,8,1185
3,6,2014,Starbucks Coffee,Eating Out,1,1184
3,6,2014,Greggs,Eating Out,6,1178
3,6,2014,ATM Cash Withdrawal,General,10,1168
4,6,2014,Costa Coffee,Eating Out,1,1167
4,6,2014,The West Cornwall Pasty Company,Eating Out,6,1161
4,6,2014,Cheam Service Station,,8,1153
5,6,2014,Wild Bean Cafe,Eating Out,2,1151
5,6,2014,Chicken Cottage,Eating Out,8,1143
6,6,2014,ASDA,Groceries,66,1077
6,6,2014,Wild Bean Cafe,Eating Out,1,1076
6,6,2014,Scott's Restaurant,Eating Out,45,1031
6,6,2014,Cheam Service Station,,2,1029
7,6,2014,Cubit and West rent,Rent,550,479
8,6,2014,Tool Tec,,9,470
9,6,2014,South West Trains,Transport,27,443
9,6,2014,Starbucks Coffee,Eating Out,2,441
9,6,2014,Chicken Cottage,Eating Out,5,436
10,6,2014,Caffe Nero,Eating Out,2,434
10,6,2014,Chicken Cottage,Eating Out,7,427
11,6,2014,Costa Coffee,Eating Out,2,425
11,6,2014,Subway,Eating Out,5,420
12,6,2014,Caffe Nero,Eating Out,1,419
12,6,2014,Chicken Cottage,Eating Out,5,414
13,6,2014,ASDA,Groceries,75,339
13,6,2014,Costa Coffee,Eating Out,1,338
13,6,2014,McDonalds,Eating Out,5,333
13,6,2014,Restaurant Gordon RamsayPortland Restaurant,Eating Out,46,287
13,6,2014,ATM Cash Withdrawal,General,10,277
14,6,2014,ATM Cash Withdrawal,General,10,267
15,6,2014,BRGAS-Electricity,Bills,21,246
15,6,2014,BRGAS-Gas,Bills,42,204
16,6,2014,LBS Council Tax,Bills,50,154
16,6,2014,South West Trains,Transport,30,124
16,6,2014,Caffe Nero,Eating Out,1,123
16,6,2014,Subway,Eating Out,5,118
17,6,2014,Costa Coffee,Eating Out,1,117
19,6,2014,Starbucks Coffee,Eating Out,2,115
19,6,2014,Greggs,Eating Out,5,110
20,6,2014,VIRGIN MEDIA PYMTS,Bills,46,64
20,6,2014,Tescos,Groceries,62,2
20,6,2014,The West Cornwall Pasty Company,Eating Out,8,-6
20,6,2014,ATM Cash Withdrawal,General,10,-16
21,6,2014,Ministry of Sound ClubXOYO Club,Eating Out,15,-31
21,6,2014,Ministry of Sound ClubXOYO Club,Eating Out,10,-41
21,6,2014,Ministry of Sound ClubXOYO Club,Eating Out,12,-53
21,6,2014,Ministry of Sound ClubXOYO Club,Eating Out,5,-58
21,6,2014,Ministry of Sound ClubXOYO Club,Eating Out,5,-63
21,6,2014,Restaurant Gordon RamsayPortland Restaurant,Eating Out,44,-107
23,6,2014,South West Trains,Transport,28,-135
23,6,2014,Caffe Nero,Eating Out,1,-136
23,6,2014,Greggs,Eating Out,4,-140
24,6,2014,O2,Bills,37,-177
24,6,2014,Starbucks Coffee,Eating Out,2,-179
24,6,2014,Greggs,Eating Out,4,-183
25,6,2014,Starbucks Coffee,Eating Out,1,-184
25,6,2014,Subway,Eating Out,7,-191
26,6,2014,Starbucks Coffee,Eating Out,2,-193
26,6,2014,Red Shop,,1,-194
27,6,2014,ASDA,Groceries,63,-257
27,6,2014,Costa Coffee,Eating Out,2,-259
27,6,2014,Ministry of Sound ClubXOYO Club,Eating Out,14,-273
27,6,2014,Ministry of Sound ClubXOYO Club,Eating Out,6,-279
27,6,2014,Ministry of Sound ClubXOYO Club,Eating Out,14,-293
27,6,2014,Ministry of Sound ClubXOYO Club,Eating Out,5,-298
29,6,2014,Restaurant Gordon RamsayPortland Restaurant,Eating Out,24,-322
30,6,2014,South West Trains,Transport,31,-353
30,6,2014,Caffe Nero,Eating Out,2,-355
30,6,2014,Chicken Cottage,Eating Out,7,-362
30,6,2014,ATM Cash Withdrawal,General,20,-382
1,7,2014,Rhino Sports salary,General,1700,1318
1,7,2014,McDonalds,Eating Out,8,1310
1,7,2014,ATM Cash Withdrawal,General,20,1290
2,7,2014,Starbucks Coffee,Eating Out,2,1288
2,7,2014,ATM Cash Withdrawal,General,20,1268
3,7,2014,Starbucks Coffee,Eating Out,2,1266
4,7,2014,Tescos,Groceries,43,1223
4,7,2014,Wild Bean Cafe,Eating Out,1,1222
4,7,2014,Pret A Manger,Eating Out,8,1214
5,7,2014,Anglo restaurant,Eating Out,41,1173
5,7,2014,ATM Cash Withdrawal,General,20,1153
7,7,2014,Cubit and West rent,Rent,550,603
7,7,2014,South West Trains,Transport,27,576
7,7,2014,Starbucks Coffee,Eating Out,2,574
8,7,2014,Costa Coffee,Eating Out,2,572
8,7,2014,Pret A Manger,Eating Out,7,565
8,7,2014,Paying back Julie,,2,563
9,7,2014,Wild Bean Cafe,Eating Out,1,562
10,7,2014,Paying back Julie,,8,554
11,7,2014,Waitrose,Groceries,55,499
11,7,2014,Wild Bean Cafe,Eating Out,2,497
11,7,2014,The West Cornwall Pasty Company,Eating Out,6,491
11,7,2014,ATM Cash Withdrawal,General,10,481
12,7,2014,Scott's Restaurant,Eating Out,40,441
12,7,2014,ATM Cash Withdrawal,General,20,421
14,7,2014,South West Trains,Transport,28,393
14,7,2014,Caffe Nero,Eating Out,1,392
14,7,2014,Pret A Manger,Eating Out,8,384
15,7,2014,BRGAS-Electricity,Bills,30,354
15,7,2014,BRGAS-Gas,Bills,41,313
15,7,2014,Costa Coffee,Eating Out,2,311
15,7,2014,Subway,Eating Out,6,305
15,7,2014,ATM Cash Withdrawal,General,10,295
15,7,2014,Civic Shop,,1,294
16,7,2014,LBS Council Tax,Bills,50,244
16,7,2014,Pret A Manger,Eating Out,6,238
17,7,2014,Starbucks Coffee,Eating Out,2,236
17,7,2014,ATM Cash Withdrawal,General,20,216
18,7,2014,Sainsburys,Groceries,46,170
18,7,2014,Wild Bean Cafe,Eating Out,2,168
18,7,2014,Greggs,Eating Out,4,164
18,7,2014,The Grand Pub,Eating Out,16,148
18,7,2014,The Grand Pub,Eating Out,9,139
18,7,2014,The Grand Pub,Eating Out,5,134
18,7,2014,The Grand Pub,Eating Out,8,126
18,7,2014,The Grand Pub,Eating Out,10,116
18,7,2014,Pizza Express,Eating Out,28,88
19,7,2014,Fabric Club,Eating Out,10,78
20,7,2014,VIRGIN MEDIA PYMTS,Bills,42,36
21,7,2014,South West Trains,Transport,24,12
21,7,2014,The West Cornwall Pasty Company,Eating Out,7,5
21,7,2014,ATM Cash Withdrawal,General,10,-5
21,7,2014,Paying back Julie,,2,-7
22,7,2014,Starbucks Coffee,Eating Out,2,-9
22,7,2014,Greggs,Eating Out,4,-13
23,7,2014,Caffe Nero,Eating Out,2,-15
24,7,2014,O2,Bills,31,-46
24,7,2014,Wild Bean Cafe,Eating Out,1,-47
24,7,2014,Subway,Eating Out,7,-54
25,7,2014,Tescos,Groceries,47,-101
25,7,2014,Starbucks Coffee,Eating Out,2,-103
25,7,2014,Pret A Manger,Eating Out,7,-110
25,7,2014,Pizza Express,Eating Out,58,-168
25,7,2014,ATM Cash Withdrawal,General,20,-188
26,7,2014,Anglo restaurant,Eating Out,51,-239
28,7,2014,South West Trains,Transport,25,-264
28,7,2014,Caffe Nero,Eating Out,2,-266
29,7,2014,Costa Coffee,Eating Out,1,-267
29,7,2014,McDonalds,Eating Out,4,-271
30,7,2014,Chicken Cottage,Eating Out,4,-275
30,7,2014,ATM Cash Withdrawal,General,20,-295
31,7,2014,Costa Coffee,Eating Out,1,-296
1,8,2014,Rhino Sports salary,General,1700,1404
1,8,2014,Tescos,Groceries,86,1318
1,8,2014,Starbucks Coffee,Eating Out,2,1316
1,8,2014,Dominos Pizza,Eating Out,59,1257
2,8,2014,Restaurant Gordon RamsayPortland Restaurant,Eating Out,42,1215
4,8,2014,South West Trains,Transport,34,1181
4,8,2014,Starbucks Coffee,Eating Out,2,1179
4,8,2014,Chicken Cottage,Eating Out,4,1175
5,8,2014,Caffe Nero,Eating Out,2,1173
5,8,2014,Subway,Eating Out,5,1168
7,8,2014,Cubit and West rent,Rent,550,618
7,8,2014,ATM Cash Withdrawal,General,10,608
8,8,2014,Tescos,Groceries,88,520
8,8,2014,Caffe Nero,Eating Out,1,519
8,8,2014,ATM Cash Withdrawal,General,20,499
11,8,2014,South West Trains,Transport,25,474
11,8,2014,Starbucks Coffee,Eating Out,1,473
12,8,2014,Starbucks Coffee,Eating Out,2,471
14,8,2014,Wild Bean Cafe,Eating Out,2,469
15,8,2014,BRGAS-Electricity,Bills,40,429
15,8,2014,BRGAS-Gas,Bills,25,404
15,8,2014,ASDA,Groceries,83,321
15,8,2014,Caffe Nero,Eating Out,2,319
15,8,2014,McDonalds,Eating Out,8,311
15,8,2014,Dominos Pizza,Eating Out,37,274
16,8,2014,LBS Council Tax,Bills,50,224
17,8,2014,Restaurant Gordon RamsayPortland Restaurant,Eating Out,27,197
17,8,2014,ATM Cash Withdrawal,General,10,187
18,8,2014,South West Trains,Transport,32,155
18,8,2014,Starbucks Coffee,Eating Out,2,153
18,8,2014,Chicken Cottage,Eating Out,7,146
19,8,2014,Starbucks Coffee,Eating Out,2,144
19,8,2014,Subway,Eating Out,8,136
20,8,2014,VIRGIN MEDIA PYMTS,Bills,56,80
20,8,2014,Costa Coffee,Eating Out,1,79
20,8,2014,Subway,Eating Out,8,71
21,8,2014,Wild Bean Cafe,Eating Out,1,70
21,8,2014,Chicken Cottage,Eating Out,7,63
22,8,2014,Sainsburys,Groceries,65,-2
22,8,2014,Starbucks Coffee,Eating Out,1,-3
22,8,2014,McDonalds,Eating Out,4,-7
22,8,2014,Scott's Restaurant,Eating Out,30,-37
23,8,2014,ATM Cash Withdrawal,General,20,-57
24,8,2014,O2,Bills,30,-87
24,8,2014,Scott's Restaurant,Eating Out,54,-141
24,8,2014,ATM Cash Withdrawal,General,20,-161
25,8,2014,South West Trains,Transport,24,-185
25,8,2014,Wild Bean Cafe,Eating Out,1,-186
25,8,2014,Chicken Cottage,Eating Out,6,-192
26,8,2014,Caffe Nero,Eating Out,2,-194
26,8,2014,McDonalds,Eating Out,6,-200
27,8,2014,Costa Coffee,Eating Out,2,-202
27,8,2014,Subway,Eating Out,8,-210
28,8,2014,Caffe Nero,Eating Out,2,-212
28,8,2014,Chicken Cottage,Eating Out,6,-218
29,8,2014,Morrisons,Groceries,89,-307
29,8,2014,Greggs,Eating Out,5,-312
1,9,2014,Rhino Sports salary,General,1700,1388
1,9,2014,South West Trains,Transport,34,1354
1,9,2014,Pret A Manger,Eating Out,5,1349
3,9,2014,Caffe Nero,Eating Out,1,1348
3,9,2014,Pret A Manger,Eating Out,8,1340
3,9,2014,ATM Cash Withdrawal,General,20,1320
4,9,2014,Wild Bean Cafe,Eating Out,1,1319
4,9,2014,Pret A Manger,Eating Out,8,1311
5,9,2014,ASDA,Groceries,60,1251
5,9,2014,Starbucks Coffee,Eating Out,1,1250
5,9,2014,Subway,Eating Out,6,1244
6,9,2014,Heaven Club,Eating Out,7,1237
6,9,2014,Heaven Club,Eating Out,16,1221
6,9,2014,Heaven Club,Eating Out,13,1208
7,9,2014,Cubit and West rent,Rent,550,658
7,9,2014,ATM Cash Withdrawal,General,10,648
7,9,2014,Tool Tec,,6,642
8,9,2014,South West Trains,Transport,31,611
8,9,2014,Starbucks Coffee,Eating Out,2,609
8,9,2014,Subway,Eating Out,6,603
8,9,2014,ATM Cash Withdrawal,General,10,593
9,9,2014,Costa Coffee,Eating Out,2,591
9,9,2014,Subway,Eating Out,8,583
9,9,2014,ATM Cash Withdrawal,General,20,563
10,9,2014,Pret A Manger,Eating Out,5,558
11,9,2014,Starbucks Coffee,Eating Out,1,557
11,9,2014,Greggs,Eating Out,8,549
12,9,2014,Morrisons,Groceries,73,476
12,9,2014,Wild Bean Cafe,Eating Out,2,474
13,9,2014,Scott's Restaurant,Eating Out,52,422
13,9,2014,ATM Cash Withdrawal,General,20,402
15,9,2014,BRGAS-Electricity,Bills,29,373
15,9,2014,BRGAS-Gas,Bills,36,337
15,9,2014,South West Trains,Transport,24,313
15,9,2014,Wild Bean Cafe,Eating Out,2,311
15,9,2014,Civic Shop,,7,304
16,9,2014,LBS Council Tax,Bills,50,254
16,9,2014,Starbucks Coffee,Eating Out,1,253
16,9,2014,ATM Cash Withdrawal,General,20,233
17,9,2014,Starbucks Coffee,Eating Out,2,231
17,9,2014,Greggs,Eating Out,4,227
18,9,2014,McDonalds,Eating Out,5,222
19,9,2014,Waitrose,Groceries,52,170
19,9,2014,Costa Coffee,Eating Out,2,168
20,9,2014,VIRGIN MEDIA PYMTS,Bills,42,126
21,9,2014,Anglo restaurant,Eating Out,31,95
22,9,2014,South West Trains,Transport,29,66
23,9,2014,Caffe Nero,Eating Out,2,64
23,9,2014,The West Cornwall Pasty Company,Eating Out,6,58
24,9,2014,O2,Bills,36,22
24,9,2014,Starbucks Coffee,Eating Out,1,21
24,9,2014,Red Shop,,9,12
25,9,2014,Caffe Nero,Eating Out,1,11
25,9,2014,Greggs,Eating Out,7,4
26,9,2014,Sainsburys,Groceries,85,-81
26,9,2014,Caffe Nero,Eating Out,1,-82
26,9,2014,Greggs,Eating Out,6,-88
26,9,2014,Scott's Restaurant,Eating Out,59,-147
28,9,2014,Restaurant Gordon RamsayPortland Restaurant,Eating Out,31,-178
28,9,2014,Civic Shop,,7,-185
29,9,2014,South West Trains,Transport,30,-215
29,9,2014,Subway,Eating Out,7,-222
30,9,2014,McDonalds,Eating Out,4,-226
30,9,2014,ATM Cash Withdrawal,General,20,-246
1,10,2014,Rhino Sports salary,General,1700,1454
2,10,2014,Costa Coffee,Eating Out,2,1452
2,10,2014,Greggs,Eating Out,7,1445
3,10,2014,Morrisons,Groceries,86,1359
3,10,2014,Starbucks Coffee,Eating Out,1,1358
3,10,2014,Greggs,Eating Out,5,1353
4,10,2014,ATM Cash Withdrawal,General,10,1343
6,10,2014,South West Trains,Transport,33,1310
6,10,2014,Caffe Nero,Eating Out,1,1309
6,10,2014,Subway,Eating Out,4,1305
7,10,2014,Cubit and West rent,Rent,550,755
7,10,2014,Wild Bean Cafe,Eating Out,2,753
7,10,2014,McDonalds,Eating Out,6,747
8,10,2014,Costa Coffee,Eating Out,1,746
9,10,2014,Costa Coffee,Eating Out,1,745
9,10,2014,Greggs,Eating Out,7,738
10,10,2014,Sainsburys,Groceries,54,684
10,10,2014,Wild Bean Cafe,Eating Out,2,682
10,10,2014,ATM Cash Withdrawal,General,10,672
10,10,2014,Red Shop,,1,671
12,10,2014,Scott's Restaurant,Eating Out,43,628
13,10,2014,South West Trains,Transport,25,603
13,10,2014,Caffe Nero,Eating Out,2,601
13,10,2014,ATM Cash Withdrawal,General,20,581
14,10,2014,Costa Coffee,Eating Out,2,579
15,10,2014,BRGAS-Electricity,Bills,30,549
15,10,2014,BRGAS-Gas,Bills,28,521
15,10,2014,Wild Bean Cafe,Eating Out,1,520
16,10,2014,LBS Council Tax,Bills,50,470
16,10,2014,Costa Coffee,Eating Out,2,468
16,10,2014,ATM Cash Withdrawal,General,20,448
17,10,2014,Sainsburys,Groceries,69,379
17,10,2014,Caffe Nero,Eating Out,2,377
17,10,2014,Pret A Manger,Eating Out,5,372
20,10,2014,VIRGIN MEDIA PYMTS,Bills,57,315
20,10,2014,South West Trains,Transport,27,288
20,10,2014,Costa Coffee,Eating Out,1,287
21,10,2014,Starbucks Coffee,Eating Out,2,285
21,10,2014,Chicken Cottage,Eating Out,5,280
21,10,2014,ATM Cash Withdrawal,General,10,270
22,10,2014,Costa Coffee,Eating Out,2,268
22,10,2014,The West Cornwall Pasty Company,Eating Out,5,263
23,10,2014,Pret A Manger,Eating Out,8,255
24,10,2014,O2,Bills,30,225
24,10,2014,ASDA,Groceries,49,176
24,10,2014,Wild Bean Cafe,Eating Out,2,174
25,10,2014,Pizza Express,Eating Out,59,115
26,10,2014,Pizza Express,Eating Out,50,65
26,10,2014,ATM Cash Withdrawal,General,10,55
27,10,2014,South West Trains,Transport,27,28
27,10,2014,Costa Coffee,Eating Out,1,27
28,10,2014,Costa Coffee,Eating Out,2,25
28,10,2014,Pret A Manger,Eating Out,8,17
28,10,2014,ATM Cash Withdrawal,General,20,-3
29,10,2014,ATM Cash Withdrawal,General,20,-23
30,10,2014,Costa Coffee,Eating Out,1,-24
30,10,2014,ATM Cash Withdrawal,General,20,-44
30,10,2014,Cheam Service Station,,5,-49
31,10,2014,Sainsburys,Groceries,86,-135
31,10,2014,Wild Bean Cafe,Eating Out,2,-137
31,10,2014,McDonalds,Eating Out,6,-143
1,11,2014,Rhino Sports salary,General,1700,1557
2,11,2014,Civic Shop,,8,1549
3,11,2014,South West Trains,Transport,38,1511
4,11,2014,Greggs,Eating Out,8,1503
4,11,2014,Red Shop,,3,1500
5,11,2014,Costa Coffee,Eating Out,1,1499
6,11,2014,Costa Coffee,Eating Out,1,1498
6,11,2014,Subway,Eating Out,8,1490
7,11,2014,Cubit and West rent,Rent,550,940
7,11,2014,ASDA,Groceries,59,881
7,11,2014,Caffe Nero,Eating Out,2,879
7,11,2014,Anglo restaurant,Eating Out,47,832
10,11,2014,South West Trains,Transport,24,808
10,11,2014,Starbucks Coffee,Eating Out,2,806
10,11,2014,Chicken Cottage,Eating Out,8,798
10,11,2014,ATM Cash Withdrawal,General,20,778
10,11,2014,Paying back James,,3,775
12,11,2014,Caffe Nero,Eating Out,2,773
12,11,2014,Chicken Cottage,Eating Out,7,766
12,11,2014,ATM Cash Withdrawal,General,20,746
12,11,2014,Tool Tec,,9,737
13,11,2014,Costa Coffee,Eating Out,2,735
13,11,2014,Pret A Manger,Eating Out,4,731
13,11,2014,ATM Cash Withdrawal,General,10,721
14,11,2014,Sainsburys,Groceries,47,674
14,11,2014,Wild Bean Cafe,Eating Out,2,672
14,11,2014,Dominos Pizza,Eating Out,29,643
15,11,2014,BRGAS-Electricity,Bills,56,587
15,11,2014,BRGAS-Gas,Bills,38,549
15,11,2014,Anglo restaurant,Eating Out,48,501
16,11,2014,LBS Council Tax,Bills,50,451
17,11,2014,South West Trains,Transport,29,422
17,11,2014,Wild Bean Cafe,Eating Out,2,420
18,11,2014,Starbucks Coffee,Eating Out,2,418
18,11,2014,The West Cornwall Pasty Company,Eating Out,4,414
19,11,2014,Costa Coffee,Eating Out,2,412
19,11,2014,ATM Cash Withdrawal,General,10,402
20,11,2014,VIRGIN MEDIA PYMTS,Bills,44,358
20,11,2014,Wild Bean Cafe,Eating Out,1,357
21,11,2014,ASDA,Groceries,57,300
21,11,2014,Costa Coffee,Eating Out,2,298
21,11,2014,Subway,Eating Out,7,291
22,11,2014,Pizza Express,Eating Out,29,262
22,11,2014,ATM Cash Withdrawal,General,20,242
24,11,2014,O2,Bills,38,204
24,11,2014,South West Trains,Transport,31,173
24,11,2014,Costa Coffee,Eating Out,1,172
25,11,2014,Caffe Nero,Eating Out,1,171
25,11,2014,Subway,Eating Out,7,164
26,11,2014,Wild Bean Cafe,Eating Out,2,162
26,11,2014,Greggs,Eating Out,4,158
27,11,2014,Starbucks Coffee,Eating Out,2,156
27,11,2014,Greggs,Eating Out,4,152
28,11,2014,ASDA,Groceries,74,78
28,11,2014,Starbucks Coffee,Eating Out,1,77
28,11,2014,Greggs,Eating Out,5,72
28,11,2014,Fabric Club,Eating Out,12,60
28,11,2014,Fabric Club,Eating Out,10,50
28,11,2014,Fabric Club,Eating Out,8,42
28,11,2014,Fabric Club,Eating Out,11,31
28,11,2014,Pizza Express,Eating Out,57,-26
30,11,2014,ATM Cash Withdrawal,General,10,-36
1,12,2014,Rhino Sports salary,General,1700,1664
1,12,2014,South West Trains,Transport,29,1635
1,12,2014,Costa Coffee,Eating Out,1,1634
1,12,2014,ATM Cash Withdrawal,General,20,1614
2,12,2014,Wild Bean Cafe,Eating Out,2,1612
2,12,2014,Greggs,Eating Out,4,1608
2,12,2014,Civic Shop,,8,1600
3,12,2014,Pret A Manger,Eating Out,6,1594
3,12,2014,Tool Shop,,4,1590
4,12,2014,Starbucks Coffee,Eating Out,1,1589
5,12,2014,Sainsburys,Groceries,87,1502
5,12,2014,Wild Bean Cafe,Eating Out,2,1500
5,12,2014,Chicken Cottage,Eating Out,5,1495
5,12,2014,ATM Cash Withdrawal,General,10,1485
6,12,2014,The Grand Pub,Eating Out,7,1478
6,12,2014,The Grand Pub,Eating Out,7,1471
6,12,2014,The Grand Pub,Eating Out,14,1457
6,12,2014,Scott's Restaurant,Eating Out,37,1420
6,12,2014,ATM Cash Withdrawal,General,20,1400
7,12,2014,Cubit and West rent,Rent,550,850
8,12,2014,South West Trains,Transport,27,823
8,12,2014,Costa Coffee,Eating Out,2,821
8,12,2014,Chicken Cottage,Eating Out,8,813
9,12,2014,Wild Bean Cafe,Eating Out,1,812
9,12,2014,ATM Cash Withdrawal,General,10,802
9,12,2014,Paying back Julie,,7,795
10,12,2014,Caffe Nero,Eating Out,2,793
11,12,2014,Greggs,Eating Out,4,789
12,12,2014,Tescos,Groceries,55,734
12,12,2014,Caffe Nero,Eating Out,2,732
14,12,2014,Scott's Restaurant,Eating Out,59,673
14,12,2014,Paying back Julie,,4,669
15,12,2014,BRGAS-Electricity,Bills,39,630
15,12,2014,BRGAS-Gas,Bills,35,595
15,12,2014,South West Trains,Transport,34,561
15,12,2014,McDonalds,Eating Out,6,555
15,12,2014,ATM Cash Withdrawal,General,10,545
16,12,2014,LBS Council Tax,Bills,50,495
16,12,2014,Costa Coffee,Eating Out,2,493
17,12,2014,Caffe Nero,Eating Out,2,491
17,12,2014,Greggs,Eating Out,8,483
17,12,2014,ATM Cash Withdrawal,General,10,473
18,12,2014,Wild Bean Cafe,Eating Out,1,472
18,12,2014,ATM Cash Withdrawal,General,10,462
19,12,2014,Sainsburys,Groceries,53,409
19,12,2014,Wild Bean Cafe,Eating Out,2,407
19,12,2014,The West Cornwall Pasty Company,Eating Out,7,400
20,12,2014,VIRGIN MEDIA PYMTS,Bills,37,363
20,12,2014,Scott's Restaurant,Eating Out,57,306
21,12,2014,Restaurant Gordon RamsayPortland Restaurant,Eating Out,55,251
21,12,2014,ATM Cash Withdrawal,General,10,241
22,12,2014,South West Trains,Transport,28,213
22,12,2014,Caffe Nero,Eating Out,1,212
23,12,2014,Starbucks Coffee,Eating Out,1,211
23,12,2014,The West Cornwall Pasty Company,Eating Out,6,205
24,12,2014,O2,Bills,30,175
24,12,2014,Starbucks Coffee,Eating Out,1,174
24,12,2014,Chicken Cottage,Eating Out,5,169
25,12,2014,Starbucks Coffee,Eating Out,2,167
25,12,2014,Chicken Cottage,Eating Out,4,163
25,12,2014,Civic Shop,,5,158
26,12,2014,Waitrose,Groceries,73,85
26,12,2014,Chicken Cottage,Eating Out,7,78
26,12,2014,Pizza Express,Eating Out,35,43
27,12,2014,Restaurant Gordon RamsayPortland Restaurant,Eating Out,46,-3
29,12,2014,South West Trains,Transport,27,-30
29,12,2014,Costa Coffee,Eating Out,2,-32
30,12,2014,Starbucks Coffee,Eating Out,2,-34
30,12,2014,Greggs,Eating Out,4,-38
30,12,2014,ATM Cash Withdrawal,General,10,-48
31,12,2014,Wild Bean Cafe,Eating Out,2,-50
31,12,2014,Civic Shop,,4,-54
1,1,2015,Rhino Sports salary,General,1700,1646
1,1,2015,Caffe Nero,Eating Out,2,1644
2,1,2015,Sainsburys,Groceries,46,1598
2,1,2015,Starbucks Coffee,Eating Out,2,1596
2,1,2015,Greggs,Eating Out,8,1588
3,1,2015,ATM Cash Withdrawal,General,10,1578
4,1,2015,Dominos Pizza,Eating Out,29,1549
5,1,2015,South West Trains,Transport,30,1519
5,1,2015,Costa Coffee,Eating Out,2,1517
6,1,2015,Caffe Nero,Eating Out,2,1515
7,1,2015,Cubit and West rent,Rent,550,965
7,1,2015,Wild Bean Cafe,Eating Out,1,964
7,1,2015,McDonalds,Eating Out,4,960
8,1,2015,Caffe Nero,Eating Out,2,958
8,1,2015,The West Cornwall Pasty Company,Eating Out,7,951
9,1,2015,Sainsburys,Groceries,47,904
9,1,2015,Caffe Nero,Eating Out,2,902
9,1,2015,Chicken Cottage,Eating Out,6,896
9,1,2015,Dominos Pizza,Eating Out,52,844
9,1,2015,ATM Cash Withdrawal,General,20,824
11,1,2015,ATM Cash Withdrawal,General,10,814
12,1,2015,South West Trains,Transport,34,780
12,1,2015,Wild Bean Cafe,Eating Out,2,778
12,1,2015,ATM Cash Withdrawal,General,10,768
12,1,2015,Paying back James,,8,760
13,1,2015,Chicken Cottage,Eating Out,6,754
14,1,2015,Wild Bean Cafe,Eating Out,1,753
15,1,2015,BRGAS-Electricity,Bills,52,701
15,1,2015,BRGAS-Gas,Bills,97,604
15,1,2015,Wild Bean Cafe,Eating Out,2,602
15,1,2015,Pret A Manger,Eating Out,5,597
16,1,2015,LBS Council Tax,Bills,50,547
16,1,2015,Sainsburys,Groceries,56,491
16,1,2015,Starbucks Coffee,Eating Out,2,489
16,1,2015,ATM Cash Withdrawal,General,10,479
18,1,2015,Dominos Pizza,Eating Out,55,424
19,1,2015,South West Trains,Transport,34,390
19,1,2015,Costa Coffee,Eating Out,2,388
19,1,2015,Greggs,Eating Out,5,383
19,1,2015,Tool Tec,,6,377
20,1,2015,VIRGIN MEDIA PYMTS,Bills,44,333
20,1,2015,Costa Coffee,Eating Out,2,331
20,1,2015,Greggs,Eating Out,5,326
21,1,2015,Wild Bean Cafe,Eating Out,1,325
21,1,2015,Subway,Eating Out,7,318
23,1,2015,Tescos,Groceries,53,265
23,1,2015,Starbucks Coffee,Eating Out,1,264
24,1,2015,O2,Bills,31,233
25,1,2015,ATM Cash Withdrawal,General,10,223
26,1,2015,South West Trains,Transport,38,185
26,1,2015,Pret A Manger,Eating Out,6,179
26,1,2015,Civic Shop,,7,172
27,1,2015,Costa Coffee,Eating Out,2,170
27,1,2015,Chicken Cottage,Eating Out,5,165
28,1,2015,ATM Cash Withdrawal,General,20,145
29,1,2015,Starbucks Coffee,Eating Out,1,144
30,1,2015,Tescos,Groceries,84,60
30,1,2015,Caffe Nero,Eating Out,2,58
31,1,2015,Pizza Express,Eating Out,24,34
1,2,2015,Rhino Sports salary,General,1700,1734
1,2,2015,Anglo restaurant,Eating Out,32,1702
1,2,2015,ATM Cash Withdrawal,General,20,1682
2,2,2015,South West Trains,Transport,26,1656
2,2,2015,Caffe Nero,Eating Out,2,1654
4,2,2015,Costa Coffee,Eating Out,2,1652
4,2,2015,Chicken Cottage,Eating Out,8,1644
4,2,2015,Red Shop,,7,1637
5,2,2015,Starbucks Coffee,Eating Out,1,1636
6,2,2015,Morrisons,Groceries,62,1574
6,2,2015,The West Cornwall Pasty Company,Eating Out,7,1567
6,2,2015,Fabric Club,Eating Out,13,1554
6,2,2015,Fabric Club,Eating Out,16,1538
6,2,2015,Anglo restaurant,Eating Out,48,1490
6,2,2015,Tool Tec,,4,1486
7,2,2015,Cubit and West rent,Rent,550,936
7,2,2015,Anglo restaurant,Eating Out,25,911
8,2,2015,Cheam Service Station,,1,910
9,2,2015,South West Trains,Transport,36,874
10,2,2015,Wild Bean Cafe,Eating Out,2,872
10,2,2015,Red Shop,,1,871
11,2,2015,Starbucks Coffee,Eating Out,2,869
11,2,2015,Pret A Manger,Eating Out,6,863
12,2,2015,Caffe Nero,Eating Out,2,861
12,2,2015,McDonalds,Eating Out,7,854
12,2,2015,ATM Cash Withdrawal,General,20,834
13,2,2015,Sainsburys,Groceries,64,770
13,2,2015,ATM Cash Withdrawal,General,10,760
14,2,2015,Dominos Pizza,Eating Out,49,711
15,2,2015,BRGAS-Electricity,Bills,40,671
15,2,2015,BRGAS-Gas,Bills,41,630
16,2,2015,LBS Council Tax,Bills,50,580
16,2,2015,South West Trains,Transport,26,554
16,2,2015,Costa Coffee,Eating Out,1,553
16,2,2015,Greggs,Eating Out,5,548
16,2,2015,ATM Cash Withdrawal,General,10,538
17,2,2015,Starbucks Coffee,Eating Out,1,537
17,2,2015,Chicken Cottage,Eating Out,4,533
17,2,2015,Tool Shop,,8,525
18,2,2015,Wild Bean Cafe,Eating Out,2,523
18,2,2015,Subway,Eating Out,7,516
19,2,2015,Costa Coffee,Eating Out,2,514
19,2,2015,Chicken Cottage,Eating Out,7,507
19,2,2015,ATM Cash Withdrawal,General,10,497
20,2,2015,VIRGIN MEDIA PYMTS,Bills,42,455
20,2,2015,ASDA,Groceries,48,407
20,2,2015,Costa Coffee,Eating Out,2,405
20,2,2015,Chicken Cottage,Eating Out,4,401
21,2,2015,Scott's Restaurant,Eating Out,59,342
21,2,2015,ATM Cash Withdrawal,General,20,322
23,2,2015,South West Trains,Transport,36,286
23,2,2015,Wild Bean Cafe,Eating Out,2,284
23,2,2015,Pret A Manger,Eating Out,6,278
24,2,2015,O2,Bills,34,244
24,2,2015,Wild Bean Cafe,Eating Out,1,243
24,2,2015,Subway,Eating Out,4,239
24,2,2015,ATM Cash Withdrawal,General,10,229
25,2,2015,Starbucks Coffee,Eating Out,1,228
26,2,2015,Wild Bean Cafe,Eating Out,1,227
26,2,2015,Greggs,Eating Out,4,223
27,2,2015,Tescos,Groceries,65,158
27,2,2015,Costa Coffee,Eating Out,1,157
27,2,2015,Heaven Club,Eating Out,8,149
27,2,2015,Heaven Club,Eating Out,13,136
27,2,2015,Heaven Club,Eating Out,5,131
1,3,2015,Rhino Sports salary,General,1700,1831
1,3,2015,ATM Cash Withdrawal,General,10,1821
2,3,2015,South West Trains,Transport,24,1797
2,3,2015,Starbucks Coffee,Eating Out,2,1795
2,3,2015,McDonalds,Eating Out,6,1789
4,3,2015,Caffe Nero,Eating Out,1,1788
5,3,2015,Starbucks Coffee,Eating Out,1,1787
5,3,2015,McDonalds,Eating Out,5,1782
6,3,2015,Morrisons,Groceries,84,1698
6,3,2015,Wild Bean Cafe,Eating Out,2,1696
6,3,2015,Dominos Pizza,Eating Out,26,1670
6,3,2015,Civic Shop,,6,1664
7,3,2015,Cubit and West rent,Rent,550,1114
7,3,2015,ATM Cash Withdrawal,General,10,1104
9,3,2015,South West Trains,Transport,26,1078
9,3,2015,Starbucks Coffee,Eating Out,1,1077
9,3,2015,ATM Cash Withdrawal,General,10,1067
10,3,2015,Costa Coffee,Eating Out,1,1066
10,3,2015,Tool Shop,,5,1061
11,3,2015,Caffe Nero,Eating Out,2,1059
11,3,2015,Paying back Julie,,8,1051
12,3,2015,Starbucks Coffee,Eating Out,1,1050
12,3,2015,McDonalds,Eating Out,7,1043
13,3,2015,Waitrose,Groceries,69,974
13,3,2015,Caffe Nero,Eating Out,2,972
13,3,2015,Pret A Manger,Eating Out,7,965
14,3,2015,ATM Cash Withdrawal,General,10,955
15,3,2015,BRGAS-Electricity,Bills,21,934
15,3,2015,BRGAS-Gas,Bills,44,890
15,3,2015,Restaurant Gordon RamsayPortland Restaurant,Eating Out,38,852
15,3,2015,Tool Tec,,9,843
16,3,2015,LBS Council Tax,Bills,50,793
16,3,2015,South West Trains,Transport,32,761
16,3,2015,Costa Coffee,Eating Out,2,759
17,3,2015,Caffe Nero,Eating Out,1,758
17,3,2015,Pret A Manger,Eating Out,7,751
18,3,2015,Caffe Nero,Eating Out,2,749
18,3,2015,Greggs,Eating Out,8,741
18,3,2015,ATM Cash Withdrawal,General,20,721
19,3,2015,Wild Bean Cafe,Eating Out,2,719
19,3,2015,Greggs,Eating Out,6,713
20,3,2015,VIRGIN MEDIA PYMTS,Bills,48,665
20,3,2015,Tescos,Groceries,55,610
20,3,2015,McDonalds,Eating Out,6,604
20,3,2015,The Grand Pub,Eating Out,13,591
20,3,2015,ATM Cash Withdrawal,General,20,571
22,3,2015,Cheam Service Station,,5,566
23,3,2015,South West Trains,Transport,25,541
23,3,2015,Chicken Cottage,Eating Out,8,533
24,3,2015,O2,Bills,30,503
24,3,2015,McDonalds,Eating Out,5,498
24,3,2015,ATM Cash Withdrawal,General,10,488
25,3,2015,Caffe Nero,Eating Out,1,487
25,3,2015,Paying back Julie,,3,484
26,3,2015,Starbucks Coffee,Eating Out,2,482
26,3,2015,Pret A Manger,Eating Out,8,474
27,3,2015,Morrisons,Groceries,48,426
27,3,2015,Wild Bean Cafe,Eating Out,2,424
27,3,2015,Subway,Eating Out,4,420
27,3,2015,Paying back James,,7,413
29,3,2015,Restaurant Gordon RamsayPortland Restaurant,Eating Out,26,387
30,3,2015,South West Trains,Transport,26,361
30,3,2015,Starbucks Coffee,Eating Out,2,359
30,3,2015,Subway,Eating Out,4,355
30,3,2015,ATM Cash Withdrawal,General,10,345
30,3,2015,Tool Shop,,1,344
31,3,2015,Wild Bean Cafe,Eating Out,1,343
31,3,2015,ATM Cash Withdrawal,General,20,323
1,4,2015,Rhino Sports salary,General,1700,2023
1,4,2015,The West Cornwall Pasty Company,Eating Out,4,2019
1,4,2015,ATM Cash Withdrawal,General,20,1999
2,4,2015,Caffe Nero,Eating Out,2,1997
3,4,2015,ASDA,Groceries,58,1939
4,4,2015,Tool Tec,,3,1936
6,4,2015,South West Trains,Transport,33,1903
6,4,2015,Wild Bean Cafe,Eating Out,2,1901
6,4,2015,Greggs,Eating Out,6,1895
7,4,2015,Cubit and West rent,Rent,550,1345
8,4,2015,Starbucks Coffee,Eating Out,2,1343
9,4,2015,Costa Coffee,Eating Out,2,1341
9,4,2015,Chicken Cottage,Eating Out,4,1337
9,4,2015,Civic Shop,,5,1332
10,4,2015,ASDA,Groceries,45,1287
10,4,2015,Chicken Cottage,Eating Out,5,1282
10,4,2015,ATM Cash Withdrawal,General,10,1272
11,4,2015,ATM Cash Withdrawal,General,10,1262
12,4,2015,ATM Cash Withdrawal,General,10,1252
13,4,2015,South West Trains,Transport,31,1221
13,4,2015,Caffe Nero,Eating Out,2,1219
13,4,2015,Pret A Manger,Eating Out,6,1213
14,4,2015,Wild Bean Cafe,Eating Out,1,1212
14,4,2015,The West Cornwall Pasty Company,Eating Out,8,1204
15,4,2015,BRGAS-Electricity,Bills,40,1164
15,4,2015,BRGAS-Gas,Bills,42,1122
15,4,2015,McDonalds,Eating Out,8,1114
15,4,2015,ATM Cash Withdrawal,General,20,1094
16,4,2015,LBS Council Tax,Bills,50,1044
16,4,2015,Costa Coffee,Eating Out,2,1042
16,4,2015,The West Cornwall Pasty Company,Eating Out,6,1036
17,4,2015,ASDA,Groceries,70,966
17,4,2015,Caffe Nero,Eating Out,1,965
17,4,2015,Fabric Club,Eating Out,15,950
17,4,2015,Fabric Club,Eating Out,13,937
19,4,2015,Scott's Restaurant,Eating Out,56,881
20,4,2015,VIRGIN MEDIA PYMTS,Bills,50,831
20,4,2015,South West Trains,Transport,37,794
20,4,2015,Caffe Nero,Eating Out,2,792
20,4,2015,Pret A Manger,Eating Out,4,788
21,4,2015,Caffe Nero,Eating Out,2,786
21,4,2015,Chicken Cottage,Eating Out,5,781
21,4,2015,ATM Cash Withdrawal,General,20,761
22,4,2015,Costa Coffee,Eating Out,1,760
22,4,2015,The West Cornwall Pasty Company,Eating Out,8,752
22,4,2015,ATM Cash Withdrawal,General,20,732
22,4,2015,Paying back James,,5,727
23,4,2015,Wild Bean Cafe,Eating Out,2,725
23,4,2015,Greggs,Eating Out,4,721
23,4,2015,Paying back Julie,,3,718
24,4,2015,O2,Bills,35,683
24,4,2015,Tescos,Groceries,69,614
24,4,2015,Costa Coffee,Eating Out,2,612
24,4,2015,Paying back James,,6,606
26,4,2015,Scott's Restaurant,Eating Out,39,567
27,4,2015,South West Trains,Transport,38,529
27,4,2015,Costa Coffee,Eating Out,2,527
27,4,2015,Chicken Cottage,Eating Out,8,519
28,4,2015,Starbucks Coffee,Eating Out,1,518
28,4,2015,McDonalds,Eating Out,6,512
28,4,2015,ATM Cash Withdrawal,General,20,492
29,4,2015,ATM Cash Withdrawal,General,10,482
30,4,2015,Starbucks Coffee,Eating Out,2,480
30,4,2015,Pret A Manger,Eating Out,8,472
1,5,2015,Rhino Sports salary,General,1700,2172
1,5,2015,Waitrose,Groceries,65,2107
1,5,2015,Costa Coffee,Eating Out,2,2105
1,5,2015,Dominos Pizza,Eating Out,27,2078
1,5,2015,ATM Cash Withdrawal,General,10,2068
1,5,2015,Civic Shop,,9,2059
2,5,2015,Anglo restaurant,Eating Out,46,2013
3,5,2015,Restaurant Gordon RamsayPortland Restaurant,Eating Out,40,1973
4,5,2015,South West Trains,Transport,33,1940
4,5,2015,Caffe Nero,Eating Out,1,1939
4,5,2015,ATM Cash Withdrawal,General,10,1929
5,5,2015,Costa Coffee,Eating Out,2,1927
5,5,2015,Subway,Eating Out,4,1923
5,5,2015,Tool Shop,,1,1922
6,5,2015,Starbucks Coffee,Eating Out,1,1921
6,5,2015,The West Cornwall Pasty Company,Eating Out,8,1913
7,5,2015,Cubit and West rent,Rent,550,1363
7,5,2015,Wild Bean Cafe,Eating Out,1,1362
8,5,2015,Waitrose,Groceries,79,1283
8,5,2015,Chicken Cottage,Eating Out,7,1276
11,5,2015,South West Trains,Transport,26,1250
11,5,2015,Costa Coffee,Eating Out,2,1248
11,5,2015,Subway,Eating Out,7,1241
11,5,2015,Tool Tec,,5,1236
12,5,2015,Wild Bean Cafe,Eating Out,2,1234
12,5,2015,The West Cornwall Pasty Company,Eating Out,7,1227
13,5,2015,Paying back James,,7,1220
14,5,2015,Starbucks Coffee,Eating Out,2,1218
15,5,2015,BRGAS-Electricity,Bills,38,1180
15,5,2015,BRGAS-Gas,Bills,29,1151
15,5,2015,Morrisons,Groceries,71,1080
15,5,2015,Greggs,Eating Out,6,1074
15,5,2015,Anglo restaurant,Eating Out,29,1045
16,5,2015,LBS Council Tax,Bills,50,995
17,5,2015,Restaurant Gordon RamsayPortland Restaurant,Eating Out,25,970
17,5,2015,ATM Cash Withdrawal,General,10,960
18,5,2015,South West Trains,Transport,27,933
18,5,2015,Starbucks Coffee,Eating Out,2,931
19,5,2015,ATM Cash Withdrawal,General,10,921
19,5,2015,Tool Shop,,1,920
20,5,2015,VIRGIN MEDIA PYMTS,Bills,51,869
20,5,2015,Costa Coffee,Eating Out,2,867
20,5,2015,The West Cornwall Pasty Company,Eating Out,4,863
20,5,2015,Paying back James,,3,860
21,5,2015,Wild Bean Cafe,Eating Out,1,859
21,5,2015,Greggs,Eating Out,7,852
21,5,2015,ATM Cash Withdrawal,General,10,842
22,5,2015,Tescos,Groceries,87,755
22,5,2015,Starbucks Coffee,Eating Out,2,753
22,5,2015,Subway,Eating Out,8,745
23,5,2015,Ministry of Sound ClubXOYO Club,Eating Out,9,736
23,5,2015,Ministry of Sound ClubXOYO Club,Eating Out,13,723
23,5,2015,Ministry of Sound ClubXOYO Club,Eating Out,14,709
23,5,2015,Ministry of Sound ClubXOYO Club,Eating Out,13,696
23,5,2015,Ministry of Sound ClubXOYO Club,Eating Out,14,682
23,5,2015,Scott's Restaurant,Eating Out,58,624
23,5,2015,ATM Cash Withdrawal,General,10,614
24,5,2015,O2,Bills,34,580
25,5,2015,South West Trains,Transport,38,542
25,5,2015,Caffe Nero,Eating Out,1,541
25,5,2015,McDonalds,Eating Out,5,536
26,5,2015,Pret A Manger,Eating Out,8,528
27,5,2015,Starbucks Coffee,Eating Out,2,526
27,5,2015,McDonalds,Eating Out,7,519
28,5,2015,Wild Bean Cafe,Eating Out,2,517
28,5,2015,The West Cornwall Pasty Company,Eating Out,7,510
29,5,2015,ASDA,Groceries,80,430
29,5,2015,Caffe Nero,Eating Out,2,428
29,5,2015,The Grand Pub,Eating Out,5,423
29,5,2015,The Grand Pub,Eating Out,10,413
29,5,2015,The Grand Pub,Eating Out,14,399
29,5,2015,The Grand Pub,Eating Out,12,387
29,5,2015,The Grand Pub,Eating Out,8,379
30,5,2015,Dominos Pizza,Eating Out,55,324
31,5,2015,ATM Cash Withdrawal,General,10,314
1,6,2015,Rhino Sports salary,General,1700,2014
1,6,2015,South West Trains,Transport,32,1982
1,6,2015,Costa Coffee,Eating Out,1,1981
1,6,2015,Chicken Cottage,Eating Out,4,1977
1,6,2015,ATM Cash Withdrawal,General,10,1967
2,6,2015,Costa Coffee,Eating Out,2,1965
2,6,2015,McDonalds,Eating Out,5,1960
3,6,2015,Wild Bean Cafe,Eating Out,2,1958
3,6,2015,ATM Cash Withdrawal,General,20,1938
4,6,2015,Wild Bean Cafe,Eating Out,1,1937
5,6,2015,ASDA,Groceries,73,1864
5,6,2015,Costa Coffee,Eating Out,1,1863
5,6,2015,Pret A Manger,Eating Out,7,1856
5,6,2015,The Grand Pub,Eating Out,8,1848
5,6,2015,The Grand Pub,Eating Out,10,1838
5,6,2015,Scott's Restaurant,Eating Out,45,1793
6,6,2015,The Grand Pub,Eating Out,5,1788
6,6,2015,The Grand Pub,Eating Out,7,1781
6,6,2015,Scott's Restaurant,Eating Out,47,1734
7,6,2015,Cubit and West rent,Rent,550,1184
7,6,2015,ATM Cash Withdrawal,General,20,1164
8,6,2015,South West Trains,Transport,32,1132
8,6,2015,Greggs,Eating Out,7,1125
9,6,2015,Wild Bean Cafe,Eating Out,2,1123
9,6,2015,McDonalds,Eating Out,5,1118
10,6,2015,Chicken Cottage,Eating Out,6,1112
11,6,2015,Wild Bean Cafe,Eating Out,1,1111
12,6,2015,ASDA,Groceries,81,1030
12,6,2015,Starbucks Coffee,Eating Out,2,1028
12,6,2015,Greggs,Eating Out,7,1021
12,6,2015,Ministry of Sound ClubXOYO Club,Eating Out,5,1016
12,6,2015,Ministry of Sound ClubXOYO Club,Eating Out,11,1005
12,6,2015,Ministry of Sound ClubXOYO Club,Eating Out,10,995
12,6,2015,Ministry of Sound ClubXOYO Club,Eating Out,16,979
13,6,2015,Heaven Club,Eating Out,9,970
13,6,2015,Heaven Club,Eating Out,15,955
13,6,2015,Heaven Club,Eating Out,10,945
13,6,2015,Heaven Club,Eating Out,13,932
13,6,2015,Heaven Club,Eating Out,6,926
13,6,2015,Heaven Club,Eating Out,15,911
15,6,2015,BRGAS-Electricity,Bills,22,889
15,6,2015,BRGAS-Gas,Bills,23,866
15,6,2015,South West Trains,Transport,29,837
15,6,2015,Caffe Nero,Eating Out,2,835
15,6,2015,Greggs,Eating Out,8,827
15,6,2015,Tool Shop,,6,821
16,6,2015,LBS Council Tax,Bills,50,771
16,6,2015,Wild Bean Cafe,Eating Out,2,769
16,6,2015,McDonalds,Eating Out,6,763
17,6,2015,Caffe Nero,Eating Out,2,761
17,6,2015,Greggs,Eating Out,5,756
18,6,2015,Wild Bean Cafe,Eating Out,2,754
18,6,2015,The West Cornwall Pasty Company,Eating Out,6,748
18,6,2015,ATM Cash Withdrawal,General,20,728
19,6,2015,Tescos,Groceries,70,658
19,6,2015,Caffe Nero,Eating Out,1,657
19,6,2015,Pret A Manger,Eating Out,7,650
19,6,2015,Restaurant Gordon RamsayPortland Restaurant,Eating Out,30,620
19,6,2015,Tool Tec,,5,615
20,6,2015,VIRGIN MEDIA PYMTS,Bills,39,576
20,6,2015,Restaurant Gordon RamsayPortland Restaurant,Eating Out,34,542
20,6,2015,ATM Cash Withdrawal,General,10,532
20,6,2015,Tool Shop,,1,531
21,6,2015,ATM Cash Withdrawal,General,20,511
22,6,2015,South West Trains,Transport,25,486
22,6,2015,Starbucks Coffee,Eating Out,2,484
22,6,2015,The West Cornwall Pasty Company,Eating Out,8,476
23,6,2015,Starbucks Coffee,Eating Out,1,475
23,6,2015,The West Cornwall Pasty Company,Eating Out,7,468
23,6,2015,ATM Cash Withdrawal,General,20,448
24,6,2015,O2,Bills,35,413
24,6,2015,Starbucks Coffee,Eating Out,2,411
24,6,2015,Pret A Manger,Eating Out,4,407
25,6,2015,Wild Bean Cafe,Eating Out,1,406
26,6,2015,Sainsburys,Groceries,85,321
26,6,2015,Wild Bean Cafe,Eating Out,1,320
26,6,2015,Greggs,Eating Out,7,313
26,6,2015,Cheam Service Station,,8,305
27,6,2015,ATM Cash Withdrawal,General,10,295
27,6,2015,Tool Tec,,5,290
29,6,2015,South West Trains,Transport,29,261
29,6,2015,Costa Coffee,Eating Out,1,260
30,6,2015,Starbucks Coffee,Eating Out,1,259
30,6,2015,ATM Cash Withdrawal,General,10,249
1,7,2015,Rhino Sports salary,General,1700,1949
1,7,2015,Costa Coffee,Eating Out,1,1948
1,7,2015,ATM Cash Withdrawal,General,10,1938
1,7,2015,Paying back Julie,,5,1933
2,7,2015,Caffe Nero,Eating Out,2,1931
2,7,2015,Pret A Manger,Eating Out,7,1924
3,7,2015,Waitrose,Groceries,54,1870
3,7,2015,Subway,Eating Out,5,1865
3,7,2015,Heaven Club,Eating Out,13,1852
3,7,2015,Heaven Club,Eating Out,16,1836
3,7,2015,Heaven Club,Eating Out,11,1825
3,7,2015,Heaven Club,Eating Out,13,1812
3,7,2015,Heaven Club,Eating Out,16,1796
4,7,2015,Civic Shop,,1,1795
5,7,2015,Pizza Express,Eating Out,40,1755
5,7,2015,ATM Cash Withdrawal,General,10,1745
6,7,2015,South West Trains,Transport,32,1713
6,7,2015,Costa Coffee,Eating Out,1,1712
6,7,2015,Cheam Service Station,,4,1708
7,7,2015,Cubit and West rent,Rent,550,1158
7,7,2015,Caffe Nero,Eating Out,2,1156
7,7,2015,Tool Tec,,8,1148
8,7,2015,Costa Coffee,Eating Out,1,1147
8,7,2015,Subway,Eating Out,6,1141
9,7,2015,Starbucks Coffee,Eating Out,1,1140
9,7,2015,Paying back Julie,,6,1134
10,7,2015,ASDA,Groceries,73,1061
10,7,2015,Wild Bean Cafe,Eating Out,1,1060
10,7,2015,McDonalds,Eating Out,5,1055
10,7,2015,Restaurant Gordon RamsayPortland Restaurant,Eating Out,31,1024
10,7,2015,ATM Cash Withdrawal,General,10,1014
11,7,2015,Tool Tec,,3,1011
13,7,2015,South West Trains,Transport,31,980
13,7,2015,Wild Bean Cafe,Eating Out,2,978
13,7,2015,McDonalds,Eating Out,5,973
14,7,2015,Starbucks Coffee,Eating Out,2,971
14,7,2015,The West Cornwall Pasty Company,Eating Out,7,964
14,7,2015,ATM Cash Withdrawal,General,10,954
15,7,2015,BRGAS-Electricity,Bills,37,917
15,7,2015,BRGAS-Gas,Bills,36,881
15,7,2015,Pret A Manger,Eating Out,4,877
16,7,2015,LBS Council Tax,Bills,50,827
16,7,2015,Starbucks Coffee,Eating Out,1,826
17,7,2015,Sainsburys,Groceries,87,739
17,7,2015,Subway,Eating Out,4,735
17,7,2015,Pizza Express,Eating Out,53,682
18,7,2015,Fabric Club,Eating Out,15,667
18,7,2015,Fabric Club,Eating Out,8,659
18,7,2015,Fabric Club,Eating Out,8,651
18,7,2015,Fabric Club,Eating Out,7,644
18,7,2015,Fabric Club,Eating Out,13,631
19,7,2015,Anglo restaurant,Eating Out,25,606
20,7,2015,VIRGIN MEDIA PYMTS,Bills,53,553
20,7,2015,South West Trains,Transport,33,520
20,7,2015,Wild Bean Cafe,Eating Out,2,518
20,7,2015,ATM Cash Withdrawal,General,20,498
20,7,2015,Tool Shop,,5,493
21,7,2015,Starbucks Coffee,Eating Out,2,491
22,7,2015,Starbucks Coffee,Eating Out,2,489
22,7,2015,ATM Cash Withdrawal,General,20,469
24,7,2015,O2,Bills,33,436
24,7,2015,ASDA,Groceries,74,362
24,7,2015,McDonalds,Eating Out,4,358
26,7,2015,Paying back Julie,,7,351
27,7,2015,South West Trains,Transport,36,315
29,7,2015,Costa Coffee,Eating Out,2,313
29,7,2015,McDonalds,Eating Out,4,309
30,7,2015,Starbucks Coffee,Eating Out,1,308
31,7,2015,ASDA,Groceries,43,265
31,7,2015,Wild Bean Cafe,Eating Out,2,263
31,7,2015,ATM Cash Withdrawal,General,10,253
31,7,2015,Cheam Service Station,,2,251
1,8,2015,Rhino Sports salary,General,1700,1951
1,8,2015,Heaven Club,Eating Out,14,1937
1,8,2015,Heaven Club,Eating Out,13,1924
1,8,2015,Heaven Club,Eating Out,6,1918
1,8,2015,Heaven Club,Eating Out,13,1905
1,8,2015,Heaven Club,Eating Out,13,1892
1,8,2015,Heaven Club,Eating Out,8,1884
1,8,2015,Dominos Pizza,Eating Out,35,1849
1,8,2015,ATM Cash Withdrawal,General,20,1829
2,8,2015,Anglo restaurant,Eating Out,28,1801
2,8,2015,Paying back James,,2,1799
3,8,2015,South West Trains,Transport,34,1765
3,8,2015,Caffe Nero,Eating Out,1,1764
3,8,2015,Subway,Eating Out,5,1759
4,8,2015,Wild Bean Cafe,Eating Out,2,1757
4,8,2015,Cheam Service Station,,4,1753
5,8,2015,Starbucks Coffee,Eating Out,1,1752
6,8,2015,Wild Bean Cafe,Eating Out,2,1750
6,8,2015,The West Cornwall Pasty Company,Eating Out,7,1743
7,8,2015,Cubit and West rent,Rent,550,1193
7,8,2015,ASDA,Groceries,50,1143
7,8,2015,Scott's Restaurant,Eating Out,54,1089
8,8,2015,Anglo restaurant,Eating Out,46,1043
9,8,2015,ATM Cash Withdrawal,General,20,1023
10,8,2015,South West Trains,Transport,37,986
10,8,2015,Costa Coffee,Eating Out,1,985
10,8,2015,ATM Cash Withdrawal,General,20,965
11,8,2015,Caffe Nero,Eating Out,2,963
11,8,2015,Chicken Cottage,Eating Out,8,955
11,8,2015,ATM Cash Withdrawal,General,10,945
12,8,2015,Caffe Nero,Eating Out,2,943
12,8,2015,ATM Cash Withdrawal,General,20,923
14,8,2015,ASDA,Groceries,69,854
14,8,2015,Wild Bean Cafe,Eating Out,2,852
14,8,2015,Greggs,Eating Out,8,844
15,8,2015,BRGAS-Electricity,Bills,40,804
15,8,2015,BRGAS-Gas,Bills,24,780
15,8,2015,Dominos Pizza,Eating Out,24,756
15,8,2015,ATM Cash Withdrawal,General,20,736
16,8,2015,LBS Council Tax,Bills,50,686
17,8,2015,South West Trains,Transport,37,649
17,8,2015,Caffe Nero,Eating Out,2,647
17,8,2015,ATM Cash Withdrawal,General,20,627
18,8,2015,Costa Coffee,Eating Out,2,625
18,8,2015,Greggs,Eating Out,6,619
19,8,2015,Wild Bean Cafe,Eating Out,2,617
20,8,2015,VIRGIN MEDIA PYMTS,Bills,47,570
20,8,2015,Starbucks Coffee,Eating Out,2,568
20,8,2015,The West Cornwall Pasty Company,Eating Out,7,561
20,8,2015,ATM Cash Withdrawal,General,20,541
21,8,2015,ASDA,Groceries,64,477
21,8,2015,Costa Coffee,Eating Out,1,476
22,8,2015,Heaven Club,Eating Out,12,464
22,8,2015,Heaven Club,Eating Out,14,450
22,8,2015,Heaven Club,Eating Out,9,441
22,8,2015,Heaven Club,Eating Out,12,429
22,8,2015,Heaven Club,Eating Out,12,417
22,8,2015,Heaven Club,Eating Out,14,403
23,8,2015,ATM Cash Withdrawal,General,20,383
24,8,2015,O2,Bills,35,348
24,8,2015,South West Trains,Transport,24,324
24,8,2015,Wild Bean Cafe,Eating Out,2,322
24,8,2015,Chicken Cottage,Eating Out,5,317
25,8,2015,Costa Coffee,Eating Out,2,315
25,8,2015,ATM Cash Withdrawal,General,10,305
26,8,2015,Caffe Nero,Eating Out,2,303
26,8,2015,ATM Cash Withdrawal,General,20,283
27,8,2015,Starbucks Coffee,Eating Out,1,282
27,8,2015,McDonalds,Eating Out,7,275
27,8,2015,ATM Cash Withdrawal,General,10,265
28,8,2015,Sainsburys,Groceries,88,177
28,8,2015,Starbucks Coffee,Eating Out,2,175
28,8,2015,Tool Tec,,3,172
29,8,2015,Tool Tec,,8,164
31,8,2015,South West Trains,Transport,33,131
31,8,2015,Greggs,Eating Out,7,124
31,8,2015,ATM Cash Withdrawal,General,10,114
1,9,2015,Rhino Sports salary,General,1700,1814
1,9,2015,Starbucks Coffee,Eating Out,2,1812
1,9,2015,McDonalds,Eating Out,8,1804
1,9,2015,Paying back Julie,,3,1801
2,9,2015,Costa Coffee,Eating Out,1,1800
2,9,2015,Subway,Eating Out,6,1794
3,9,2015,Starbucks Coffee,Eating Out,1,1793
4,9,2015,Morrisons,Groceries,76,1717
4,9,2015,Caffe Nero,Eating Out,2,1715
4,9,2015,McDonalds,Eating Out,4,1711
4,9,2015,Cheam Service Station,,7,1704
6,9,2015,Dominos Pizza,Eating Out,40,1664
6,9,2015,ATM Cash Withdrawal,General,20,1644
7,9,2015,Cubit and West rent,Rent,550,1094
7,9,2015,South West Trains,Transport,24,1070
7,9,2015,Wild Bean Cafe,Eating Out,2,1068
7,9,2015,ATM Cash Withdrawal,General,20,1048
8,9,2015,Costa Coffee,Eating Out,1,1047
8,9,2015,Tool Shop,,7,1040
9,9,2015,Paying back James,,6,1034
11,9,2015,Tescos,Groceries,54,980
11,9,2015,Wild Bean Cafe,Eating Out,2,978
11,9,2015,Chicken Cottage,Eating Out,6,972
11,9,2015,Tool Shop,,1,971
12,9,2015,Dominos Pizza,Eating Out,48,923
13,9,2015,Pizza Express,Eating Out,41,882
13,9,2015,ATM Cash Withdrawal,General,20,862
14,9,2015,South West Trains,Transport,32,830
14,9,2015,Costa Coffee,Eating Out,1,829
14,9,2015,The West Cornwall Pasty Company,Eating Out,4,825
14,9,2015,Tool Tec,,3,822
15,9,2015,BRGAS-Electricity,Bills,35,787
15,9,2015,BRGAS-Gas,Bills,26,761
15,9,2015,Wild Bean Cafe,Eating Out,2,759
15,9,2015,Pret A Manger,Eating Out,4,755
16,9,2015,LBS Council Tax,Bills,50,705
16,9,2015,Caffe Nero,Eating Out,2,703
16,9,2015,McDonalds,Eating Out,5,698
16,9,2015,Tool Shop,,2,696
17,9,2015,Chicken Cottage,Eating Out,6,690
17,9,2015,ATM Cash Withdrawal,General,20,670
17,9,2015,Paying back Julie,,5,665
18,9,2015,ASDA,Groceries,85,580
18,9,2015,Pret A Manger,Eating Out,6,574
19,9,2015,Dominos Pizza,Eating Out,26,548
20,9,2015,VIRGIN MEDIA PYMTS,Bills,39,509
21,9,2015,South West Trains,Transport,25,484
21,9,2015,Wild Bean Cafe,Eating Out,2,482
21,9,2015,Pret A Manger,Eating Out,6,476
22,9,2015,Wild Bean Cafe,Eating Out,1,475
23,9,2015,Costa Coffee,Eating Out,2,473
23,9,2015,Pret A Manger,Eating Out,6,467
23,9,2015,Tool Tec,,2,465
24,9,2015,O2,Bills,31,434
24,9,2015,Starbucks Coffee,Eating Out,2,432
25,9,2015,ASDA,Groceries,67,365
25,9,2015,Subway,Eating Out,5,360
25,9,2015,ATM Cash Withdrawal,General,20,340
26,9,2015,Ministry of Sound ClubXOYO Club,Eating Out,5,335
26,9,2015,Ministry of Sound ClubXOYO Club,Eating Out,5,330
26,9,2015,Ministry of Sound ClubXOYO Club,Eating Out,5,325
27,9,2015,Tool Tec,,1,324
28,9,2015,South West Trains,Transport,28,296
28,9,2015,Starbucks Coffee,Eating Out,1,295
28,9,2015,Greggs,Eating Out,8,287
28,9,2015,Civic Shop,,1,286
29,9,2015,Costa Coffee,Eating Out,2,284
30,9,2015,Wild Bean Cafe,Eating Out,2,282
30,9,2015,ATM Cash Withdrawal,General,10,272
1,10,2015,Rhino Sports salary,General,1700,1972
1,10,2015,Wild Bean Cafe,Eating Out,2,1970
1,10,2015,Pret A Manger,Eating Out,8,1962
1,10,2015,ATM Cash Withdrawal,General,20,1942
2,10,2015,Morrisons,Groceries,72,1870
2,10,2015,Starbucks Coffee,Eating Out,2,1868
2,10,2015,ATM Cash Withdrawal,General,10,1858
4,10,2015,Tool Tec,,4,1854
5,10,2015,South West Trains,Transport,24,1830
5,10,2015,Wild Bean Cafe,Eating Out,2,1828
6,10,2015,Wild Bean Cafe,Eating Out,2,1826
7,10,2015,Cubit and West rent,Rent,550,1276
7,10,2015,Costa Coffee,Eating Out,1,1275
8,10,2015,Starbucks Coffee,Eating Out,1,1274
8,10,2015,Chicken Cottage,Eating Out,8,1266
8,10,2015,ATM Cash Withdrawal,General,10,1256
9,10,2015,Tescos,Groceries,79,1177
9,10,2015,Starbucks Coffee,Eating Out,1,1176
10,10,2015,Anglo restaurant,Eating Out,56,1120
12,10,2015,South West Trains,Transport,25,1095
12,10,2015,Pret A Manger,Eating Out,7,1088
13,10,2015,Caffe Nero,Eating Out,1,1087
13,10,2015,Pret A Manger,Eating Out,6,1081
14,10,2015,Costa Coffee,Eating Out,2,1079
14,10,2015,ATM Cash Withdrawal,General,20,1059
14,10,2015,Red Shop,,1,1058
15,10,2015,BRGAS-Electricity,Bills,27,1031
15,10,2015,BRGAS-Gas,Bills,29,1002
15,10,2015,Wild Bean Cafe,Eating Out,1,1001
15,10,2015,McDonalds,Eating Out,5,996
16,10,2015,LBS Council Tax,Bills,50,946
16,10,2015,Waitrose,Groceries,79,867
16,10,2015,Caffe Nero,Eating Out,2,865
17,10,2015,Restaurant Gordon RamsayPortland Restaurant,Eating Out,52,813
18,10,2015,Restaurant Gordon RamsayPortland Restaurant,Eating Out,28,785
19,10,2015,South West Trains,Transport,32,753
19,10,2015,The West Cornwall Pasty Company,Eating Out,8,745
20,10,2015,VIRGIN MEDIA PYMTS,Bills,30,715
20,10,2015,Wild Bean Cafe,Eating Out,2,713
20,10,2015,McDonalds,Eating Out,7,706
21,10,2015,Starbucks Coffee,Eating Out,1,705
21,10,2015,Pret A Manger,Eating Out,4,701
21,10,2015,ATM Cash Withdrawal,General,10,691
21,10,2015,Cheam Service Station,,6,685
22,10,2015,Caffe Nero,Eating Out,1,684
22,10,2015,Pret A Manger,Eating Out,6,678
23,10,2015,ASDA,Groceries,43,635
23,10,2015,Caffe Nero,Eating Out,2,633
23,10,2015,Pizza Express,Eating Out,32,601
23,10,2015,ATM Cash Withdrawal,General,20,581
24,10,2015,O2,Bills,33,548
24,10,2015,Tool Tec,,8,540
25,10,2015,Restaurant Gordon RamsayPortland Restaurant,Eating Out,44,496
26,10,2015,South West Trains,Transport,24,472
26,10,2015,Wild Bean Cafe,Eating Out,2,470
26,10,2015,Subway,Eating Out,5,465
27,10,2015,Costa Coffee,Eating Out,2,463
27,10,2015,McDonalds,Eating Out,8,455
27,10,2015,Tool Tec,,6,449
28,10,2015,Caffe Nero,Eating Out,1,448
29,10,2015,Starbucks Coffee,Eating Out,1,447
29,10,2015,ATM Cash Withdrawal,General,10,437
30,10,2015,ASDA,Groceries,51,386
30,10,2015,Starbucks Coffee,Eating Out,1,385
30,10,2015,Anglo restaurant,Eating Out,52,333
31,10,2015,Scott's Restaurant,Eating Out,49,284
1,11,2015,Rhino Sports salary,General,1700,1984
1,11,2015,ATM Cash Withdrawal,General,20,1964
2,11,2015,South West Trains,Transport,27,1937
2,11,2015,Starbucks Coffee,Eating Out,2,1935
4,11,2015,McDonalds,Eating Out,8,1927
4,11,2015,ATM Cash Withdrawal,General,10,1917
4,11,2015,Paying back Julie,,3,1914
5,11,2015,Starbucks Coffee,Eating Out,2,1912
5,11,2015,The West Cornwall Pasty Company,Eating Out,6,1906
6,11,2015,Sainsburys,Groceries,76,1830
6,11,2015,Wild Bean Cafe,Eating Out,2,1828
6,11,2015,Chicken Cottage,Eating Out,8,1820
6,11,2015,Civic Shop,,3,1817
7,11,2015,Cubit and West rent,Rent,550,1267
7,11,2015,Pizza Express,Eating Out,45,1222
7,11,2015,ATM Cash Withdrawal,General,20,1202
8,11,2015,Tool Tec,,9,1193
9,11,2015,South West Trains,Transport,26,1167
9,11,2015,Costa Coffee,Eating Out,2,1165
10,11,2015,Starbucks Coffee,Eating Out,2,1163
10,11,2015,Greggs,Eating Out,5,1158
10,11,2015,ATM Cash Withdrawal,General,20,1138
11,11,2015,Caffe Nero,Eating Out,2,1136
11,11,2015,McDonalds,Eating Out,6,1130
11,11,2015,ATM Cash Withdrawal,General,10,1120
11,11,2015,Paying back James,,3,1117
12,11,2015,Starbucks Coffee,Eating Out,1,1116
12,11,2015,Subway,Eating Out,7,1109
13,11,2015,ASDA,Groceries,49,1060
13,11,2015,McDonalds,Eating Out,4,1056
13,11,2015,Anglo restaurant,Eating Out,26,1030
14,11,2015,ATM Cash Withdrawal,General,20,1010
14,11,2015,Tool Shop,,2,1008
15,11,2015,BRGAS-Electricity,Bills,78,930
15,11,2015,BRGAS-Gas,Bills,50,880
15,11,2015,Restaurant Gordon RamsayPortland Restaurant,Eating Out,49,831
16,11,2015,LBS Council Tax,Bills,50,781
16,11,2015,South West Trains,Transport,37,744
16,11,2015,ATM Cash Withdrawal,General,20,724
17,11,2015,Starbucks Coffee,Eating Out,2,722
17,11,2015,ATM Cash Withdrawal,General,20,702
18,11,2015,Starbucks Coffee,Eating Out,2,700
19,11,2015,Starbucks Coffee,Eating Out,2,698
19,11,2015,Paying back Julie,,4,694
20,11,2015,VIRGIN MEDIA PYMTS,Bills,49,645
20,11,2015,Morrisons,Groceries,47,598
20,11,2015,Starbucks Coffee,Eating Out,1,597
20,11,2015,ATM Cash Withdrawal,General,10,587
21,11,2015,Pizza Express,Eating Out,45,542
21,11,2015,Cheam Service Station,,9,533
22,11,2015,Scott's Restaurant,Eating Out,36,497
23,11,2015,South West Trains,Transport,31,466
23,11,2015,McDonalds,Eating Out,6,460
24,11,2015,O2,Bills,30,430
24,11,2015,Starbucks Coffee,Eating Out,2,428
25,11,2015,Wild Bean Cafe,Eating Out,1,427
25,11,2015,McDonalds,Eating Out,7,420
26,11,2015,Wild Bean Cafe,Eating Out,1,419
27,11,2015,Waitrose,Groceries,44,375
27,11,2015,Starbucks Coffee,Eating Out,1,374
27,11,2015,Subway,Eating Out,7,367
27,11,2015,The Grand Pub,Eating Out,12,355
27,11,2015,The Grand Pub,Eating Out,9,346
27,11,2015,The Grand Pub,Eating Out,6,340
27,11,2015,The Grand Pub,Eating Out,8,332
27,11,2015,The Grand Pub,Eating Out,12,320
27,11,2015,Scott's Restaurant,Eating Out,40,280
27,11,2015,ATM Cash Withdrawal,General,10,270
28,11,2015,Ministry of Sound ClubXOYO Club,Eating Out,11,259
28,11,2015,Ministry of Sound ClubXOYO Club,Eating Out,8,251
28,11,2015,Ministry of Sound ClubXOYO Club,Eating Out,10,241
28,11,2015,Ministry of Sound ClubXOYO Club,Eating Out,13,228
29,11,2015,Pizza Express,Eating Out,46,182
30,11,2015,South West Trains,Transport,36,146
30,11,2015,Wild Bean Cafe,Eating Out,2,144
30,11,2015,Greggs,Eating Out,4,140
1,12,2015,Rhino Sports salary,General,1700,1840
1,12,2015,Wild Bean Cafe,Eating Out,1,1839
3,12,2015,Starbucks Coffee,Eating Out,1,1838
3,12,2015,The West Cornwall Pasty Company,Eating Out,7,1831
3,12,2015,Paying back Julie,,5,1826
4,12,2015,Sainsburys,Groceries,50,1776
4,12,2015,The Grand Pub,Eating Out,16,1760
4,12,2015,The Grand Pub,Eating Out,16,1744
4,12,2015,The Grand Pub,Eating Out,10,1734
4,12,2015,The Grand Pub,Eating Out,6,1728
4,12,2015,The Grand Pub,Eating Out,5,1723
4,12,2015,Civic Shop,,9,1714
5,12,2015,Restaurant Gordon RamsayPortland Restaurant,Eating Out,28,1686
6,12,2015,Pizza Express,Eating Out,44,1642
7,12,2015,Cubit and West rent,Rent,550,1092
7,12,2015,South West Trains,Transport,33,1059
7,12,2015,Wild Bean Cafe,Eating Out,1,1058
7,12,2015,Chicken Cottage,Eating Out,4,1054
8,12,2015,Costa Coffee,Eating Out,2,1052
9,12,2015,Wild Bean Cafe,Eating Out,2,1050
9,12,2015,ATM Cash Withdrawal,General,20,1030
10,12,2015,Costa Coffee,Eating Out,2,1028
10,12,2015,ATM Cash Withdrawal,General,10,1018
10,12,2015,Paying back Julie,,2,1016
11,12,2015,Tescos,Groceries,89,927
11,12,2015,Wild Bean Cafe,Eating Out,2,925
11,12,2015,Restaurant Gordon RamsayPortland Restaurant,Eating Out,36,889
12,12,2015,ATM Cash Withdrawal,General,20,869
14,12,2015,South West Trains,Transport,37,832
14,12,2015,Costa Coffee,Eating Out,2,830
15,12,2015,BRGAS-Electricity,Bills,28,802
15,12,2015,BRGAS-Gas,Bills,40,762
16,12,2015,LBS Council Tax,Bills,50,712
16,12,2015,Caffe Nero,Eating Out,2,710
16,12,2015,ATM Cash Withdrawal,General,10,700
17,12,2015,Costa Coffee,Eating Out,2,698
17,12,2015,Greggs,Eating Out,5,693
17,12,2015,ATM Cash Withdrawal,General,10,683
17,12,2015,Red Shop,,9,674
18,12,2015,ASDA,Groceries,59,615
18,12,2015,Costa Coffee,Eating Out,2,613
18,12,2015,Anglo restaurant,Eating Out,39,574
19,12,2015,The Grand Pub,Eating Out,10,564
19,12,2015,The Grand Pub,Eating Out,10,554
19,12,2015,Pizza Express,Eating Out,50,504
20,12,2015,VIRGIN MEDIA PYMTS,Bills,44,460
21,12,2015,South West Trains,Transport,31,429
21,12,2015,Costa Coffee,Eating Out,2,427
21,12,2015,The West Cornwall Pasty Company,Eating Out,4,423
22,12,2015,Starbucks Coffee,Eating Out,2,421
23,12,2015,Costa Coffee,Eating Out,2,419
23,12,2015,ATM Cash Withdrawal,General,20,399
23,12,2015,Paying back Julie,,8,391
24,12,2015,O2,Bills,38,353
24,12,2015,Wild Bean Cafe,Eating Out,2,351
24,12,2015,Greggs,Eating Out,5,346
24,12,2015,ATM Cash Withdrawal,General,10,336
25,12,2015,Morrisons,Groceries,86,250
25,12,2015,Starbucks Coffee,Eating Out,2,248
25,12,2015,Scott's Restaurant,Eating Out,47,201
27,12,2015,Restaurant Gordon RamsayPortland Restaurant,Eating Out,50,151
27,12,2015,ATM Cash Withdrawal,General,10,141
28,12,2015,South West Trains,Transport,30,111
28,12,2015,Starbucks Coffee,Eating Out,2,109
29,12,2015,Costa Coffee,Eating Out,2,107
29,12,2015,McDonalds,Eating Out,7,100
30,12,2015,Costa Coffee,Eating Out,2,98
30,12,2015,Subway,Eating Out,6,92
1,1,2016,Rhino Sports salary,General,1700,1792
1,1,2016,ASDA,Groceries,87,1705
1,1,2016,Starbucks Coffee,Eating Out,2,1703
1,1,2016,Restaurant Gordon RamsayPortland Restaurant,Eating Out,54,1649
2,1,2016,ATM Cash Withdrawal,General,10,1639
3,1,2016,ATM Cash Withdrawal,General,20,1619
4,1,2016,South West Trains,Transport,26,1593
4,1,2016,Wild Bean Cafe,Eating Out,1,1592
4,1,2016,Chicken Cottage,Eating Out,8,1584
4,1,2016,ATM Cash Withdrawal,General,10,1574
5,1,2016,Caffe Nero,Eating Out,1,1573
5,1,2016,ATM Cash Withdrawal,General,10,1563
6,1,2016,Wild Bean Cafe,Eating Out,1,1562
7,1,2016,Cubit and West rent,Rent,550,1012
7,1,2016,Caffe Nero,Eating Out,1,1011
7,1,2016,Chicken Cottage,Eating Out,5,1006
8,1,2016,Morrisons,Groceries,45,961
8,1,2016,Starbucks Coffee,Eating Out,2,959
8,1,2016,Scott's Restaurant,Eating Out,48,911
9,1,2016,ATM Cash Withdrawal,General,10,901
11,1,2016,South West Trains,Transport,29,872
11,1,2016,Costa Coffee,Eating Out,1,871
12,1,2016,Wild Bean Cafe,Eating Out,2,869
12,1,2016,Greggs,Eating Out,4,865
13,1,2016,Wild Bean Cafe,Eating Out,1,864
13,1,2016,Pret A Manger,Eating Out,8,856
13,1,2016,Red Shop,,2,854
14,1,2016,Caffe Nero,Eating Out,2,852
14,1,2016,The West Cornwall Pasty Company,Eating Out,8,844
14,1,2016,Cheam Service Station,,7,837
15,1,2016,BRGAS-Electricity,Bills,47,790
15,1,2016,BRGAS-Gas,Bills,48,742
15,1,2016,Sainsburys,Groceries,65,677
15,1,2016,Costa Coffee,Eating Out,2,675
16,1,2016,LBS Council Tax,Bills,50,625
16,1,2016,Scott's Restaurant,Eating Out,24,601
16,1,2016,ATM Cash Withdrawal,General,10,591
18,1,2016,South West Trains,Transport,36,555
18,1,2016,Starbucks Coffee,Eating Out,2,553
18,1,2016,Greggs,Eating Out,5,548
19,1,2016,Costa Coffee,Eating Out,1,547
19,1,2016,McDonalds,Eating Out,6,541
19,1,2016,ATM Cash Withdrawal,General,10,531
19,1,2016,Civic Shop,,4,527
20,1,2016,VIRGIN MEDIA PYMTS,Bills,57,470
21,1,2016,Wild Bean Cafe,Eating Out,1,469
21,1,2016,Pret A Manger,Eating Out,6,463
21,1,2016,ATM Cash Withdrawal,General,10,453
22,1,2016,Tescos,Groceries,80,373
22,1,2016,Caffe Nero,Eating Out,1,372
22,1,2016,Scott's Restaurant,Eating Out,30,342
22,1,2016,Civic Shop,,6,336
23,1,2016,ATM Cash Withdrawal,General,10,326
24,1,2016,O2,Bills,33,293
24,1,2016,Paying back Julie,,5,288
25,1,2016,South West Trains,Transport,25,263
25,1,2016,Greggs,Eating Out,7,256
25,1,2016,ATM Cash Withdrawal,General,10,246
26,1,2016,Wild Bean Cafe,Eating Out,1,245
26,1,2016,Chicken Cottage,Eating Out,6,239
27,1,2016,Starbucks Coffee,Eating Out,1,238
27,1,2016,McDonalds,Eating Out,5,233
27,1,2016,ATM Cash Withdrawal,General,20,213
27,1,2016,Tool Tec,,8,205
28,1,2016,Starbucks Coffee,Eating Out,2,203
28,1,2016,Subway,Eating Out,5,198
29,1,2016,Morrisons,Groceries,89,109
29,1,2016,Wild Bean Cafe,Eating Out,1,108
29,1,2016,The West Cornwall Pasty Company,Eating Out,7,101
31,1,2016,ATM Cash Withdrawal,General,20,81
1,2,2016,Rhino Sports salary,General,1700,1781
1,2,2016,South West Trains,Transport,36,1745
1,2,2016,Starbucks Coffee,Eating Out,1,1744
1,2,2016,Chicken Cottage,Eating Out,4,1740
1,2,2016,ATM Cash Withdrawal,General,10,1730
1,2,2016,Tool Tec,,1,1729
2,2,2016,Wild Bean Cafe,Eating Out,2,1727
2,2,2016,The West Cornwall Pasty Company,Eating Out,7,1720
2,2,2016,Paying back James,,1,1719
3,2,2016,ATM Cash Withdrawal,General,20,1699
3,2,2016,Tool Tec,,1,1698
4,2,2016,Costa Coffee,Eating Out,2,1696
4,2,2016,Cheam Service Station,,2,1694
5,2,2016,Waitrose,Groceries,65,1629
5,2,2016,Caffe Nero,Eating Out,1,1628
6,2,2016,ATM Cash Withdrawal,General,10,1618
7,2,2016,Cubit and West rent,Rent,550,1068
7,2,2016,Anglo restaurant,Eating Out,34,1034
8,2,2016,South West Trains,Transport,33,1001
8,2,2016,Starbucks Coffee,Eating Out,2,999
8,2,2016,Pret A Manger,Eating Out,6,993
8,2,2016,ATM Cash Withdrawal,General,10,983
8,2,2016,Paying back James,,1,982
9,2,2016,Wild Bean Cafe,Eating Out,2,980
9,2,2016,Paying back Julie,,3,977
10,2,2016,Starbucks Coffee,Eating Out,1,976
11,2,2016,Wild Bean Cafe,Eating Out,1,975
11,2,2016,Greggs,Eating Out,8,967
11,2,2016,ATM Cash Withdrawal,General,20,947
12,2,2016,Tescos,Groceries,80,867
12,2,2016,Costa Coffee,Eating Out,2,865
12,2,2016,Greggs,Eating Out,6,859
12,2,2016,ATM Cash Withdrawal,General,10,849
15,2,2016,BRGAS-Electricity,Bills,35,814
15,2,2016,BRGAS-Gas,Bills,29,785
15,2,2016,South West Trains,Transport,38,747
15,2,2016,Costa Coffee,Eating Out,2,745
15,2,2016,The West Cornwall Pasty Company,Eating Out,5,740
16,2,2016,LBS Council Tax,Bills,50,690
16,2,2016,Wild Bean Cafe,Eating Out,2,688
16,2,2016,Chicken Cottage,Eating Out,6,682
16,2,2016,ATM Cash Withdrawal,General,20,662
17,2,2016,Starbucks Coffee,Eating Out,1,661
17,2,2016,McDonalds,Eating Out,7,654
17,2,2016,Civic Shop,,7,647
18,2,2016,Caffe Nero,Eating Out,2,645
19,2,2016,Waitrose,Groceries,50,595
19,2,2016,Costa Coffee,Eating Out,2,593
19,2,2016,Greggs,Eating Out,8,585
19,2,2016,Scott's Restaurant,Eating Out,42,543
20,2,2016,VIRGIN MEDIA PYMTS,Bills,38,505
20,2,2016,Scott's Restaurant,Eating Out,57,448
21,2,2016,ATM Cash Withdrawal,General,20,428
22,2,2016,South West Trains,Transport,32,396
22,2,2016,Starbucks Coffee,Eating Out,1,395
22,2,2016,Pret A Manger,Eating Out,5,390
23,2,2016,Costa Coffee,Eating Out,1,389
23,2,2016,Subway,Eating Out,5,384
24,2,2016,O2,Bills,30,354
24,2,2016,Wild Bean Cafe,Eating Out,2,352
24,2,2016,Pret A Manger,Eating Out,6,346
24,2,2016,ATM Cash Withdrawal,General,10,336
25,2,2016,Starbucks Coffee,Eating Out,2,334
26,2,2016,Waitrose,Groceries,50,284
26,2,2016,Caffe Nero,Eating Out,1,283
26,2,2016,The West Cornwall Pasty Company,Eating Out,5,278
26,2,2016,Pizza Express,Eating Out,47,231
27,2,2016,Heaven Club,Eating Out,5,226
27,2,2016,Dominos Pizza,Eating Out,51,175
29,2,2016,South West Trains,Transport,34,141
29,2,2016,Costa Coffee,Eating Out,2,139
1,3,2016,Rhino Sports salary,General,1700,1839
1,3,2016,Chicken Cottage,Eating Out,7,1832
1,3,2016,ATM Cash Withdrawal,General,20,1812
2,3,2016,Costa Coffee,Eating Out,2,1810
3,3,2016,Starbucks Coffee,Eating Out,2,1808
4,3,2016,Waitrose,Groceries,65,1743
4,3,2016,Costa Coffee,Eating Out,2,1741
4,3,2016,Subway,Eating Out,4,1737
4,3,2016,Dominos Pizza,Eating Out,24,1713
6,3,2016,Anglo restaurant,Eating Out,28,1685
6,3,2016,ATM Cash Withdrawal,General,20,1665
7,3,2016,Cubit and West rent,Rent,550,1115
7,3,2016,South West Trains,Transport,27,1088
8,3,2016,Wild Bean Cafe,Eating Out,1,1087
8,3,2016,ATM Cash Withdrawal,General,20,1067
9,3,2016,Wild Bean Cafe,Eating Out,2,1065
9,3,2016,McDonalds,Eating Out,6,1059
9,3,2016,Tool Shop,,8,1051
10,3,2016,Costa Coffee,Eating Out,1,1050
10,3,2016,Pret A Manger,Eating Out,5,1045
10,3,2016,ATM Cash Withdrawal,General,10,1035
11,3,2016,Tescos,Groceries,81,954
11,3,2016,Caffe Nero,Eating Out,2,952
11,3,2016,Chicken Cottage,Eating Out,5,947
11,3,2016,Restaurant Gordon RamsayPortland Restaurant,Eating Out,39,908
11,3,2016,ATM Cash Withdrawal,General,10,898
12,3,2016,ATM Cash Withdrawal,General,10,888
13,3,2016,Dominos Pizza,Eating Out,50,838
13,3,2016,ATM Cash Withdrawal,General,20,818
14,3,2016,South West Trains,Transport,37,781
14,3,2016,Costa Coffee,Eating Out,2,779
14,3,2016,McDonalds,Eating Out,4,775
15,3,2016,BRGAS-Electricity,Bills,44,731
15,3,2016,BRGAS-Gas,Bills,27,704
15,3,2016,Caffe Nero,Eating Out,2,702
15,3,2016,McDonalds,Eating Out,8,694
16,3,2016,LBS Council Tax,Bills,50,644
16,3,2016,Caffe Nero,Eating Out,2,642
16,3,2016,McDonalds,Eating Out,7,635
16,3,2016,ATM Cash Withdrawal,General,20,615
17,3,2016,Pret A Manger,Eating Out,6,609
18,3,2016,Tescos,Groceries,54,555
18,3,2016,Subway,Eating Out,7,548
18,3,2016,Pizza Express,Eating Out,32,516
18,3,2016,Cheam Service Station,,9,507
19,3,2016,Cheam Service Station,,1,506
20,3,2016,VIRGIN MEDIA PYMTS,Bills,44,462
20,3,2016,Pizza Express,Eating Out,57,405
21,3,2016,South West Trains,Transport,24,381
21,3,2016,Costa Coffee,Eating Out,2,379
22,3,2016,Subway,Eating Out,7,372
22,3,2016,ATM Cash Withdrawal,General,20,352
23,3,2016,Starbucks Coffee,Eating Out,1,351
24,3,2016,O2,Bills,35,316
24,3,2016,Starbucks Coffee,Eating Out,2,314
24,3,2016,Pret A Manger,Eating Out,5,309
25,3,2016,Tescos,Groceries,89,220
25,3,2016,Costa Coffee,Eating Out,2,218
25,3,2016,Chicken Cottage,Eating Out,6,212
25,3,2016,Restaurant Gordon RamsayPortland Restaurant,Eating Out,28,184
27,3,2016,Dominos Pizza,Eating Out,57,127
27,3,2016,ATM Cash Withdrawal,General,20,107
28,3,2016,South West Trains,Transport,35,72
28,3,2016,Caffe Nero,Eating Out,2,70
28,3,2016,Subway,Eating Out,4,66
29,3,2016,Wild Bean Cafe,Eating Out,2,64
29,3,2016,Chicken Cottage,Eating Out,4,60
30,3,2016,Costa Coffee,Eating Out,1,59
31,3,2016,Starbucks Coffee,Eating Out,2,57
31,3,2016,Greggs,Eating Out,5,52
31,3,2016,ATM Cash Withdrawal,General,20,32
1,4,2016,Rhino Sports salary,General,1700,1732
1,4,2016,ASDA,Groceries,84,1648
2,4,2016,Scott's Restaurant,Eating Out,25,1623
2,4,2016,ATM Cash Withdrawal,General,20,1603
4,4,2016,South West Trains,Transport,38,1565
4,4,2016,Costa Coffee,Eating Out,2,1563
4,4,2016,Subway,Eating Out,8,1555
4,4,2016,ATM Cash Withdrawal,General,10,1545
5,4,2016,Caffe Nero,Eating Out,1,1544
5,4,2016,McDonalds,Eating Out,5,1539
5,4,2016,Tool Shop,,5,1534
6,4,2016,Caffe Nero,Eating Out,2,1532
6,4,2016,ATM Cash Withdrawal,General,10,1522
7,4,2016,Cubit and West rent,Rent,550,972
7,4,2016,Starbucks Coffee,Eating Out,2,970
7,4,2016,Subway,Eating Out,4,966
8,4,2016,Morrisons,Groceries,57,909
8,4,2016,Subway,Eating Out,4,905
8,4,2016,Pizza Express,Eating Out,25,880
8,4,2016,ATM Cash Withdrawal,General,20,860
9,4,2016,Scott's Restaurant,Eating Out,52,808
10,4,2016,Anglo restaurant,Eating Out,42,766
11,4,2016,South West Trains,Transport,26,740
11,4,2016,Subway,Eating Out,6,734
11,4,2016,ATM Cash Withdrawal,General,10,724
12,4,2016,Costa Coffee,Eating Out,1,723
12,4,2016,Greggs,Eating Out,7,716
13,4,2016,Costa Coffee,Eating Out,1,715
13,4,2016,ATM Cash Withdrawal,General,10,705
14,4,2016,Costa Coffee,Eating Out,1,704
14,4,2016,ATM Cash Withdrawal,General,20,684
14,4,2016,Cheam Service Station,,8,676
15,4,2016,BRGAS-Electricity,Bills,39,637
15,4,2016,BRGAS-Gas,Bills,29,608
15,4,2016,Morrisons,Groceries,63,545
15,4,2016,Caffe Nero,Eating Out,1,544
15,4,2016,Scott's Restaurant,Eating Out,32,512
16,4,2016,LBS Council Tax,Bills,50,462
18,4,2016,South West Trains,Transport,29,433
18,4,2016,Wild Bean Cafe,Eating Out,1,432
19,4,2016,Starbucks Coffee,Eating Out,2,430
19,4,2016,Greggs,Eating Out,5,425
20,4,2016,VIRGIN MEDIA PYMTS,Bills,29,396
20,4,2016,Greggs,Eating Out,7,389
21,4,2016,Wild Bean Cafe,Eating Out,2,387
21,4,2016,Subway,Eating Out,8,379
22,4,2016,ASDA,Groceries,67,312
22,4,2016,Caffe Nero,Eating Out,1,311
22,4,2016,Pret A Manger,Eating Out,7,304
23,4,2016,Pizza Express,Eating Out,25,279
23,4,2016,ATM Cash Withdrawal,General,20,259
24,4,2016,O2,Bills,34,225
24,4,2016,Restaurant Gordon RamsayPortland Restaurant,Eating Out,52,173
24,4,2016,ATM Cash Withdrawal,General,10,163
25,4,2016,South West Trains,Transport,35,128
25,4,2016,Costa Coffee,Eating Out,1,127
25,4,2016,Pret A Manger,Eating Out,4,123
26,4,2016,Chicken Cottage,Eating Out,6,117
27,4,2016,Caffe Nero,Eating Out,1,116
27,4,2016,Subway,Eating Out,5,111
28,4,2016,Starbucks Coffee,Eating Out,1,110
28,4,2016,Subway,Eating Out,6,104
29,4,2016,Tescos,Groceries,54,50
29,4,2016,Starbucks Coffee,Eating Out,2,48
29,4,2016,Subway,Eating Out,8,40
1,5,2016,Rhino Sports salary,General,1700,1740
1,5,2016,ATM Cash Withdrawal,General,20,1720
2,5,2016,South West Trains,Transport,28,1692
3,5,2016,Costa Coffee,Eating Out,1,1691
3,5,2016,Subway,Eating Out,8,1683
4,5,2016,Starbucks Coffee,Eating Out,2,1681
4,5,2016,McDonalds,Eating Out,4,1677
5,5,2016,The West Cornwall Pasty Company,Eating Out,5,1672
5,5,2016,Paying back James,,2,1670
6,5,2016,ASDA,Groceries,79,1591
6,5,2016,Wild Bean Cafe,Eating Out,1,1590
6,5,2016,The West Cornwall Pasty Company,Eating Out,8,1582
6,5,2016,Dominos Pizza,Eating Out,45,1537
6,5,2016,ATM Cash Withdrawal,General,10,1527
7,5,2016,Cubit and West rent,Rent,550,977
7,5,2016,Scott's Restaurant,Eating Out,25,952
8,5,2016,ATM Cash Withdrawal,General,20,932
8,5,2016,Tool Tec,,2,930
9,5,2016,South West Trains,Transport,33,897
9,5,2016,Subway,Eating Out,5,892
9,5,2016,ATM Cash Withdrawal,General,20,872
10,5,2016,Costa Coffee,Eating Out,1,871
11,5,2016,Chicken Cottage,Eating Out,6,865
11,5,2016,ATM Cash Withdrawal,General,20,845
12,5,2016,Wild Bean Cafe,Eating Out,1,844
12,5,2016,Greggs,Eating Out,7,837
12,5,2016,Paying back James,,4,833
13,5,2016,Morrisons,Groceries,88,745
13,5,2016,The West Cornwall Pasty Company,Eating Out,8,737
13,5,2016,Fabric Club,Eating Out,12,725
13,5,2016,Fabric Club,Eating Out,8,717
13,5,2016,Fabric Club,Eating Out,15,702
13,5,2016,ATM Cash Withdrawal,General,10,692
14,5,2016,Ministry of Sound ClubXOYO Club,Eating Out,7,685
14,5,2016,Scott's Restaurant,Eating Out,53,632
14,5,2016,ATM Cash Withdrawal,General,10,622
14,5,2016,Paying back James,,4,618
15,5,2016,BRGAS-Electricity,Bills,23,595
15,5,2016,BRGAS-Gas,Bills,29,566
16,5,2016,LBS Council Tax,Bills,50,516
16,5,2016,South West Trains,Transport,33,483
16,5,2016,Costa Coffee,Eating Out,1,482
16,5,2016,Subway,Eating Out,7,475
17,5,2016,Caffe Nero,Eating Out,1,474
17,5,2016,ATM Cash Withdrawal,General,10,464
18,5,2016,Costa Coffee,Eating Out,2,462
19,5,2016,Costa Coffee,Eating Out,2,460
19,5,2016,Chicken Cottage,Eating Out,7,453
20,5,2016,VIRGIN MEDIA PYMTS,Bills,29,424
20,5,2016,Morrisons,Groceries,43,381
20,5,2016,Costa Coffee,Eating Out,2,379
20,5,2016,Greggs,Eating Out,6,373
22,5,2016,Scott's Restaurant,Eating Out,59,314
23,5,2016,South West Trains,Transport,37,277
23,5,2016,Caffe Nero,Eating Out,2,275
24,5,2016,O2,Bills,34,241
24,5,2016,Caffe Nero,Eating Out,2,239
24,5,2016,McDonalds,Eating Out,5,234
25,5,2016,Starbucks Coffee,Eating Out,2,232
26,5,2016,Starbucks Coffee,Eating Out,2,230
26,5,2016,Subway,Eating Out,7,223
26,5,2016,Civic Shop,,9,214
27,5,2016,Sainsburys,Groceries,42,172
27,5,2016,Starbucks Coffee,Eating Out,2,170
27,5,2016,Chicken Cottage,Eating Out,5,165
28,5,2016,Ministry of Sound ClubXOYO Club,Eating Out,13,152
28,5,2016,Pizza Express,Eating Out,47,105
28,5,2016,ATM Cash Withdrawal,General,10,95
29,5,2016,Scott's Restaurant,Eating Out,40,55
29,5,2016,ATM Cash Withdrawal,General,20,35
30,5,2016,South West Trains,Transport,37,-2
30,5,2016,Wild Bean Cafe,Eating Out,2,-4
30,5,2016,Greggs,Eating Out,7,-11
31,5,2016,Starbucks Coffee,Eating Out,1,-12
31,5,2016,McDonalds,Eating Out,5,-17
1,6,2016,Rhino Sports salary,General,1700,1683
1,6,2016,Costa Coffee,Eating Out,2,1681
2,6,2016,Subway,Eating Out,7,1674
2,6,2016,ATM Cash Withdrawal,General,10,1664
2,6,2016,Cheam Service Station,,8,1656
3,6,2016,Sainsburys,Groceries,56,1600
3,6,2016,Caffe Nero,Eating Out,2,1598
3,6,2016,Subway,Eating Out,7,1591
3,6,2016,Fabric Club,Eating Out,15,1576
3,6,2016,Fabric Club,Eating Out,8,1568
3,6,2016,Fabric Club,Eating Out,13,1555
3,6,2016,Fabric Club,Eating Out,11,1544
3,6,2016,ATM Cash Withdrawal,General,20,1524
5,6,2016,Pizza Express,Eating Out,50,1474
6,6,2016,South West Trains,Transport,31,1443
6,6,2016,Costa Coffee,Eating Out,1,1442
6,6,2016,Subway,Eating Out,7,1435
7,6,2016,Cubit and West rent,Rent,550,885
7,6,2016,Costa Coffee,Eating Out,2,883
7,6,2016,McDonalds,Eating Out,8,875
8,6,2016,Wild Bean Cafe,Eating Out,2,873
8,6,2016,Subway,Eating Out,6,867
9,6,2016,Caffe Nero,Eating Out,2,865
9,6,2016,Greggs,Eating Out,6,859
9,6,2016,ATM Cash Withdrawal,General,10,849
10,6,2016,Morrisons,Groceries,79,770
10,6,2016,Caffe Nero,Eating Out,2,768
10,6,2016,Greggs,Eating Out,8,760
10,6,2016,ATM Cash Withdrawal,General,10,750
11,6,2016,Scott's Restaurant,Eating Out,33,717
11,6,2016,ATM Cash Withdrawal,General,10,707
12,6,2016,Restaurant Gordon RamsayPortland Restaurant,Eating Out,26,681
13,6,2016,South West Trains,Transport,29,652
14,6,2016,Starbucks Coffee,Eating Out,1,651
14,6,2016,McDonalds,Eating Out,6,645
15,6,2016,BRGAS-Electricity,Bills,39,606
15,6,2016,BRGAS-Gas,Bills,25,581
15,6,2016,Costa Coffee,Eating Out,1,580
15,6,2016,Chicken Cottage,Eating Out,8,572
15,6,2016,Red Shop,,1,571
16,6,2016,LBS Council Tax,Bills,50,521
16,6,2016,Starbucks Coffee,Eating Out,2,519
16,6,2016,Subway,Eating Out,6,513
16,6,2016,ATM Cash Withdrawal,General,10,503
17,6,2016,Waitrose,Groceries,44,459
17,6,2016,Wild Bean Cafe,Eating Out,2,457
17,6,2016,McDonalds,Eating Out,7,450
17,6,2016,ATM Cash Withdrawal,General,20,430
18,6,2016,Dominos Pizza,Eating Out,33,397
20,6,2016,VIRGIN MEDIA PYMTS,Bills,39,358
20,6,2016,South West Trains,Transport,33,325
20,6,2016,Wild Bean Cafe,Eating Out,2,323
20,6,2016,Pret A Manger,Eating Out,5,318
21,6,2016,Costa Coffee,Eating Out,2,316
21,6,2016,Pret A Manger,Eating Out,7,309
21,6,2016,Civic Shop,,1,308
22,6,2016,Costa Coffee,Eating Out,1,307
22,6,2016,Chicken Cottage,Eating Out,5,302
23,6,2016,Chicken Cottage,Eating Out,5,297
24,6,2016,O2,Bills,34,263
24,6,2016,ASDA,Groceries,80,183
24,6,2016,Starbucks Coffee,Eating Out,2,181
24,6,2016,Greggs,Eating Out,7,174
26,6,2016,ATM Cash Withdrawal,General,10,164
27,6,2016,South West Trains,Transport,33,131
27,6,2016,Wild Bean Cafe,Eating Out,1,130
27,6,2016,Subway,Eating Out,8,122
28,6,2016,ATM Cash Withdrawal,General,20,102
29,6,2016,Starbucks Coffee,Eating Out,2,100
29,6,2016,McDonalds,Eating Out,5,95
30,6,2016,Costa Coffee,Eating Out,1,94
30,6,2016,McDonalds,Eating Out,5,89
30,6,2016,Paying back James,,5,84
1,7,2016,Rhino Sports salary,General,1700,1784
1,7,2016,Morrisons,Groceries,56,1728
1,7,2016,Starbucks Coffee,Eating Out,1,1727
1,7,2016,Subway,Eating Out,6,1721
1,7,2016,Fabric Club,Eating Out,7,1714
1,7,2016,Fabric Club,Eating Out,11,1703
1,7,2016,Fabric Club,Eating Out,13,1690
1,7,2016,Fabric Club,Eating Out,13,1677
1,7,2016,Fabric Club,Eating Out,11,1666
1,7,2016,Fabric Club,Eating Out,8,1658
1,7,2016,ATM Cash Withdrawal,General,10,1648
2,7,2016,The Grand Pub,Eating Out,9,1639
2,7,2016,The Grand Pub,Eating Out,10,1629
2,7,2016,Anglo restaurant,Eating Out,45,1584
2,7,2016,ATM Cash Withdrawal,General,10,1574
4,7,2016,South West Trains,Transport,25,1549
4,7,2016,Greggs,Eating Out,4,1545
4,7,2016,ATM Cash Withdrawal,General,20,1525
5,7,2016,Starbucks Coffee,Eating Out,2,1523
5,7,2016,Chicken Cottage,Eating Out,7,1516
5,7,2016,Paying back Julie,,2,1514
6,7,2016,Starbucks Coffee,Eating Out,1,1513
6,7,2016,Chicken Cottage,Eating Out,4,1509
7,7,2016,Cubit and West rent,Rent,550,959
7,7,2016,Starbucks Coffee,Eating Out,2,957
7,7,2016,Pret A Manger,Eating Out,7,950
8,7,2016,Sainsburys,Groceries,59,891
8,7,2016,Dominos Pizza,Eating Out,38,853
8,7,2016,ATM Cash Withdrawal,General,10,843
9,7,2016,Fabric Club,Eating Out,5,838
9,7,2016,Fabric Club,Eating Out,6,832
9,7,2016,Fabric Club,Eating Out,9,823
9,7,2016,Fabric Club,Eating Out,12,811
9,7,2016,Fabric Club,Eating Out,12,799
10,7,2016,ATM Cash Withdrawal,General,20,779
11,7,2016,South West Trains,Transport,33,746
11,7,2016,Costa Coffee,Eating Out,1,745
12,7,2016,Costa Coffee,Eating Out,2,743
12,7,2016,Chicken Cottage,Eating Out,5,738
12,7,2016,ATM Cash Withdrawal,General,10,728
13,7,2016,Caffe Nero,Eating Out,1,727
13,7,2016,ATM Cash Withdrawal,General,20,707
14,7,2016,Starbucks Coffee,Eating Out,2,705
14,7,2016,Chicken Cottage,Eating Out,7,698
15,7,2016,BRGAS-Electricity,Bills,21,677
15,7,2016,BRGAS-Gas,Bills,21,656
15,7,2016,ASDA,Groceries,77,579
15,7,2016,Costa Coffee,Eating Out,2,577
15,7,2016,Subway,Eating Out,8,569
16,7,2016,LBS Council Tax,Bills,50,519
16,7,2016,Cheam Service Station,,1,518
17,7,2016,ATM Cash Withdrawal,General,20,498
18,7,2016,South West Trains,Transport,25,473
18,7,2016,ATM Cash Withdrawal,General,20,453
19,7,2016,Costa Coffee,Eating Out,2,451
19,7,2016,The West Cornwall Pasty Company,Eating Out,8,443
19,7,2016,ATM Cash Withdrawal,General,20,423
19,7,2016,Civic Shop,,1,422
20,7,2016,VIRGIN MEDIA PYMTS,Bills,45,377
20,7,2016,Caffe Nero,Eating Out,2,375
20,7,2016,The West Cornwall Pasty Company,Eating Out,7,368
21,7,2016,Wild Bean Cafe,Eating Out,1,367
21,7,2016,McDonalds,Eating Out,5,362
21,7,2016,ATM Cash Withdrawal,General,20,342
21,7,2016,Cheam Service Station,,2,340
22,7,2016,Waitrose,Groceries,61,279
22,7,2016,Wild Bean Cafe,Eating Out,1,278
22,7,2016,Pret A Manger,Eating Out,6,272
22,7,2016,ATM Cash Withdrawal,General,10,262
24,7,2016,O2,Bills,32,230
24,7,2016,ATM Cash Withdrawal,General,10,220
25,7,2016,South West Trains,Transport,28,192
25,7,2016,Chicken Cottage,Eating Out,8,184
26,7,2016,Wild Bean Cafe,Eating Out,2,182
26,7,2016,Pret A Manger,Eating Out,7,175
27,7,2016,Subway,Eating Out,8,167
27,7,2016,ATM Cash Withdrawal,General,20,147
28,7,2016,Costa Coffee,Eating Out,1,146
28,7,2016,The West Cornwall Pasty Company,Eating Out,7,139
29,7,2016,Sainsburys,Groceries,85,54
30,7,2016,Pizza Express,Eating Out,27,27
31,7,2016,ATM Cash Withdrawal,General,20,7
31,7,2016,Civic Shop,,5,2
1,8,2016,Rhino Sports salary,General,1700,1702
1,8,2016,South West Trains,Transport,37,1665
1,8,2016,Starbucks Coffee,Eating Out,2,1663
1,8,2016,Subway,Eating Out,7,1656
2,8,2016,Costa Coffee,Eating Out,2,1654
3,8,2016,Wild Bean Cafe,Eating Out,2,1652
3,8,2016,The West Cornwall Pasty Company,Eating Out,8,1644
3,8,2016,ATM Cash Withdrawal,General,20,1624
4,8,2016,Starbucks Coffee,Eating Out,1,1623
4,8,2016,McDonalds,Eating Out,4,1619
5,8,2016,Tescos,Groceries,52,1567
5,8,2016,Starbucks Coffee,Eating Out,2,1565
5,8,2016,The Grand Pub,Eating Out,16,1549
5,8,2016,The Grand Pub,Eating Out,16,1533
5,8,2016,The Grand Pub,Eating Out,10,1523
5,8,2016,ATM Cash Withdrawal,General,20,1503
6,8,2016,ATM Cash Withdrawal,General,10,1493
6,8,2016,Tool Shop,,2,1491
7,8,2016,Cubit and West rent,Rent,550,941
7,8,2016,Scott's Restaurant,Eating Out,39,902
8,8,2016,South West Trains,Transport,37,865
8,8,2016,Costa Coffee,Eating Out,1,864
8,8,2016,Pret A Manger,Eating Out,5,859
8,8,2016,ATM Cash Withdrawal,General,20,839
9,8,2016,McDonalds,Eating Out,8,831
10,8,2016,Caffe Nero,Eating Out,2,829
10,8,2016,Chicken Cottage,Eating Out,8,821
11,8,2016,Starbucks Coffee,Eating Out,2,819
11,8,2016,ATM Cash Withdrawal,General,20,799
12,8,2016,ASDA,Groceries,46,753
12,8,2016,Caffe Nero,Eating Out,2,751
12,8,2016,Dominos Pizza,Eating Out,56,695
14,8,2016,ATM Cash Withdrawal,General,20,675
15,8,2016,BRGAS-Electricity,Bills,31,644
15,8,2016,BRGAS-Gas,Bills,29,615
15,8,2016,South West Trains,Transport,26,589
15,8,2016,Costa Coffee,Eating Out,2,587
15,8,2016,Greggs,Eating Out,5,582
16,8,2016,LBS Council Tax,Bills,50,532
16,8,2016,ATM Cash Withdrawal,General,10,522
17,8,2016,Starbucks Coffee,Eating Out,1,521
17,8,2016,Greggs,Eating Out,6,515
17,8,2016,ATM Cash Withdrawal,General,10,505
18,8,2016,Wild Bean Cafe,Eating Out,2,503
18,8,2016,ATM Cash Withdrawal,General,10,493
19,8,2016,Tescos,Groceries,51,442
19,8,2016,Costa Coffee,Eating Out,2,440
19,8,2016,McDonalds,Eating Out,4,436
20,8,2016,VIRGIN MEDIA PYMTS,Bills,32,404
20,8,2016,Pizza Express,Eating Out,59,345
21,8,2016,ATM Cash Withdrawal,General,10,335
21,8,2016,Tool Tec,,8,327
22,8,2016,South West Trains,Transport,34,293
22,8,2016,Pret A Manger,Eating Out,7,286
23,8,2016,Wild Bean Cafe,Eating Out,1,285
24,8,2016,O2,Bills,32,253
24,8,2016,Costa Coffee,Eating Out,1,252
24,8,2016,ATM Cash Withdrawal,General,10,242
25,8,2016,Starbucks Coffee,Eating Out,2,240
26,8,2016,Waitrose,Groceries,63,177
26,8,2016,Wild Bean Cafe,Eating Out,2,175
26,8,2016,Pret A Manger,Eating Out,6,169
26,8,2016,Anglo restaurant,Eating Out,24,145
29,8,2016,South West Trains,Transport,35,110
29,8,2016,Subway,Eating Out,8,102
30,8,2016,Starbucks Coffee,Eating Out,1,101
30,8,2016,Greggs,Eating Out,6,95
31,8,2016,Starbucks Coffee,Eating Out,1,94
31,8,2016,ATM Cash Withdrawal,General,20,74
1,9,2016,Rhino Sports salary,General,1700,1774
1,9,2016,Costa Coffee,Eating Out,1,1773
1,9,2016,Chicken Cottage,Eating Out,5,1768
2,9,2016,Waitrose,Groceries,50,1718
2,9,2016,Starbucks Coffee,Eating Out,2,1716
2,9,2016,Pret A Manger,Eating Out,7,1709
3,9,2016,ATM Cash Withdrawal,General,10,1699
4,9,2016,Dominos Pizza,Eating Out,25,1674
4,9,2016,ATM Cash Withdrawal,General,20,1654
5,9,2016,South West Trains,Transport,29,1625
6,9,2016,Wild Bean Cafe,Eating Out,2,1623
6,9,2016,Subway,Eating Out,6,1617
7,9,2016,Cubit and West rent,Rent,550,1067
9,9,2016,ASDA,Groceries,76,991
9,9,2016,Ministry of Sound ClubXOYO Club,Eating Out,15,976
9,9,2016,Ministry of Sound ClubXOYO Club,Eating Out,16,960
9,9,2016,Ministry of Sound ClubXOYO Club,Eating Out,16,944
9,9,2016,Ministry of Sound ClubXOYO Club,Eating Out,5,939
9,9,2016,Dominos Pizza,Eating Out,31,908
10,9,2016,Scott's Restaurant,Eating Out,54,854
11,9,2016,Anglo restaurant,Eating Out,33,821
12,9,2016,South West Trains,Transport,33,788
12,9,2016,Costa Coffee,Eating Out,2,786
12,9,2016,The West Cornwall Pasty Company,Eating Out,8,778
12,9,2016,ATM Cash Withdrawal,General,10,768
13,9,2016,Wild Bean Cafe,Eating Out,2,766
13,9,2016,Greggs,Eating Out,5,761
13,9,2016,ATM Cash Withdrawal,General,20,741
14,9,2016,Costa Coffee,Eating Out,2,739
14,9,2016,Pret A Manger,Eating Out,5,734
15,9,2016,BRGAS-Electricity,Bills,35,699
15,9,2016,BRGAS-Gas,Bills,32,667
15,9,2016,Wild Bean Cafe,Eating Out,2,665
15,9,2016,McDonalds,Eating Out,6,659
15,9,2016,ATM Cash Withdrawal,General,20,639
15,9,2016,Cheam Service Station,,3,636
16,9,2016,LBS Council Tax,Bills,50,586
16,9,2016,Morrisons,Groceries,49,537
16,9,2016,Wild Bean Cafe,Eating Out,2,535
16,9,2016,McDonalds,Eating Out,6,529
16,9,2016,Dominos Pizza,Eating Out,40,489
17,9,2016,Scott's Restaurant,Eating Out,43,446
18,9,2016,ATM Cash Withdrawal,General,10,436
19,9,2016,South West Trains,Transport,24,412
19,9,2016,Caffe Nero,Eating Out,2,410
20,9,2016,VIRGIN MEDIA PYMTS,Bills,55,355
20,9,2016,Costa Coffee,Eating Out,2,353
20,9,2016,ATM Cash Withdrawal,General,10,343
21,9,2016,Wild Bean Cafe,Eating Out,1,342
21,9,2016,Red Shop,,1,341
22,9,2016,Costa Coffee,Eating Out,2,339
22,9,2016,Pret A Manger,Eating Out,5,334
22,9,2016,ATM Cash Withdrawal,General,10,324
23,9,2016,Waitrose,Groceries,81,243
23,9,2016,Costa Coffee,Eating Out,2,241
23,9,2016,Subway,Eating Out,4,237
23,9,2016,ATM Cash Withdrawal,General,20,217
24,9,2016,O2,Bills,38,179
24,9,2016,Ministry of Sound ClubXOYO Club,Eating Out,6,173
24,9,2016,Ministry of Sound ClubXOYO Club,Eating Out,8,165
24,9,2016,Ministry of Sound ClubXOYO Club,Eating Out,16,149
24,9,2016,Ministry of Sound ClubXOYO Club,Eating Out,14,135
24,9,2016,Ministry of Sound ClubXOYO Club,Eating Out,6,129
25,9,2016,Pizza Express,Eating Out,31,98
25,9,2016,ATM Cash Withdrawal,General,10,88
26,9,2016,South West Trains,Transport,27,61
26,9,2016,Wild Bean Cafe,Eating Out,2,59
26,9,2016,Pret A Manger,Eating Out,6,53
26,9,2016,ATM Cash Withdrawal,General,10,43
27,9,2016,Wild Bean Cafe,Eating Out,2,41
27,9,2016,McDonalds,Eating Out,8,33
28,9,2016,Caffe Nero,Eating Out,2,31
29,9,2016,Caffe Nero,Eating Out,2,29
29,9,2016,The West Cornwall Pasty Company,Eating Out,7,22
30,9,2016,ASDA,Groceries,79,-57
30,9,2016,Starbucks Coffee,Eating Out,2,-59
30,9,2016,Chicken Cottage,Eating Out,8,-67
1,10,2016,Rhino Sports salary,General,1700,1633
2,10,2016,Dominos Pizza,Eating Out,30,1603
2,10,2016,ATM Cash Withdrawal,General,20,1583
3,10,2016,South West Trains,Transport,34,1549
3,10,2016,Wild Bean Cafe,Eating Out,2,1547
5,10,2016,Wild Bean Cafe,Eating Out,1,1546
5,10,2016,Subway,Eating Out,4,1542
6,10,2016,Caffe Nero,Eating Out,1,1541
6,10,2016,Greggs,Eating Out,8,1533
7,10,2016,Cubit and West rent,Rent,550,983
7,10,2016,ASDA,Groceries,69,914
7,10,2016,Caffe Nero,Eating Out,1,913
7,10,2016,Pret A Manger,Eating Out,8,905
8,10,2016,ATM Cash Withdrawal,General,10,895
10,10,2016,South West Trains,Transport,38,857
10,10,2016,Wild Bean Cafe,Eating Out,2,855
11,10,2016,Wild Bean Cafe,Eating Out,1,854
11,10,2016,Cheam Service Station,,8,846
12,10,2016,Starbucks Coffee,Eating Out,1,845
12,10,2016,Subway,Eating Out,7,838
14,10,2016,ASDA,Groceries,60,778
14,10,2016,Caffe Nero,Eating Out,1,777
14,10,2016,Fabric Club,Eating Out,7,770
14,10,2016,Fabric Club,Eating Out,12,758
14,10,2016,ATM Cash Withdrawal,General,10,748
14,10,2016,Red Shop,,5,743
15,10,2016,BRGAS-Electricity,Bills,23,720
15,10,2016,BRGAS-Gas,Bills,41,679
16,10,2016,LBS Council Tax,Bills,50,629
17,10,2016,South West Trains,Transport,26,603
17,10,2016,Costa Coffee,Eating Out,2,601
17,10,2016,Greggs,Eating Out,6,595
18,10,2016,Wild Bean Cafe,Eating Out,1,594
18,10,2016,Pret A Manger,Eating Out,5,589
18,10,2016,ATM Cash Withdrawal,General,20,569
19,10,2016,The West Cornwall Pasty Company,Eating Out,8,561
20,10,2016,VIRGIN MEDIA PYMTS,Bills,43,518
20,10,2016,Wild Bean Cafe,Eating Out,2,516
20,10,2016,Subway,Eating Out,5,511
20,10,2016,ATM Cash Withdrawal,General,20,491
21,10,2016,Tescos,Groceries,84,407
21,10,2016,Wild Bean Cafe,Eating Out,2,405
21,10,2016,Pret A Manger,Eating Out,7,398
24,10,2016,O2,Bills,38,360
24,10,2016,South West Trains,Transport,27,333
24,10,2016,The West Cornwall Pasty Company,Eating Out,7,326
25,10,2016,Starbucks Coffee,Eating Out,2,324
25,10,2016,Pret A Manger,Eating Out,6,318
26,10,2016,Starbucks Coffee,Eating Out,2,316
26,10,2016,Chicken Cottage,Eating Out,7,309
26,10,2016,ATM Cash Withdrawal,General,20,289
27,10,2016,Wild Bean Cafe,Eating Out,2,287
27,10,2016,Pret A Manger,Eating Out,6,281
27,10,2016,ATM Cash Withdrawal,General,20,261
28,10,2016,Tescos,Groceries,48,213
28,10,2016,Costa Coffee,Eating Out,1,212
28,10,2016,Chicken Cottage,Eating Out,5,207
28,10,2016,Restaurant Gordon RamsayPortland Restaurant,Eating Out,40,167
31,10,2016,South West Trains,Transport,30,137
31,10,2016,Wild Bean Cafe,Eating Out,2,135
1,11,2016,Rhino Sports salary,General,1700,1835
3,11,2016,Starbucks Coffee,Eating Out,1,1834
3,11,2016,ATM Cash Withdrawal,General,10,1824
4,11,2016,ASDA,Groceries,55,1769
4,11,2016,Starbucks Coffee,Eating Out,2,1767
4,11,2016,Dominos Pizza,Eating Out,53,1714
4,11,2016,ATM Cash Withdrawal,General,10,1704
5,11,2016,The Grand Pub,Eating Out,7,1697
5,11,2016,The Grand Pub,Eating Out,9,1688
5,11,2016,The Grand Pub,Eating Out,13,1675
5,11,2016,The Grand Pub,Eating Out,11,1664
5,11,2016,ATM Cash Withdrawal,General,10,1654
6,11,2016,ATM Cash Withdrawal,General,20,1634
7,11,2016,Cubit and West rent,Rent,550,1084
7,11,2016,South West Trains,Transport,30,1054
7,11,2016,Costa Coffee,Eating Out,1,1053
7,11,2016,Subway,Eating Out,5,1048
8,11,2016,Starbucks Coffee,Eating Out,2,1046
8,11,2016,Chicken Cottage,Eating Out,7,1039
9,11,2016,Costa Coffee,Eating Out,2,1037
10,11,2016,Costa Coffee,Eating Out,2,1035
10,11,2016,McDonalds,Eating Out,5,1030
11,11,2016,ASDA,Groceries,56,974
11,11,2016,Caffe Nero,Eating Out,1,973
11,11,2016,Greggs,Eating Out,5,968
11,11,2016,Civic Shop,,1,967
12,11,2016,ATM Cash Withdrawal,General,10,957
13,11,2016,ATM Cash Withdrawal,General,20,937
14,11,2016,South West Trains,Transport,33,904
14,11,2016,Costa Coffee,Eating Out,2,902
15,11,2016,BRGAS-Electricity,Bills,23,879
15,11,2016,BRGAS-Gas,Bills,55,824
15,11,2016,Caffe Nero,Eating Out,2,822
15,11,2016,Pret A Manger,Eating Out,4,818
16,11,2016,LBS Council Tax,Bills,50,768
16,11,2016,Wild Bean Cafe,Eating Out,2,766
16,11,2016,The West Cornwall Pasty Company,Eating Out,8,758
17,11,2016,Costa Coffee,Eating Out,2,756
17,11,2016,Greggs,Eating Out,6,750
17,11,2016,ATM Cash Withdrawal,General,10,740
17,11,2016,Paying back James,,5,735
18,11,2016,Morrisons,Groceries,64,671
18,11,2016,Costa Coffee,Eating Out,2,669
18,11,2016,Pret A Manger,Eating Out,6,663
18,11,2016,Scott's Restaurant,Eating Out,53,610
19,11,2016,ATM Cash Withdrawal,General,10,600
19,11,2016,Tool Shop,,8,592
20,11,2016,VIRGIN MEDIA PYMTS,Bills,46,546
20,11,2016,Pizza Express,Eating Out,37,509
21,11,2016,South West Trains,Transport,36,473
21,11,2016,Pret A Manger,Eating Out,8,465
21,11,2016,ATM Cash Withdrawal,General,10,455
22,11,2016,Subway,Eating Out,6,449
23,11,2016,Caffe Nero,Eating Out,2,447
23,11,2016,Chicken Cottage,Eating Out,6,441
24,11,2016,O2,Bills,36,405
24,11,2016,Wild Bean Cafe,Eating Out,1,404
24,11,2016,ATM Cash Withdrawal,General,20,384
25,11,2016,Waitrose,Groceries,77,307
25,11,2016,Caffe Nero,Eating Out,2,305
25,11,2016,Chicken Cottage,Eating Out,7,298
25,11,2016,Dominos Pizza,Eating Out,28,270
25,11,2016,ATM Cash Withdrawal,General,10,260
25,11,2016,Red Shop,,6,254
26,11,2016,ATM Cash Withdrawal,General,10,244
27,11,2016,Restaurant Gordon RamsayPortland Restaurant,Eating Out,29,215
28,11,2016,South West Trains,Transport,32,183
28,11,2016,Caffe Nero,Eating Out,2,181
28,11,2016,McDonalds,Eating Out,6,175
28,11,2016,ATM Cash Withdrawal,General,20,155
29,11,2016,Greggs,Eating Out,8,147
1,12,2016,Rhino Sports salary,General,1700,1847
1,12,2016,Costa Coffee,Eating Out,2,1845
1,12,2016,The West Cornwall Pasty Company,Eating Out,5,1840
1,12,2016,Paying back James,,8,1832
2,12,2016,Waitrose,Groceries,48,1784
2,12,2016,Caffe Nero,Eating Out,2,1782
2,12,2016,Pret A Manger,Eating Out,8,1774
2,12,2016,Pizza Express,Eating Out,29,1745
2,12,2016,ATM Cash Withdrawal,General,10,1735
3,12,2016,Fabric Club,Eating Out,11,1724
3,12,2016,Fabric Club,Eating Out,9,1715
3,12,2016,Fabric Club,Eating Out,5,1710
3,12,2016,Fabric Club,Eating Out,11,1699
4,12,2016,Pizza Express,Eating Out,53,1646
5,12,2016,South West Trains,Transport,25,1621
5,12,2016,Costa Coffee,Eating Out,2,1619
5,12,2016,Greggs,Eating Out,7,1612
5,12,2016,ATM Cash Withdrawal,General,10,1602
6,12,2016,Costa Coffee,Eating Out,2,1600
6,12,2016,Chicken Cottage,Eating Out,8,1592
7,12,2016,Cubit and West rent,Rent,550,1042
7,12,2016,McDonalds,Eating Out,8,1034
7,12,2016,Paying back Julie,,3,1031
8,12,2016,Pret A Manger,Eating Out,4,1027
9,12,2016,Sainsburys,Groceries,66,961
9,12,2016,Starbucks Coffee,Eating Out,1,960
9,12,2016,The West Cornwall Pasty Company,Eating Out,5,955
9,12,2016,Anglo restaurant,Eating Out,49,906
10,12,2016,Anglo restaurant,Eating Out,46,860
11,12,2016,Restaurant Gordon RamsayPortland Restaurant,Eating Out,25,835
12,12,2016,South West Trains,Transport,32,803
12,12,2016,Wild Bean Cafe,Eating Out,2,801
12,12,2016,Greggs,Eating Out,7,794
12,12,2016,ATM Cash Withdrawal,General,10,784
13,12,2016,Wild Bean Cafe,Eating Out,2,782
13,12,2016,Pret A Manger,Eating Out,4,778
14,12,2016,Wild Bean Cafe,Eating Out,2,776
14,12,2016,Paying back Julie,,1,775
15,12,2016,BRGAS-Electricity,Bills,43,732
15,12,2016,BRGAS-Gas,Bills,27,705
15,12,2016,Caffe Nero,Eating Out,2,703
15,12,2016,Greggs,Eating Out,7,696
15,12,2016,Red Shop,,8,688
16,12,2016,LBS Council Tax,Bills,50,638
16,12,2016,Waitrose,Groceries,42,596
16,12,2016,Greggs,Eating Out,7,589
19,12,2016,South West Trains,Transport,31,558
19,12,2016,Greggs,Eating Out,5,553
20,12,2016,VIRGIN MEDIA PYMTS,Bills,58,495
20,12,2016,McDonalds,Eating Out,7,488
21,12,2016,Caffe Nero,Eating Out,2,486
21,12,2016,Subway,Eating Out,7,479
22,12,2016,Starbucks Coffee,Eating Out,2,477
23,12,2016,Sainsburys,Groceries,61,416
23,12,2016,Pret A Manger,Eating Out,5,411
23,12,2016,ATM Cash Withdrawal,General,10,401
24,12,2016,O2,Bills,38,363
24,12,2016,Ministry of Sound ClubXOYO Club,Eating Out,15,348
24,12,2016,Ministry of Sound ClubXOYO Club,Eating Out,11,337
24,12,2016,Ministry of Sound ClubXOYO Club,Eating Out,8,329
24,12,2016,Ministry of Sound ClubXOYO Club,Eating Out,5,324
24,12,2016,Ministry of Sound ClubXOYO Club,Eating Out,9,315
24,12,2016,ATM Cash Withdrawal,General,10,305
25,12,2016,Scott's Restaurant,Eating Out,41,264
26,12,2016,South West Trains,Transport,37,227
26,12,2016,Wild Bean Cafe,Eating Out,2,225
26,12,2016,Subway,Eating Out,5,220
26,12,2016,ATM Cash Withdrawal,General,10,210
27,12,2016,Wild Bean Cafe,Eating Out,1,209
27,12,2016,ATM Cash Withdrawal,General,10,199
28,12,2016,Costa Coffee,Eating Out,1,198
28,12,2016,Subway,Eating Out,6,192
29,12,2016,Caffe Nero,Eating Out,2,190
29,12,2016,McDonalds,Eating Out,4,186
30,12,2016,Morrisons,Groceries,43,143
30,12,2016,Caffe Nero,Eating Out,2,141
30,12,2016,ATM Cash Withdrawal,General,20,121
31,12,2016,The Grand Pub,Eating Out,8,113
31,12,2016,The Grand Pub,Eating Out,12,101
31,12,2016,The Grand Pub,Eating Out,16,85
31,12,2016,The Grand Pub,Eating Out,14,71
31,12,2016,The Grand Pub,Eating Out,8,63
1,1,2017,Rhino Sports salary,General,1700,1763
1,1,2017,Pizza Express,Eating Out,51,1712
2,1,2017,South West Trains,Transport,34,1678
2,1,2017,Caffe Nero,Eating Out,2,1676
2,1,2017,Pret A Manger,Eating Out,6,1670
3,1,2017,McDonalds,Eating Out,5,1665
3,1,2017,Tool Tec,,9,1656
4,1,2017,Starbucks Coffee,Eating Out,1,1655
5,1,2017,Starbucks Coffee,Eating Out,2,1653
5,1,2017,Greggs,Eating Out,5,1648
6,1,2017,Waitrose,Groceries,83,1565
6,1,2017,Costa Coffee,Eating Out,1,1564
6,1,2017,The West Cornwall Pasty Company,Eating Out,5,1559
6,1,2017,ATM Cash Withdrawal,General,10,1549
7,1,2017,Cubit and West rent,Rent,550,999
7,1,2017,The Grand Pub,Eating Out,10,989
7,1,2017,The Grand Pub,Eating Out,5,984
7,1,2017,The Grand Pub,Eating Out,10,974
9,1,2017,South West Trains,Transport,38,936
9,1,2017,Caffe Nero,Eating Out,2,934
9,1,2017,Pret A Manger,Eating Out,8,926
9,1,2017,ATM Cash Withdrawal,General,20,906
9,1,2017,Civic Shop,,8,898
10,1,2017,Costa Coffee,Eating Out,1,897
10,1,2017,Chicken Cottage,Eating Out,7,890
12,1,2017,Caffe Nero,Eating Out,2,888
12,1,2017,Pret A Manger,Eating Out,7,881
13,1,2017,Sainsburys,Groceries,86,795
13,1,2017,Caffe Nero,Eating Out,2,793
13,1,2017,The West Cornwall Pasty Company,Eating Out,6,787
13,1,2017,Scott's Restaurant,Eating Out,34,753
14,1,2017,ATM Cash Withdrawal,General,10,743
15,1,2017,BRGAS-Electricity,Bills,83,660
15,1,2017,BRGAS-Gas,Bills,43,617
15,1,2017,ATM Cash Withdrawal,General,20,597
16,1,2017,LBS Council Tax,Bills,50,547
16,1,2017,South West Trains,Transport,32,515
16,1,2017,Starbucks Coffee,Eating Out,2,513
16,1,2017,The West Cornwall Pasty Company,Eating Out,7,506
16,1,2017,ATM Cash Withdrawal,General,10,496
17,1,2017,Caffe Nero,Eating Out,1,495
17,1,2017,Chicken Cottage,Eating Out,7,488
17,1,2017,Tool Shop,,7,481
18,1,2017,Caffe Nero,Eating Out,1,480
18,1,2017,McDonalds,Eating Out,5,475
19,1,2017,Pret A Manger,Eating Out,8,467
20,1,2017,VIRGIN MEDIA PYMTS,Bills,31,436
20,1,2017,ASDA,Groceries,62,374
20,1,2017,Pizza Express,Eating Out,31,343
21,1,2017,Scott's Restaurant,Eating Out,48,295
22,1,2017,Scott's Restaurant,Eating Out,24,271
23,1,2017,South West Trains,Transport,33,238
23,1,2017,Wild Bean Cafe,Eating Out,2,236
24,1,2017,O2,Bills,36,200
24,1,2017,Caffe Nero,Eating Out,1,199
25,1,2017,Caffe Nero,Eating Out,1,198
25,1,2017,McDonalds,Eating Out,5,193
26,1,2017,Pret A Manger,Eating Out,7,186
26,1,2017,ATM Cash Withdrawal,General,20,166
27,1,2017,Sainsburys,Groceries,58,108
27,1,2017,The West Cornwall Pasty Company,Eating Out,4,104
27,1,2017,Dominos Pizza,Eating Out,52,52
28,1,2017,Restaurant Gordon RamsayPortland Restaurant,Eating Out,50,2
28,1,2017,ATM Cash Withdrawal,General,20,-18
28,1,2017,Tool Shop,,4,-22
30,1,2017,South West Trains,Transport,34,-56
30,1,2017,Costa Coffee,Eating Out,1,-57
31,1,2017,Starbucks Coffee,Eating Out,2,-59
31,1,2017,ATM Cash Withdrawal,General,20,-79
31,1,2017,Paying back James,,3,-82
1,2,2017,Rhino Sports salary,General,1700,1618
1,2,2017,Chicken Cottage,Eating Out,7,1611
2,2,2017,Wild Bean Cafe,Eating Out,1,1610
3,2,2017,Tescos,Groceries,82,1528
3,2,2017,Wild Bean Cafe,Eating Out,1,1527
3,2,2017,Pizza Express,Eating Out,35,1492
4,2,2017,Heaven Club,Eating Out,16,1476
5,2,2017,Dominos Pizza,Eating Out,35,1441
6,2,2017,South West Trains,Transport,35,1406
6,2,2017,Wild Bean Cafe,Eating Out,1,1405
6,2,2017,Greggs,Eating Out,5,1400
6,2,2017,Red Shop,,8,1392
7,2,2017,Cubit and West rent,Rent,550,842
7,2,2017,Wild Bean Cafe,Eating Out,2,840
7,2,2017,Greggs,Eating Out,4,836
9,2,2017,Costa Coffee,Eating Out,1,835
9,2,2017,The West Cornwall Pasty Company,Eating Out,4,831
10,2,2017,Morrisons,Groceries,59,772
10,2,2017,McDonalds,Eating Out,6,766
10,2,2017,ATM Cash Withdrawal,General,20,746
10,2,2017,Paying back Julie,,6,740
12,2,2017,Pizza Express,Eating Out,58,682
13,2,2017,South West Trains,Transport,31,651
13,2,2017,Starbucks Coffee,Eating Out,1,650
14,2,2017,Costa Coffee,Eating Out,1,649
14,2,2017,Subway,Eating Out,4,645
14,2,2017,ATM Cash Withdrawal,General,10,635
15,2,2017,BRGAS-Electricity,Bills,32,603
15,2,2017,BRGAS-Gas,Bills,42,561
15,2,2017,ATM Cash Withdrawal,General,10,551
16,2,2017,LBS Council Tax,Bills,50,501
16,2,2017,Costa Coffee,Eating Out,2,499
16,2,2017,Cheam Service Station,,5,494
17,2,2017,ASDA,Groceries,49,445
17,2,2017,Subway,Eating Out,4,441
20,2,2017,VIRGIN MEDIA PYMTS,Bills,57,384
20,2,2017,South West Trains,Transport,33,351
20,2,2017,Starbucks Coffee,Eating Out,2,349
20,2,2017,Pret A Manger,Eating Out,6,343
21,2,2017,Starbucks Coffee,Eating Out,2,341
21,2,2017,McDonalds,Eating Out,5,336
21,2,2017,ATM Cash Withdrawal,General,10,326
21,2,2017,Tool Tec,,6,320
22,2,2017,Caffe Nero,Eating Out,2,318
23,2,2017,Costa Coffee,Eating Out,1,317
24,2,2017,O2,Bills,35,282
24,2,2017,Sainsburys,Groceries,65,217
24,2,2017,Costa Coffee,Eating Out,1,216
24,2,2017,Pret A Manger,Eating Out,5,211
25,2,2017,ATM Cash Withdrawal,General,20,191
26,2,2017,Pizza Express,Eating Out,38,153
27,2,2017,South West Trains,Transport,26,127
27,2,2017,Costa Coffee,Eating Out,2,125
28,2,2017,Starbucks Coffee,Eating Out,2,123
28,2,2017,ATM Cash Withdrawal,General,20,103
1,3,2017,Rhino Sports salary,General,1700,1803
1,3,2017,Greggs,Eating Out,4,1799
2,3,2017,Wild Bean Cafe,Eating Out,1,1798
2,3,2017,Subway,Eating Out,5,1793
3,3,2017,ASDA,Groceries,46,1747
3,3,2017,Wild Bean Cafe,Eating Out,1,1746
3,3,2017,Dominos Pizza,Eating Out,32,1714
4,3,2017,Restaurant Gordon RamsayPortland Restaurant,Eating Out,55,1659
4,3,2017,Red Shop,,1,1658
6,3,2017,South West Trains,Transport,29,1629
6,3,2017,Chicken Cottage,Eating Out,7,1622
7,3,2017,Cubit and West rent,Rent,550,1072
7,3,2017,ATM Cash Withdrawal,General,10,1062
8,3,2017,Wild Bean Cafe,Eating Out,1,1061
8,3,2017,Chicken Cottage,Eating Out,6,1055
8,3,2017,Paying back Julie,,8,1047
9,3,2017,Caffe Nero,Eating Out,2,1045
9,3,2017,Subway,Eating Out,8,1037
9,3,2017,Paying back Julie,,2,1035
10,3,2017,Sainsburys,Groceries,59,976
10,3,2017,Starbucks Coffee,Eating Out,2,974
10,3,2017,Greggs,Eating Out,4,970
10,3,2017,Scott's Restaurant,Eating Out,26,944
11,3,2017,ATM Cash Withdrawal,General,20,924
13,3,2017,South West Trains,Transport,33,891
13,3,2017,Costa Coffee,Eating Out,2,889
13,3,2017,Chicken Cottage,Eating Out,4,885
14,3,2017,Wild Bean Cafe,Eating Out,2,883
14,3,2017,Greggs,Eating Out,8,875
15,3,2017,BRGAS-Electricity,Bills,29,846
15,3,2017,BRGAS-Gas,Bills,44,802
15,3,2017,Wild Bean Cafe,Eating Out,1,801
15,3,2017,ATM Cash Withdrawal,General,20,781
16,3,2017,LBS Council Tax,Bills,50,731
16,3,2017,Wild Bean Cafe,Eating Out,2,729
16,3,2017,The West Cornwall Pasty Company,Eating Out,6,723
16,3,2017,ATM Cash Withdrawal,General,20,703
17,3,2017,Waitrose,Groceries,65,638
17,3,2017,Starbucks Coffee,Eating Out,2,636
17,3,2017,Scott's Restaurant,Eating Out,30,606
18,3,2017,Restaurant Gordon RamsayPortland Restaurant,Eating Out,45,561
20,3,2017,VIRGIN MEDIA PYMTS,Bills,36,525
20,3,2017,South West Trains,Transport,32,493
20,3,2017,Starbucks Coffee,Eating Out,2,491
21,3,2017,Wild Bean Cafe,Eating Out,2,489
22,3,2017,Caffe Nero,Eating Out,1,488
22,3,2017,Red Shop,,3,485
23,3,2017,Starbucks Coffee,Eating Out,2,483
23,3,2017,Chicken Cottage,Eating Out,6,477
24,3,2017,O2,Bills,34,443
24,3,2017,Sainsburys,Groceries,60,383
24,3,2017,Starbucks Coffee,Eating Out,2,381
24,3,2017,The West Cornwall Pasty Company,Eating Out,4,377
24,3,2017,Anglo restaurant,Eating Out,39,338
24,3,2017,ATM Cash Withdrawal,General,10,328
24,3,2017,Tool Shop,,2,326
25,3,2017,Dominos Pizza,Eating Out,47,279
25,3,2017,ATM Cash Withdrawal,General,10,269
27,3,2017,South West Trains,Transport,33,236
27,3,2017,Caffe Nero,Eating Out,2,234
27,3,2017,The West Cornwall Pasty Company,Eating Out,7,227
27,3,2017,ATM Cash Withdrawal,General,10,217
28,3,2017,Caffe Nero,Eating Out,1,216
28,3,2017,McDonalds,Eating Out,7,209
31,3,2017,Morrisons,Groceries,83,126
31,3,2017,Caffe Nero,Eating Out,1,125
31,3,2017,McDonalds,Eating Out,6,119
1,4,2017,Rhino Sports salary,General,1700,1819
2,4,2017,Anglo restaurant,Eating Out,29,1790
3,4,2017,South West Trains,Transport,25,1765
3,4,2017,McDonalds,Eating Out,8,1757
4,4,2017,Wild Bean Cafe,Eating Out,2,1755
4,4,2017,Chicken Cottage,Eating Out,6,1749
5,4,2017,Caffe Nero,Eating Out,2,1747
5,4,2017,Subway,Eating Out,6,1741
5,4,2017,ATM Cash Withdrawal,General,20,1721
6,4,2017,ATM Cash Withdrawal,General,20,1701
7,4,2017,Cubit and West rent,Rent,550,1151
7,4,2017,ASDA,Groceries,56,1095
7,4,2017,Chicken Cottage,Eating Out,5,1090
8,4,2017,Restaurant Gordon RamsayPortland Restaurant,Eating Out,31,1059
10,4,2017,South West Trains,Transport,31,1028
10,4,2017,Starbucks Coffee,Eating Out,1,1027
11,4,2017,Wild Bean Cafe,Eating Out,2,1025
11,4,2017,Subway,Eating Out,4,1021
12,4,2017,Caffe Nero,Eating Out,2,1019
13,4,2017,Pret A Manger,Eating Out,6,1013
13,4,2017,ATM Cash Withdrawal,General,20,993
14,4,2017,Waitrose,Groceries,60,933
14,4,2017,Wild Bean Cafe,Eating Out,1,932
15,4,2017,BRGAS-Electricity,Bills,40,892
15,4,2017,BRGAS-Gas,Bills,43,849
15,4,2017,ATM Cash Withdrawal,General,10,839
15,4,2017,Tool Shop,,4,835
16,4,2017,LBS Council Tax,Bills,50,785
17,4,2017,South West Trains,Transport,27,758
17,4,2017,Costa Coffee,Eating Out,2,756
17,4,2017,McDonalds,Eating Out,6,750
18,4,2017,Caffe Nero,Eating Out,2,748
18,4,2017,McDonalds,Eating Out,4,744
18,4,2017,ATM Cash Withdrawal,General,20,724
18,4,2017,Paying back Julie,,6,718
19,4,2017,Starbucks Coffee,Eating Out,1,717
19,4,2017,Civic Shop,,6,711
20,4,2017,VIRGIN MEDIA PYMTS,Bills,43,668
20,4,2017,Costa Coffee,Eating Out,1,667
21,4,2017,Tescos,Groceries,74,593
21,4,2017,Starbucks Coffee,Eating Out,2,591
21,4,2017,McDonalds,Eating Out,7,584
23,4,2017,Anglo restaurant,Eating Out,47,537
24,4,2017,O2,Bills,30,507
24,4,2017,South West Trains,Transport,27,480
24,4,2017,Costa Coffee,Eating Out,2,478
26,4,2017,Wild Bean Cafe,Eating Out,1,477
26,4,2017,Greggs,Eating Out,6,471
26,4,2017,Civic Shop,,2,469
28,4,2017,Morrisons,Groceries,75,394
28,4,2017,Wild Bean Cafe,Eating Out,1,393
28,4,2017,Pizza Express,Eating Out,57,336
1,5,2017,Rhino Sports salary,General,1700,2036
1,5,2017,South West Trains,Transport,38,1998
1,5,2017,Caffe Nero,Eating Out,2,1996
1,5,2017,ATM Cash Withdrawal,General,20,1976
2,5,2017,Caffe Nero,Eating Out,2,1974
2,5,2017,ATM Cash Withdrawal,General,20,1954
3,5,2017,Caffe Nero,Eating Out,2,1952
3,5,2017,Chicken Cottage,Eating Out,6,1946
3,5,2017,ATM Cash Withdrawal,General,10,1936
4,5,2017,Caffe Nero,Eating Out,2,1934
4,5,2017,McDonalds,Eating Out,7,1927
4,5,2017,ATM Cash Withdrawal,General,10,1917
4,5,2017,Red Shop,,4,1913
5,5,2017,Waitrose,Groceries,60,1853
5,5,2017,Pret A Manger,Eating Out,4,1849
5,5,2017,Scott's Restaurant,Eating Out,32,1817
6,5,2017,Pizza Express,Eating Out,39,1778
6,5,2017,ATM Cash Withdrawal,General,10,1768
7,5,2017,Cubit and West rent,Rent,550,1218
7,5,2017,Pizza Express,Eating Out,39,1179
8,5,2017,South West Trains,Transport,35,1144
8,5,2017,Caffe Nero,Eating Out,2,1142
8,5,2017,The West Cornwall Pasty Company,Eating Out,8,1134
9,5,2017,Costa Coffee,Eating Out,1,1133
9,5,2017,Pret A Manger,Eating Out,6,1127
10,5,2017,Caffe Nero,Eating Out,2,1125
10,5,2017,McDonalds,Eating Out,5,1120
10,5,2017,ATM Cash Withdrawal,General,10,1110
12,5,2017,Morrisons,Groceries,45,1065
12,5,2017,Starbucks Coffee,Eating Out,2,1063
12,5,2017,Chicken Cottage,Eating Out,5,1058
12,5,2017,Heaven Club,Eating Out,9,1049
12,5,2017,Heaven Club,Eating Out,12,1037
12,5,2017,Heaven Club,Eating Out,15,1022
12,5,2017,Heaven Club,Eating Out,16,1006
12,5,2017,Anglo restaurant,Eating Out,29,977
12,5,2017,Tool Tec,,3,974
14,5,2017,Paying back James,,9,965
15,5,2017,BRGAS-Electricity,Bills,25,940
15,5,2017,BRGAS-Gas,Bills,24,916
15,5,2017,South West Trains,Transport,36,880
15,5,2017,Wild Bean Cafe,Eating Out,1,879
15,5,2017,The West Cornwall Pasty Company,Eating Out,8,871
15,5,2017,Tool Tec,,8,863
16,5,2017,LBS Council Tax,Bills,50,813
16,5,2017,Starbucks Coffee,Eating Out,2,811
16,5,2017,Greggs,Eating Out,8,803
17,5,2017,Caffe Nero,Eating Out,1,802
18,5,2017,Wild Bean Cafe,Eating Out,1,801
18,5,2017,Subway,Eating Out,8,793
19,5,2017,Tescos,Groceries,45,748
19,5,2017,ATM Cash Withdrawal,General,20,728
20,5,2017,VIRGIN MEDIA PYMTS,Bills,41,687
21,5,2017,Paying back James,,8,679
22,5,2017,South West Trains,Transport,28,651
22,5,2017,Caffe Nero,Eating Out,2,649
23,5,2017,Wild Bean Cafe,Eating Out,1,648
23,5,2017,ATM Cash Withdrawal,General,10,638
24,5,2017,O2,Bills,38,600
24,5,2017,Starbucks Coffee,Eating Out,2,598
24,5,2017,The West Cornwall Pasty Company,Eating Out,5,593
25,5,2017,The West Cornwall Pasty Company,Eating Out,6,587
26,5,2017,Sainsburys,Groceries,59,528
26,5,2017,Wild Bean Cafe,Eating Out,2,526
26,5,2017,McDonalds,Eating Out,6,520
26,5,2017,ATM Cash Withdrawal,General,10,510
27,5,2017,ATM Cash Withdrawal,General,20,490
29,5,2017,South West Trains,Transport,24,466
29,5,2017,Wild Bean Cafe,Eating Out,2,464
30,5,2017,ATM Cash Withdrawal,General,20,444
31,5,2017,Caffe Nero,Eating Out,1,443
1,6,2017,Rhino Sports salary,General,1700,2143
1,6,2017,Pret A Manger,Eating Out,4,2139
1,6,2017,Paying back Julie,,9,2130
2,6,2017,Sainsburys,Groceries,50,2080
2,6,2017,Starbucks Coffee,Eating Out,2,2078
2,6,2017,The West Cornwall Pasty Company,Eating Out,8,2070
2,6,2017,Dominos Pizza,Eating Out,31,2039
2,6,2017,ATM Cash Withdrawal,General,10,2029
5,6,2017,South West Trains,Transport,33,1996
5,6,2017,Caffe Nero,Eating Out,1,1995
5,6,2017,Greggs,Eating Out,5,1990
5,6,2017,ATM Cash Withdrawal,General,20,1970
6,6,2017,Starbucks Coffee,Eating Out,2,1968
7,6,2017,Cubit and West rent,Rent,550,1418
7,6,2017,Wild Bean Cafe,Eating Out,2,1416
7,6,2017,McDonalds,Eating Out,8,1408
8,6,2017,Costa Coffee,Eating Out,2,1406
8,6,2017,McDonalds,Eating Out,8,1398
8,6,2017,ATM Cash Withdrawal,General,10,1388
9,6,2017,ASDA,Groceries,42,1346
9,6,2017,The West Cornwall Pasty Company,Eating Out,7,1339
9,6,2017,Ministry of Sound ClubXOYO Club,Eating Out,13,1326
9,6,2017,Ministry of Sound ClubXOYO Club,Eating Out,9,1317
9,6,2017,Pizza Express,Eating Out,43,1274
10,6,2017,Paying back Julie,,8,1266
11,6,2017,ATM Cash Withdrawal,General,20,1246
12,6,2017,South West Trains,Transport,27,1219
12,6,2017,Costa Coffee,Eating Out,2,1217
12,6,2017,The West Cornwall Pasty Company,Eating Out,6,1211
12,6,2017,ATM Cash Withdrawal,General,20,1191
13,6,2017,Starbucks Coffee,Eating Out,1,1190
13,6,2017,McDonalds,Eating Out,7,1183
13,6,2017,ATM Cash Withdrawal,General,10,1173
14,6,2017,Costa Coffee,Eating Out,1,1172
14,6,2017,Greggs,Eating Out,8,1164
14,6,2017,ATM Cash Withdrawal,General,20,1144
15,6,2017,BRGAS-Electricity,Bills,22,1122
15,6,2017,BRGAS-Gas,Bills,30,1092
15,6,2017,Caffe Nero,Eating Out,2,1090
15,6,2017,Chicken Cottage,Eating Out,5,1085
16,6,2017,LBS Council Tax,Bills,50,1035
16,6,2017,Tescos,Groceries,70,965
16,6,2017,Chicken Cottage,Eating Out,6,959
17,6,2017,The Grand Pub,Eating Out,16,943
17,6,2017,ATM Cash Withdrawal,General,20,923
17,6,2017,Civic Shop,,1,922
18,6,2017,Anglo restaurant,Eating Out,54,868
18,6,2017,ATM Cash Withdrawal,General,10,858
19,6,2017,South West Trains,Transport,27,831
19,6,2017,Starbucks Coffee,Eating Out,2,829
19,6,2017,Chicken Cottage,Eating Out,6,823
20,6,2017,VIRGIN MEDIA PYMTS,Bills,43,780
20,6,2017,Wild Bean Cafe,Eating Out,1,779
21,6,2017,Caffe Nero,Eating Out,1,778
21,6,2017,Subway,Eating Out,5,773
21,6,2017,ATM Cash Withdrawal,General,10,763
22,6,2017,Wild Bean Cafe,Eating Out,1,762
22,6,2017,McDonalds,Eating Out,5,757
22,6,2017,ATM Cash Withdrawal,General,10,747
23,6,2017,Waitrose,Groceries,76,671
23,6,2017,Costa Coffee,Eating Out,2,669
23,6,2017,Chicken Cottage,Eating Out,7,662
23,6,2017,Anglo restaurant,Eating Out,58,604
23,6,2017,ATM Cash Withdrawal,General,10,594
24,6,2017,O2,Bills,37,557
25,6,2017,Scott's Restaurant,Eating Out,37,520
26,6,2017,South West Trains,Transport,33,487
26,6,2017,Subway,Eating Out,4,483
27,6,2017,Wild Bean Cafe,Eating Out,2,481
27,6,2017,Tool Tec,,1,480
28,6,2017,Wild Bean Cafe,Eating Out,1,479
29,6,2017,Caffe Nero,Eating Out,2,477
29,6,2017,Subway,Eating Out,7,470
30,6,2017,Waitrose,Groceries,60,410
30,6,2017,Greggs,Eating Out,8,402
30,6,2017,Scott's Restaurant,Eating Out,37,365
1,7,2017,Rhino Sports salary,General,1700,2065
1,7,2017,Scott's Restaurant,Eating Out,50,2015
1,7,2017,ATM Cash Withdrawal,General,10,2005
3,7,2017,South West Trains,Transport,26,1979
3,7,2017,Costa Coffee,Eating Out,2,1977
3,7,2017,The West Cornwall Pasty Company,Eating Out,8,1969
3,7,2017,ATM Cash Withdrawal,General,10,1959
4,7,2017,Wild Bean Cafe,Eating Out,2,1957
4,7,2017,Tool Shop,,5,1952
5,7,2017,Wild Bean Cafe,Eating Out,1,1951
6,7,2017,Starbucks Coffee,Eating Out,2,1949
6,7,2017,ATM Cash Withdrawal,General,10,1939
7,7,2017,Cubit and West rent,Rent,550,1389
7,7,2017,Morrisons,Groceries,50,1339
7,7,2017,Starbucks Coffee,Eating Out,1,1338
7,7,2017,Paying back James,,3,1335
9,7,2017,Restaurant Gordon RamsayPortland Restaurant,Eating Out,58,1277
9,7,2017,ATM Cash Withdrawal,General,10,1267
10,7,2017,South West Trains,Transport,30,1237
10,7,2017,Starbucks Coffee,Eating Out,2,1235
11,7,2017,Caffe Nero,Eating Out,2,1233
12,7,2017,Starbucks Coffee,Eating Out,1,1232
12,7,2017,McDonalds,Eating Out,8,1224
13,7,2017,Chicken Cottage,Eating Out,7,1217
14,7,2017,ASDA,Groceries,87,1130
14,7,2017,Costa Coffee,Eating Out,2,1128
14,7,2017,McDonalds,Eating Out,6,1122
14,7,2017,Anglo restaurant,Eating Out,55,1067
15,7,2017,BRGAS-Electricity,Bills,23,1044
15,7,2017,BRGAS-Gas,Bills,42,1002
15,7,2017,Scott's Restaurant,Eating Out,26,976
16,7,2017,LBS Council Tax,Bills,50,926
17,7,2017,South West Trains,Transport,31,895
17,7,2017,Greggs,Eating Out,4,891
18,7,2017,Wild Bean Cafe,Eating Out,2,889
18,7,2017,The West Cornwall Pasty Company,Eating Out,4,885
19,7,2017,Wild Bean Cafe,Eating Out,2,883
20,7,2017,VIRGIN MEDIA PYMTS,Bills,47,836
20,7,2017,Starbucks Coffee,Eating Out,2,834
20,7,2017,The West Cornwall Pasty Company,Eating Out,6,828
21,7,2017,Tescos,Groceries,52,776
21,7,2017,Wild Bean Cafe,Eating Out,2,774
21,7,2017,Subway,Eating Out,8,766
21,7,2017,The Grand Pub,Eating Out,6,760
21,7,2017,The Grand Pub,Eating Out,12,748
21,7,2017,The Grand Pub,Eating Out,5,743
21,7,2017,The Grand Pub,Eating Out,5,738
21,7,2017,The Grand Pub,Eating Out,7,731
21,7,2017,The Grand Pub,Eating Out,13,718
21,7,2017,Restaurant Gordon RamsayPortland Restaurant,Eating Out,27,691
24,7,2017,O2,Bills,34,657
24,7,2017,South West Trains,Transport,25,632
24,7,2017,Starbucks Coffee,Eating Out,1,631
24,7,2017,Paying back James,,3,628
25,7,2017,The West Cornwall Pasty Company,Eating Out,5,623
26,7,2017,Caffe Nero,Eating Out,1,622
26,7,2017,Chicken Cottage,Eating Out,7,615
28,7,2017,ASDA,Groceries,78,537
28,7,2017,Wild Bean Cafe,Eating Out,2,535
28,7,2017,Pret A Manger,Eating Out,8,527
31,7,2017,South West Trains,Transport,34,493
31,7,2017,Wild Bean Cafe,Eating Out,1,492
31,7,2017,The West Cornwall Pasty Company,Eating Out,8,484
1,8,2017,Rhino Sports salary,General,1700,2184
1,8,2017,Wild Bean Cafe,Eating Out,2,2182
2,8,2017,Starbucks Coffee,Eating Out,2,2180
2,8,2017,ATM Cash Withdrawal,General,20,2160
3,8,2017,Wild Bean Cafe,Eating Out,2,2158
4,8,2017,Tescos,Groceries,83,2075
4,8,2017,Starbucks Coffee,Eating Out,2,2073
4,8,2017,Greggs,Eating Out,6,2067
5,8,2017,Heaven Club,Eating Out,8,2059
5,8,2017,Heaven Club,Eating Out,5,2054
5,8,2017,Heaven Club,Eating Out,12,2042
5,8,2017,Heaven Club,Eating Out,13,2029
5,8,2017,Heaven Club,Eating Out,14,2015
6,8,2017,ATM Cash Withdrawal,General,20,1995
7,8,2017,Cubit and West rent,Rent,550,1445
7,8,2017,South West Trains,Transport,34,1411
7,8,2017,Greggs,Eating Out,5,1406
7,8,2017,ATM Cash Withdrawal,General,10,1396
8,8,2017,Caffe Nero,Eating Out,2,1394
8,8,2017,Subway,Eating Out,7,1387
8,8,2017,ATM Cash Withdrawal,General,20,1367
9,8,2017,Caffe Nero,Eating Out,2,1365
9,8,2017,Pret A Manger,Eating Out,8,1357
10,8,2017,Wild Bean Cafe,Eating Out,1,1356
10,8,2017,ATM Cash Withdrawal,General,10,1346
11,8,2017,Waitrose,Groceries,78,1268
11,8,2017,Wild Bean Cafe,Eating Out,2,1266
11,8,2017,Chicken Cottage,Eating Out,7,1259
11,8,2017,Ministry of Sound ClubXOYO Club,Eating Out,10,1249
11,8,2017,Ministry of Sound ClubXOYO Club,Eating Out,6,1243
11,8,2017,Ministry of Sound ClubXOYO Club,Eating Out,11,1232
12,8,2017,Scott's Restaurant,Eating Out,43,1189
13,8,2017,ATM Cash Withdrawal,General,10,1179
13,8,2017,Paying back Julie,,4,1175
14,8,2017,South West Trains,Transport,37,1138
14,8,2017,Costa Coffee,Eating Out,2,1136
14,8,2017,Greggs,Eating Out,4,1132
14,8,2017,ATM Cash Withdrawal,General,20,1112
15,8,2017,BRGAS-Electricity,Bills,22,1090
15,8,2017,BRGAS-Gas,Bills,33,1057
15,8,2017,Costa Coffee,Eating Out,2,1055
15,8,2017,Subway,Eating Out,7,1048
15,8,2017,ATM Cash Withdrawal,General,10,1038
16,8,2017,LBS Council Tax,Bills,50,988
16,8,2017,Wild Bean Cafe,Eating Out,2,986
16,8,2017,Tool Shop,,4,982
17,8,2017,Starbucks Coffee,Eating Out,2,980
17,8,2017,Subway,Eating Out,8,972
17,8,2017,Cheam Service Station,,2,970
18,8,2017,Waitrose,Groceries,72,898
18,8,2017,Costa Coffee,Eating Out,1,897
18,8,2017,Pret A Manger,Eating Out,5,892
19,8,2017,Scott's Restaurant,Eating Out,50,842
20,8,2017,VIRGIN MEDIA PYMTS,Bills,38,804
20,8,2017,Anglo restaurant,Eating Out,54,750
21,8,2017,South West Trains,Transport,30,720
21,8,2017,Caffe Nero,Eating Out,1,719
21,8,2017,Greggs,Eating Out,4,715
22,8,2017,Subway,Eating Out,5,710
22,8,2017,ATM Cash Withdrawal,General,10,700
22,8,2017,Red Shop,,2,698
23,8,2017,Costa Coffee,Eating Out,2,696
24,8,2017,O2,Bills,37,659
24,8,2017,Subway,Eating Out,5,654
25,8,2017,Waitrose,Groceries,61,593
25,8,2017,Pret A Manger,Eating Out,4,589
25,8,2017,The Grand Pub,Eating Out,15,574
25,8,2017,The Grand Pub,Eating Out,16,558
25,8,2017,The Grand Pub,Eating Out,10,548
25,8,2017,The Grand Pub,Eating Out,12,536
25,8,2017,ATM Cash Withdrawal,General,10,526
26,8,2017,Anglo restaurant,Eating Out,37,489
27,8,2017,Anglo restaurant,Eating Out,49,440
27,8,2017,ATM Cash Withdrawal,General,20,420
28,8,2017,South West Trains,Transport,26,394
28,8,2017,Costa Coffee,Eating Out,2,392
29,8,2017,Chicken Cottage,Eating Out,6,386
30,8,2017,ATM Cash Withdrawal,General,20,366
31,8,2017,McDonalds,Eating Out,7,359
1,9,2017,Rhino Sports salary,General,1700,2059
1,9,2017,Tescos,Groceries,70,1989
1,9,2017,Greggs,Eating Out,5,1984
2,9,2017,Scott's Restaurant,Eating Out,59,1925
3,9,2017,ATM Cash Withdrawal,General,20,1905
4,9,2017,South West Trains,Transport,38,1867
4,9,2017,Starbucks Coffee,Eating Out,2,1865
4,9,2017,Subway,Eating Out,6,1859
5,9,2017,ATM Cash Withdrawal,General,20,1839
6,9,2017,Starbucks Coffee,Eating Out,2,1837
6,9,2017,Subway,Eating Out,8,1829
6,9,2017,ATM Cash Withdrawal,General,20,1809
7,9,2017,Cubit and West rent,Rent,550,1259
7,9,2017,Wild Bean Cafe,Eating Out,2,1257
7,9,2017,ATM Cash Withdrawal,General,10,1247
8,9,2017,Morrisons,Groceries,81,1166
8,9,2017,Caffe Nero,Eating Out,2,1164
8,9,2017,ATM Cash Withdrawal,General,10,1154
9,9,2017,The Grand Pub,Eating Out,13,1141
9,9,2017,The Grand Pub,Eating Out,16,1125
9,9,2017,The Grand Pub,Eating Out,10,1115
9,9,2017,The Grand Pub,Eating Out,6,1109
9,9,2017,The Grand Pub,Eating Out,9,1100
9,9,2017,ATM Cash Withdrawal,General,20,1080
9,9,2017,Civic Shop,,6,1074
10,9,2017,Restaurant Gordon RamsayPortland Restaurant,Eating Out,29,1045
11,9,2017,South West Trains,Transport,28,1017
11,9,2017,Subway,Eating Out,7,1010
12,9,2017,Caffe Nero,Eating Out,2,1008
12,9,2017,Greggs,Eating Out,7,1001
12,9,2017,ATM Cash Withdrawal,General,20,981
13,9,2017,Costa Coffee,Eating Out,2,979
14,9,2017,Wild Bean Cafe,Eating Out,1,978
14,9,2017,Subway,Eating Out,6,972
14,9,2017,ATM Cash Withdrawal,General,20,952
15,9,2017,BRGAS-Electricity,Bills,33,919
15,9,2017,BRGAS-Gas,Bills,29,890
15,9,2017,ASDA,Groceries,83,807
15,9,2017,Costa Coffee,Eating Out,2,805
15,9,2017,Chicken Cottage,Eating Out,5,800
15,9,2017,Restaurant Gordon RamsayPortland Restaurant,Eating Out,48,752
16,9,2017,LBS Council Tax,Bills,50,702
16,9,2017,Paying back James,,7,695
17,9,2017,Tool Tec,,4,691
18,9,2017,South West Trains,Transport,30,661
18,9,2017,Costa Coffee,Eating Out,2,659
18,9,2017,Tool Shop,,7,652
19,9,2017,Greggs,Eating Out,5,647
20,9,2017,VIRGIN MEDIA PYMTS,Bills,46,601
20,9,2017,Pret A Manger,Eating Out,6,595
20,9,2017,ATM Cash Withdrawal,General,10,585
20,9,2017,Cheam Service Station,,1,584
21,9,2017,Subway,Eating Out,4,580
22,9,2017,ASDA,Groceries,49,531
22,9,2017,The West Cornwall Pasty Company,Eating Out,7,524
22,9,2017,Anglo restaurant,Eating Out,24,500
22,9,2017,ATM Cash Withdrawal,General,20,480
23,9,2017,Ministry of Sound ClubXOYO Club,Eating Out,9,471
23,9,2017,Ministry of Sound ClubXOYO Club,Eating Out,15,456
23,9,2017,Ministry of Sound ClubXOYO Club,Eating Out,8,448
24,9,2017,O2,Bills,30,418
24,9,2017,Dominos Pizza,Eating Out,56,362
25,9,2017,South West Trains,Transport,30,332
25,9,2017,Costa Coffee,Eating Out,2,330
27,9,2017,Wild Bean Cafe,Eating Out,1,329
27,9,2017,McDonalds,Eating Out,4,325
27,9,2017,ATM Cash Withdrawal,General,10,315
28,9,2017,Starbucks Coffee,Eating Out,2,313
28,9,2017,Pret A Manger,Eating Out,4,309
28,9,2017,ATM Cash Withdrawal,General,20,289
29,9,2017,Tescos,Groceries,76,213
29,9,2017,Starbucks Coffee,Eating Out,2,211
29,9,2017,Pret A Manger,Eating Out,6,205
29,9,2017,Fabric Club,Eating Out,7,198
30,9,2017,Ministry of Sound ClubXOYO Club,Eating Out,6,192
1,10,2017,Rhino Sports salary,General,1700,1892
1,10,2017,Anglo restaurant,Eating Out,49,1843
2,10,2017,South West Trains,Transport,29,1814
2,10,2017,McDonalds,Eating Out,6,1808
3,10,2017,Wild Bean Cafe,Eating Out,1,1807
3,10,2017,ATM Cash Withdrawal,General,20,1787
3,10,2017,Tool Shop,,4,1783
4,10,2017,Wild Bean Cafe,Eating Out,2,1781
4,10,2017,Tool Shop,,6,1775
5,10,2017,Wild Bean Cafe,Eating Out,2,1773
6,10,2017,Waitrose,Groceries,64,1709
6,10,2017,Costa Coffee,Eating Out,2,1707
6,10,2017,ATM Cash Withdrawal,General,20,1687
7,10,2017,Cubit and West rent,Rent,550,1137
7,10,2017,Pizza Express,Eating Out,24,1113
7,10,2017,Paying back Julie,,4,1109
8,10,2017,ATM Cash Withdrawal,General,20,1089
9,10,2017,South West Trains,Transport,32,1057
9,10,2017,Costa Coffee,Eating Out,2,1055
10,10,2017,Caffe Nero,Eating Out,1,1054
10,10,2017,Greggs,Eating Out,5,1049
10,10,2017,ATM Cash Withdrawal,General,20,1029
11,10,2017,Wild Bean Cafe,Eating Out,2,1027
12,10,2017,Starbucks Coffee,Eating Out,1,1026
13,10,2017,Morrisons,Groceries,58,968
13,10,2017,Caffe Nero,Eating Out,2,966
13,10,2017,McDonalds,Eating Out,5,961
14,10,2017,Anglo restaurant,Eating Out,44,917
15,10,2017,BRGAS-Electricity,Bills,27,890
15,10,2017,BRGAS-Gas,Bills,41,849
15,10,2017,Anglo restaurant,Eating Out,45,804
16,10,2017,LBS Council Tax,Bills,50,754
16,10,2017,South West Trains,Transport,36,718
16,10,2017,Costa Coffee,Eating Out,1,717
16,10,2017,McDonalds,Eating Out,8,709
16,10,2017,Cheam Service Station,,8,701
17,10,2017,Wild Bean Cafe,Eating Out,2,699
17,10,2017,The West Cornwall Pasty Company,Eating Out,5,694
18,10,2017,Costa Coffee,Eating Out,1,693
19,10,2017,Wild Bean Cafe,Eating Out,1,692
20,10,2017,VIRGIN MEDIA PYMTS,Bills,37,655
20,10,2017,Morrisons,Groceries,74,581
20,10,2017,Costa Coffee,Eating Out,2,579
20,10,2017,The West Cornwall Pasty Company,Eating Out,8,571
20,10,2017,Anglo restaurant,Eating Out,24,547
20,10,2017,ATM Cash Withdrawal,General,10,537
21,10,2017,Red Shop,,7,530
23,10,2017,South West Trains,Transport,24,506
23,10,2017,Caffe Nero,Eating Out,1,505
23,10,2017,Subway,Eating Out,8,497
24,10,2017,O2,Bills,36,461
24,10,2017,Caffe Nero,Eating Out,2,459
24,10,2017,Chicken Cottage,Eating Out,8,451
24,10,2017,Red Shop,,6,445
25,10,2017,Greggs,Eating Out,4,441
26,10,2017,Caffe Nero,Eating Out,2,439
26,10,2017,Pret A Manger,Eating Out,6,433
27,10,2017,ASDA,Groceries,78,355
27,10,2017,Starbucks Coffee,Eating Out,2,353
28,10,2017,ATM Cash Withdrawal,General,10,343
29,10,2017,Anglo restaurant,Eating Out,24,319
30,10,2017,South West Trains,Transport,28,291
30,10,2017,Caffe Nero,Eating Out,2,289
30,10,2017,The West Cornwall Pasty Company,Eating Out,4,285
30,10,2017,ATM Cash Withdrawal,General,20,265
30,10,2017,Cheam Service Station,,6,259
31,10,2017,Caffe Nero,Eating Out,1,258
1,11,2017,Rhino Sports salary,General,1700,1958
1,11,2017,Starbucks Coffee,Eating Out,2,1956
1,11,2017,Chicken Cottage,Eating Out,8,1948
1,11,2017,ATM Cash Withdrawal,General,10,1938
3,11,2017,Morrisons,Groceries,59,1879
3,11,2017,Caffe Nero,Eating Out,1,1878
3,11,2017,The West Cornwall Pasty Company,Eating Out,4,1874
4,11,2017,ATM Cash Withdrawal,General,10,1864
6,11,2017,South West Trains,Transport,34,1830
6,11,2017,Subway,Eating Out,7,1823
7,11,2017,Cubit and West rent,Rent,550,1273
7,11,2017,Pret A Manger,Eating Out,7,1266
8,11,2017,Caffe Nero,Eating Out,1,1265
8,11,2017,Greggs,Eating Out,8,1257
8,11,2017,ATM Cash Withdrawal,General,10,1247
8,11,2017,Paying back James,,8,1239
9,11,2017,Caffe Nero,Eating Out,1,1238
10,11,2017,ASDA,Groceries,69,1169
10,11,2017,Costa Coffee,Eating Out,2,1167
10,11,2017,Greggs,Eating Out,7,1160
10,11,2017,Tool Shop,,3,1157
11,11,2017,Restaurant Gordon RamsayPortland Restaurant,Eating Out,28,1129
13,11,2017,South West Trains,Transport,33,1096
13,11,2017,Wild Bean Cafe,Eating Out,2,1094
13,11,2017,Chicken Cottage,Eating Out,6,1088
14,11,2017,Wild Bean Cafe,Eating Out,1,1087
14,11,2017,Subway,Eating Out,8,1079
15,11,2017,BRGAS-Electricity,Bills,38,1041
15,11,2017,BRGAS-Gas,Bills,43,998
15,11,2017,Pret A Manger,Eating Out,7,991
16,11,2017,LBS Council Tax,Bills,50,941
16,11,2017,Wild Bean Cafe,Eating Out,1,940
16,11,2017,Pret A Manger,Eating Out,6,934
17,11,2017,Tescos,Groceries,71,863
17,11,2017,Wild Bean Cafe,Eating Out,1,862
17,11,2017,Chicken Cottage,Eating Out,6,856
17,11,2017,Dominos Pizza,Eating Out,32,824
18,11,2017,Ministry of Sound ClubXOYO Club,Eating Out,11,813
18,11,2017,Ministry of Sound ClubXOYO Club,Eating Out,12,801
18,11,2017,Ministry of Sound ClubXOYO Club,Eating Out,13,788
18,11,2017,Ministry of Sound ClubXOYO Club,Eating Out,9,779
18,11,2017,Ministry of Sound ClubXOYO Club,Eating Out,12,767
18,11,2017,Cheam Service Station,,8,759
20,11,2017,VIRGIN MEDIA PYMTS,Bills,29,730
20,11,2017,South West Trains,Transport,35,695
20,11,2017,Costa Coffee,Eating Out,2,693
21,11,2017,Subway,Eating Out,8,685
22,11,2017,Starbucks Coffee,Eating Out,2,683
22,11,2017,McDonalds,Eating Out,7,676
22,11,2017,ATM Cash Withdrawal,General,10,666
23,11,2017,The West Cornwall Pasty Company,Eating Out,8,658
24,11,2017,O2,Bills,35,623
24,11,2017,Sainsburys,Groceries,61,562
24,11,2017,Starbucks Coffee,Eating Out,1,561
24,11,2017,ATM Cash Withdrawal,General,10,551
25,11,2017,Scott's Restaurant,Eating Out,51,500
25,11,2017,ATM Cash Withdrawal,General,10,490
26,11,2017,Dominos Pizza,Eating Out,58,432
26,11,2017,ATM Cash Withdrawal,General,20,412
27,11,2017,South West Trains,Transport,34,378
27,11,2017,Costa Coffee,Eating Out,1,377
27,11,2017,Greggs,Eating Out,7,370
28,11,2017,Costa Coffee,Eating Out,1,369
28,11,2017,Chicken Cottage,Eating Out,6,363
28,11,2017,ATM Cash Withdrawal,General,10,353
28,11,2017,Cheam Service Station,,2,351
29,11,2017,Starbucks Coffee,Eating Out,2,349
29,11,2017,McDonalds,Eating Out,8,341
30,11,2017,Wild Bean Cafe,Eating Out,1,340
30,11,2017,The West Cornwall Pasty Company,Eating Out,6,334
30,11,2017,Red Shop,,9,325
1,12,2017,Rhino Sports salary,General,1700,2025
1,12,2017,Waitrose,Groceries,63,1962
1,12,2017,Costa Coffee,Eating Out,2,1960
1,12,2017,Pret A Manger,Eating Out,8,1952
1,12,2017,Ministry of Sound ClubXOYO Club,Eating Out,7,1945
1,12,2017,Scott's Restaurant,Eating Out,36,1909
2,12,2017,Heaven Club,Eating Out,13,1896
2,12,2017,Heaven Club,Eating Out,11,1885
2,12,2017,Heaven Club,Eating Out,8,1877
2,12,2017,Heaven Club,Eating Out,6,1871
2,12,2017,Anglo restaurant,Eating Out,49,1822
3,12,2017,Cheam Service Station,,5,1817
4,12,2017,South West Trains,Transport,27,1790
4,12,2017,Caffe Nero,Eating Out,2,1788
4,12,2017,Pret A Manger,Eating Out,7,1781
5,12,2017,Wild Bean Cafe,Eating Out,2,1779
5,12,2017,The West Cornwall Pasty Company,Eating Out,6,1773
5,12,2017,ATM Cash Withdrawal,General,10,1763
6,12,2017,Starbucks Coffee,Eating Out,2,1761
6,12,2017,The West Cornwall Pasty Company,Eating Out,5,1756
7,12,2017,Cubit and West rent,Rent,550,1206
7,12,2017,Caffe Nero,Eating Out,2,1204
7,12,2017,McDonalds,Eating Out,6,1198
7,12,2017,ATM Cash Withdrawal,General,20,1178
7,12,2017,Tool Tec,,9,1169
8,12,2017,Morrisons,Groceries,54,1115
8,12,2017,Chicken Cottage,Eating Out,8,1107
8,12,2017,Anglo restaurant,Eating Out,48,1059
9,12,2017,The Grand Pub,Eating Out,15,1044
9,12,2017,The Grand Pub,Eating Out,13,1031
9,12,2017,The Grand Pub,Eating Out,8,1023
9,12,2017,The Grand Pub,Eating Out,14,1009
9,12,2017,The Grand Pub,Eating Out,5,1004
9,12,2017,ATM Cash Withdrawal,General,10,994
11,12,2017,South West Trains,Transport,26,968
11,12,2017,Caffe Nero,Eating Out,2,966
12,12,2017,Starbucks Coffee,Eating Out,2,964
12,12,2017,Subway,Eating Out,4,960
13,12,2017,ATM Cash Withdrawal,General,10,950
13,12,2017,Paying back James,,7,943
14,12,2017,McDonalds,Eating Out,7,936
14,12,2017,ATM Cash Withdrawal,General,20,916
15,12,2017,BRGAS-Electricity,Bills,39,877
15,12,2017,BRGAS-Gas,Bills,42,835
15,12,2017,Tescos,Groceries,60,775
15,12,2017,The West Cornwall Pasty Company,Eating Out,7,768
15,12,2017,Pizza Express,Eating Out,30,738
16,12,2017,LBS Council Tax,Bills,50,688
16,12,2017,Civic Shop,,2,686
17,12,2017,Pizza Express,Eating Out,47,639
18,12,2017,South West Trains,Transport,36,603
18,12,2017,Costa Coffee,Eating Out,1,602
18,12,2017,ATM Cash Withdrawal,General,10,592
18,12,2017,Tool Shop,,5,587
19,12,2017,The West Cornwall Pasty Company,Eating Out,6,581
20,12,2017,VIRGIN MEDIA PYMTS,Bills,51,530
20,12,2017,Subway,Eating Out,8,522
21,12,2017,Wild Bean Cafe,Eating Out,2,520
21,12,2017,Chicken Cottage,Eating Out,5,515
21,12,2017,ATM Cash Withdrawal,General,20,495
22,12,2017,Sainsburys,Groceries,76,419
22,12,2017,McDonalds,Eating Out,7,412
24,12,2017,O2,Bills,30,382
24,12,2017,Scott's Restaurant,Eating Out,44,338
25,12,2017,South West Trains,Transport,36,302
25,12,2017,Wild Bean Cafe,Eating Out,1,301
26,12,2017,Wild Bean Cafe,Eating Out,2,299
26,12,2017,Subway,Eating Out,5,294
27,12,2017,Costa Coffee,Eating Out,1,293
28,12,2017,Starbucks Coffee,Eating Out,2,291
28,12,2017,Chicken Cottage,Eating Out,6,285
28,12,2017,ATM Cash Withdrawal,General,10,275
29,12,2017,Waitrose,Groceries,60,215
29,12,2017,The West Cornwall Pasty Company,Eating Out,6,209
30,12,2017,Anglo restaurant,Eating Out,46,163
1,1,2018,Rhino Sports salary,General,1700,1863
1,1,2018,South West Trains,Transport,34,1829
1,1,2018,Wild Bean Cafe,Eating Out,2,1827
1,1,2018,ATM Cash Withdrawal,General,20,1807
2,1,2018,Costa Coffee,Eating Out,2,1805
2,1,2018,McDonalds,Eating Out,8,1797
2,1,2018,ATM Cash Withdrawal,General,10,1787
2,1,2018,Paying back James,,4,1783
3,1,2018,Caffe Nero,Eating Out,1,1782
3,1,2018,Civic Shop,,7,1775
4,1,2018,Wild Bean Cafe,Eating Out,1,1774
4,1,2018,ATM Cash Withdrawal,General,20,1754
5,1,2018,Sainsburys,Groceries,60,1694
5,1,2018,Caffe Nero,Eating Out,2,1692
5,1,2018,The West Cornwall Pasty Company,Eating Out,5,1687
5,1,2018,ATM Cash Withdrawal,General,10,1677
6,1,2018,ATM Cash Withdrawal,General,10,1667
7,1,2018,Cubit and West rent,Rent,550,1117
7,1,2018,ATM Cash Withdrawal,General,10,1107
7,1,2018,Paying back Julie,,2,1105
8,1,2018,South West Trains,Transport,37,1068
8,1,2018,Caffe Nero,Eating Out,1,1067
8,1,2018,McDonalds,Eating Out,7,1060
9,1,2018,Costa Coffee,Eating Out,2,1058
9,1,2018,McDonalds,Eating Out,7,1051
9,1,2018,ATM Cash Withdrawal,General,10,1041
10,1,2018,Caffe Nero,Eating Out,1,1040
11,1,2018,Caffe Nero,Eating Out,1,1039
11,1,2018,ATM Cash Withdrawal,General,10,1029
12,1,2018,Tescos,Groceries,59,970
12,1,2018,Caffe Nero,Eating Out,1,969
12,1,2018,Pret A Manger,Eating Out,8,961
12,1,2018,The Grand Pub,Eating Out,5,956
12,1,2018,The Grand Pub,Eating Out,14,942
12,1,2018,Dominos Pizza,Eating Out,50,892
13,1,2018,Restaurant Gordon RamsayPortland Restaurant,Eating Out,25,867
15,1,2018,BRGAS-Electricity,Bills,36,831
15,1,2018,BRGAS-Gas,Bills,67,764
15,1,2018,South West Trains,Transport,26,738
15,1,2018,Costa Coffee,Eating Out,1,737
15,1,2018,Pret A Manger,Eating Out,8,729
15,1,2018,ATM Cash Withdrawal,General,20,709
16,1,2018,LBS Council Tax,Bills,50,659
16,1,2018,Caffe Nero,Eating Out,2,657
17,1,2018,Caffe Nero,Eating Out,1,656
17,1,2018,The West Cornwall Pasty Company,Eating Out,5,651
17,1,2018,Paying back Julie,,8,643
18,1,2018,Starbucks Coffee,Eating Out,1,642
18,1,2018,Chicken Cottage,Eating Out,5,637
19,1,2018,ASDA,Groceries,65,572
19,1,2018,Costa Coffee,Eating Out,1,571
19,1,2018,McDonalds,Eating Out,8,563
19,1,2018,Dominos Pizza,Eating Out,26,537
20,1,2018,VIRGIN MEDIA PYMTS,Bills,43,494
20,1,2018,Heaven Club,Eating Out,5,489
21,1,2018,Restaurant Gordon RamsayPortland Restaurant,Eating Out,49,440
21,1,2018,ATM Cash Withdrawal,General,20,420
22,1,2018,South West Trains,Transport,35,385
22,1,2018,Costa Coffee,Eating Out,2,383
23,1,2018,Starbucks Coffee,Eating Out,2,381
23,1,2018,Chicken Cottage,Eating Out,7,374
24,1,2018,O2,Bills,34,340
24,1,2018,Wild Bean Cafe,Eating Out,2,338
24,1,2018,Greggs,Eating Out,5,333
25,1,2018,The West Cornwall Pasty Company,Eating Out,4,329
25,1,2018,ATM Cash Withdrawal,General,10,319
26,1,2018,Morrisons,Groceries,56,263
26,1,2018,Pret A Manger,Eating Out,7,256
26,1,2018,Fabric Club,Eating Out,16,240
26,1,2018,Dominos Pizza,Eating Out,32,208
26,1,2018,Cheam Service Station,,7,201
27,1,2018,The Grand Pub,Eating Out,6,195
27,1,2018,Restaurant Gordon RamsayPortland Restaurant,Eating Out,51,144
28,1,2018,Scott's Restaurant,Eating Out,58,86
29,1,2018,South West Trains,Transport,34,52
29,1,2018,Starbucks Coffee,Eating Out,2,50
29,1,2018,Chicken Cottage,Eating Out,7,43
30,1,2018,Wild Bean Cafe,Eating Out,2,41
31,1,2018,Starbucks Coffee,Eating Out,2,39
31,1,2018,Subway,Eating Out,5,34
31,1,2018,Tool Shop,,6,28
1,2,2018,Rhino Sports salary,General,1700,1728
1,2,2018,Starbucks Coffee,Eating Out,2,1726
1,2,2018,ATM Cash Withdrawal,General,10,1716
2,2,2018,ASDA,Groceries,80,1636
2,2,2018,Starbucks Coffee,Eating Out,1,1635
2,2,2018,Pret A Manger,Eating Out,4,1631
2,2,2018,Pizza Express,Eating Out,26,1605
3,2,2018,Dominos Pizza,Eating Out,44,1561
3,2,2018,ATM Cash Withdrawal,General,20,1541
4,2,2018,ATM Cash Withdrawal,General,20,1521
5,2,2018,South West Trains,Transport,30,1491
5,2,2018,Caffe Nero,Eating Out,2,1489
5,2,2018,McDonalds,Eating Out,5,1484
6,2,2018,Starbucks Coffee,Eating Out,2,1482
6,2,2018,Greggs,Eating Out,7,1475
7,2,2018,Cubit and West rent,Rent,550,925
7,2,2018,Costa Coffee,Eating Out,2,923
8,2,2018,Starbucks Coffee,Eating Out,2,921
8,2,2018,Subway,Eating Out,5,916
9,2,2018,ASDA,Groceries,57,859
9,2,2018,Costa Coffee,Eating Out,1,858
9,2,2018,Dominos Pizza,Eating Out,40,818
10,2,2018,Pizza Express,Eating Out,35,783
12,2,2018,South West Trains,Transport,38,745
12,2,2018,McDonalds,Eating Out,7,738
12,2,2018,Tool Shop,,8,730
13,2,2018,Wild Bean Cafe,Eating Out,1,729
14,2,2018,Wild Bean Cafe,Eating Out,2,727
14,2,2018,Chicken Cottage,Eating Out,4,723
14,2,2018,Paying back Julie,,1,722
15,2,2018,BRGAS-Electricity,Bills,30,692
15,2,2018,BRGAS-Gas,Bills,36,656
15,2,2018,Costa Coffee,Eating Out,2,654
16,2,2018,LBS Council Tax,Bills,50,604
16,2,2018,Morrisons,Groceries,54,550
16,2,2018,Costa Coffee,Eating Out,1,549
16,2,2018,Chicken Cottage,Eating Out,5,544
16,2,2018,Paying back Julie,,9,535
17,2,2018,ATM Cash Withdrawal,General,20,515
18,2,2018,Pizza Express,Eating Out,45,470
18,2,2018,ATM Cash Withdrawal,General,20,450
19,2,2018,South West Trains,Transport,28,422
20,2,2018,VIRGIN MEDIA PYMTS,Bills,32,390
20,2,2018,Pret A Manger,Eating Out,6,384
20,2,2018,Red Shop,,6,378
21,2,2018,Caffe Nero,Eating Out,2,376
21,2,2018,Pret A Manger,Eating Out,5,371
22,2,2018,Starbucks Coffee,Eating Out,1,370
22,2,2018,Chicken Cottage,Eating Out,6,364
23,2,2018,Morrisons,Groceries,86,278
23,2,2018,Costa Coffee,Eating Out,2,276
23,2,2018,Subway,Eating Out,8,268
24,2,2018,O2,Bills,33,235
26,2,2018,South West Trains,Transport,28,207
26,2,2018,Caffe Nero,Eating Out,2,205
28,2,2018,Wild Bean Cafe,Eating Out,1,204
28,2,2018,Greggs,Eating Out,8,196
1,3,2018,Rhino Sports salary,General,1700,1896
1,3,2018,Starbucks Coffee,Eating Out,1,1895
1,3,2018,McDonalds,Eating Out,6,1889
2,3,2018,Tescos,Groceries,53,1836
2,3,2018,Subway,Eating Out,5,1831
2,3,2018,Scott's Restaurant,Eating Out,50,1781
3,3,2018,Scott's Restaurant,Eating Out,57,1724
3,3,2018,ATM Cash Withdrawal,General,20,1704
5,3,2018,South West Trains,Transport,24,1680
5,3,2018,The West Cornwall Pasty Company,Eating Out,8,1672
5,3,2018,ATM Cash Withdrawal,General,20,1652
6,3,2018,Wild Bean Cafe,Eating Out,1,1651
6,3,2018,ATM Cash Withdrawal,General,20,1631
7,3,2018,Cubit and West rent,Rent,550,1081
8,3,2018,McDonalds,Eating Out,6,1075
9,3,2018,Tescos,Groceries,75,1000
9,3,2018,Caffe Nero,Eating Out,1,999
9,3,2018,Chicken Cottage,Eating Out,8,991
10,3,2018,ATM Cash Withdrawal,General,10,981
11,3,2018,ATM Cash Withdrawal,General,20,961
12,3,2018,South West Trains,Transport,32,929
12,3,2018,Caffe Nero,Eating Out,2,927
12,3,2018,Pret A Manger,Eating Out,5,922
12,3,2018,ATM Cash Withdrawal,General,10,912
12,3,2018,Tool Tec,,6,906
13,3,2018,Starbucks Coffee,Eating Out,2,904
13,3,2018,Chicken Cottage,Eating Out,7,897
14,3,2018,Starbucks Coffee,Eating Out,2,895
14,3,2018,Chicken Cottage,Eating Out,7,888
15,3,2018,BRGAS-Electricity,Bills,41,847
15,3,2018,BRGAS-Gas,Bills,29,818
15,3,2018,ATM Cash Withdrawal,General,20,798
16,3,2018,LBS Council Tax,Bills,50,748
16,3,2018,ASDA,Groceries,48,700
16,3,2018,Starbucks Coffee,Eating Out,2,698
16,3,2018,Subway,Eating Out,6,692
16,3,2018,Dominos Pizza,Eating Out,42,650
16,3,2018,Tool Shop,,2,648
17,3,2018,Restaurant Gordon RamsayPortland Restaurant,Eating Out,39,609
18,3,2018,ATM Cash Withdrawal,General,10,599
18,3,2018,Tool Shop,,4,595
19,3,2018,South West Trains,Transport,24,571
20,3,2018,VIRGIN MEDIA PYMTS,Bills,40,531
20,3,2018,Costa Coffee,Eating Out,2,529
20,3,2018,ATM Cash Withdrawal,General,20,509
21,3,2018,Starbucks Coffee,Eating Out,1,508
21,3,2018,The West Cornwall Pasty Company,Eating Out,6,502
22,3,2018,Starbucks Coffee,Eating Out,2,500
23,3,2018,Sainsburys,Groceries,72,428
23,3,2018,Starbucks Coffee,Eating Out,2,426
24,3,2018,O2,Bills,37,389
25,3,2018,ATM Cash Withdrawal,General,10,379
26,3,2018,South West Trains,Transport,26,353
26,3,2018,Wild Bean Cafe,Eating Out,1,352
26,3,2018,Civic Shop,,7,345
27,3,2018,Wild Bean Cafe,Eating Out,2,343
28,3,2018,Starbucks Coffee,Eating Out,2,341
29,3,2018,Costa Coffee,Eating Out,2,339
29,3,2018,McDonalds,Eating Out,5,334
29,3,2018,ATM Cash Withdrawal,General,20,314
30,3,2018,Waitrose,Groceries,75,239
30,3,2018,Caffe Nero,Eating Out,2,237
30,3,2018,Pret A Manger,Eating Out,4,233
30,3,2018,Dominos Pizza,Eating Out,50,183
30,3,2018,ATM Cash Withdrawal,General,20,163
1,4,2018,Rhino Sports salary,General,1700,1863
2,4,2018,South West Trains,Transport,34,1829
2,4,2018,Starbucks Coffee,Eating Out,2,1827
2,4,2018,Pret A Manger,Eating Out,6,1821
3,4,2018,Caffe Nero,Eating Out,2,1819
3,4,2018,McDonalds,Eating Out,4,1815
