Day,Month,Year,Description,Category,Value,Balance
1,January,2010,Rhino Sports salary,General,1700,1700
1,January,2010,Waitrose,Groceries,71,1629
1,January,2010,Costa Coffee,Eating Out,2,1627
1,January,2010,Pret A Manger,Eating Out,7,1620
3,January,2010,Dominos Pizza,Eating Out,32,1588
4,January,2010,South West Trains,Transport,24,1564
4,January,2010,Starbucks Coffee,Eating Out,2,1562
5,January,2010,Wild Bean Cafe,Eating Out,1,1561
5,January,2010,Chicken Cottage,Eating Out,6,1555
6,January,2010,Costa Coffee,Eating Out,1,1554
7,January,2010,Cubit and West rent,Rent,660,894
7,January,2010,Starbucks Coffee,Eating Out,2,892
7,January,2010,Pret A Manger,Eating Out,6,886
8,January,2010,Tescos,Groceries,48,838
8,January,2010,Starbucks Coffee,Eating Out,2,836
8,January,2010,Greggs,Eating Out,8,828
11,January,2010,South West Trains,Transport,25,803
11,January,2010,Costa Coffee,Eating Out,2,801
11,January,2010,Greggs,Eating Out,5,796
12,January,2010,Subway,Eating Out,7,789
12,January,2010,ATM Cash Withdrawal,General,60,729
13,January,2010,Starbucks Coffee,Eating Out,1,728
13,January,2010,Chicken Cottage,Eating Out,4,724
14,January,2010,Wild Bean Cafe,Eating Out,1,723
15,January,2010,BRGAS-Electricity,Bills,40,683
15,January,2010,BRGAS-Gas,Bills,94,589
15,January,2010,Tescos,Groceries,44,545
15,January,2010,Costa Coffee,Eating Out,2,543
15,January,2010,The West Cornwall Pasty Company,Eating Out,5,538
16,January,2010,LBS Council Tax,Bills,50,488
18,January,2010,South West Trains,Transport,32,456
18,January,2010,Wild Bean Cafe,Eating Out,2,454
18,January,2010,McDonalds,Eating Out,8,446
20,January,2010,VIRGIN MEDIA PYMTS,Bills,53,393
20,January,2010,Subway,Eating Out,8,385
21,January,2010,Costa Coffee,Eating Out,2,383
21,January,2010,Chicken Cottage,Eating Out,7,376
22,January,2010,Tescos,Groceries,89,287
22,January,2010,Chicken Cottage,Eating Out,6,281
22,January,2010,Anglo restaurant,Eating Out,51,230
24,January,2010,O2,Bills,33,197
25,January,2010,South West Trains,Transport,34,163
25,January,2010,Wild Bean Cafe,Eating Out,1,162
25,January,2010,The West Cornwall Pasty Company,Eating Out,6,156
26,January,2010,Costa Coffee,Eating Out,2,154
26,January,2010,Greggs,Eating Out,4,150
27,January,2010,Caffe Nero,Eating Out,2,148
27,January,2010,Greggs,Eating Out,8,140
28,January,2010,Caffe Nero,Eating Out,2,138
29,January,2010,Morrisons,Groceries,50,88
29,January,2010,Caffe Nero,Eating Out,1,87
29,January,2010,Subway,Eating Out,4,83
31,January,2010,ATM Cash Withdrawal,General,60,23
1,February,2010,Rhino Sports salary,General,1700,1723
1,February,2010,South West Trains,Transport,37,1686
1,February,2010,Wild Bean Cafe,Eating Out,2,1684
1,February,2010,Greggs,Eating Out,8,1676
2,February,2010,Costa Coffee,Eating Out,1,1675
2,February,2010,Greggs,Eating Out,6,1669
3,February,2010,Starbucks Coffee,Eating Out,2,1667
3,February,2010,Greggs,Eating Out,7,1660
4,February,2010,Caffe Nero,Eating Out,1,1659
4,February,2010,Chicken Cottage,Eating Out,7,1652
5,February,2010,Waitrose,Groceries,59,1593
5,February,2010,Starbucks Coffee,Eating Out,1,1592
5,February,2010,Greggs,Eating Out,6,1586
7,February,2010,Cubit and West rent,Rent,660,926
8,February,2010,South West Trains,Transport,31,895
8,February,2010,Wild Bean Cafe,Eating Out,1,894
8,February,2010,Pret A Manger,Eating Out,7,887
9,February,2010,Starbucks Coffee,Eating Out,2,885
11,February,2010,Caffe Nero,Eating Out,2,883
11,February,2010,Chicken Cottage,Eating Out,8,875
12,February,2010,Sainsburys,Groceries,63,812
12,February,2010,Caffe Nero,Eating Out,1,811
12,February,2010,Greggs,Eating Out,4,807
12,February,2010,Restaurant Gordon RamsayPortland Restaurant,Eating Out,53,754
12,February,2010,ATM Cash Withdrawal,General,80,674
15,February,2010,BRGAS-Electricity,Bills,36,638
15,February,2010,BRGAS-Gas,Bills,31,607
15,February,2010,South West Trains,Transport,25,582
15,February,2010,Caffe Nero,Eating Out,1,581
15,February,2010,Pret A Manger,Eating Out,4,577
16,February,2010,LBS Council Tax,Bills,50,527
16,February,2010,Costa Coffee,Eating Out,1,526
16,February,2010,Subway,Eating Out,4,522
17,February,2010,Starbucks Coffee,Eating Out,2,520
18,February,2010,Chicken Cottage,Eating Out,4,516
19,February,2010,Morrisons,Groceries,49,467
19,February,2010,Caffe Nero,Eating Out,1,466
19,February,2010,Chicken Cottage,Eating Out,4,462
19,February,2010,ATM Cash Withdrawal,General,70,392
20,February,2010,VIRGIN MEDIA PYMTS,Bills,41,351
22,February,2010,South West Trains,Transport,34,317
22,February,2010,Caffe Nero,Eating Out,1,316
23,February,2010,Starbucks Coffee,Eating Out,2,314
23,February,2010,Greggs,Eating Out,7,307
24,February,2010,O2,Bills,31,276
24,February,2010,Caffe Nero,Eating Out,2,274
25,February,2010,Greggs,Eating Out,8,266
26,February,2010,ASDA,Groceries,71,195
26,February,2010,Costa Coffee,Eating Out,2,193
26,February,2010,Subway,Eating Out,6,187
26,February,2010,ATM Cash Withdrawal,General,40,147
1,March,2010,Rhino Sports salary,General,1700,1847
1,March,2010,South West Trains,Transport,36,1811
1,March,2010,Wild Bean Cafe,Eating Out,2,1809
1,March,2010,Subway,Eating Out,7,1802
2,March,2010,Wild Bean Cafe,Eating Out,2,1800
2,March,2010,Chicken Cottage,Eating Out,8,1792
2,March,2010,ATM Cash Withdrawal,General,40,1752
3,March,2010,Starbucks Coffee,Eating Out,2,1750
3,March,2010,Subway,Eating Out,8,1742
4,March,2010,Caffe Nero,Eating Out,2,1740
4,March,2010,Chicken Cottage,Eating Out,4,1736
5,March,2010,Morrisons,Groceries,64,1672
5,March,2010,Costa Coffee,Eating Out,1,1671
5,March,2010,Pret A Manger,Eating Out,8,1663
7,March,2010,Cubit and West rent,Rent,660,1003
8,March,2010,South West Trains,Transport,31,972
8,March,2010,Caffe Nero,Eating Out,2,970
8,March,2010,Greggs,Eating Out,6,964
9,March,2010,Wild Bean Cafe,Eating Out,2,962
9,March,2010,Greggs,Eating Out,4,958
10,March,2010,Costa Coffee,Eating Out,1,957
10,March,2010,Greggs,Eating Out,6,951
11,March,2010,Wild Bean Cafe,Eating Out,2,949
11,March,2010,Chicken Cottage,Eating Out,8,941
12,March,2010,ASDA,Groceries,49,892
12,March,2010,Costa Coffee,Eating Out,1,891
13,March,2010,Restaurant Gordon RamsayPortland Restaurant,Eating Out,35,856
14,March,2010,Anglo restaurant,Eating Out,45,811
15,March,2010,BRGAS-Electricity,Bills,44,767
15,March,2010,BRGAS-Gas,Bills,23,744
15,March,2010,South West Trains,Transport,25,719
15,March,2010,Pret A Manger,Eating Out,7,712
16,March,2010,LBS Council Tax,Bills,50,662
16,March,2010,Caffe Nero,Eating Out,1,661
16,March,2010,Subway,Eating Out,7,654
17,March,2010,Caffe Nero,Eating Out,1,653
17,March,2010,The West Cornwall Pasty Company,Eating Out,7,646
18,March,2010,Caffe Nero,Eating Out,2,644
18,March,2010,McDonalds,Eating Out,7,637
19,March,2010,Tescos,Groceries,55,582
19,March,2010,Starbucks Coffee,Eating Out,1,581
19,March,2010,The West Cornwall Pasty Company,Eating Out,7,574
20,March,2010,VIRGIN MEDIA PYMTS,Bills,39,535
20,March,2010,Dominos Pizza,Eating Out,31,504
20,March,2010,ATM Cash Withdrawal,General,70,434
21,March,2010,Restaurant Gordon RamsayPortland Restaurant,Eating Out,53,381
22,March,2010,South West Trains,Transport,33,348
22,March,2010,Wild Bean Cafe,Eating Out,2,346
24,March,2010,O2,Bills,38,308
24,March,2010,Starbucks Coffee,Eating Out,2,306
24,March,2010,Chicken Cottage,Eating Out,7,299
25,March,2010,Caffe Nero,Eating Out,2,297
25,March,2010,Subway,Eating Out,6,291
26,March,2010,ASDA,Groceries,68,223
29,March,2010,South West Trains,Transport,24,199
29,March,2010,Starbucks Coffee,Eating Out,1,198
30,March,2010,Wild Bean Cafe,Eating Out,2,196
30,March,2010,Chicken Cottage,Eating Out,8,188
31,March,2010,Caffe Nero,Eating Out,2,186
1,April,2010,Rhino Sports salary,General,1700,1886
1,April,2010,Costa Coffee,Eating Out,2,1884
1,April,2010,McDonalds,Eating Out,4,1880
2,April,2010,Sainsburys,Groceries,75,1805
2,April,2010,Caffe Nero,Eating Out,2,1803
2,April,2010,McDonalds,Eating Out,5,1798
3,April,2010,ATM Cash Withdrawal,General,20,1778
4,April,2010,Anglo restaurant,Eating Out,41,1737
5,April,2010,South West Trains,Transport,35,1702
5,April,2010,Subway,Eating Out,8,1694
6,April,2010,Caffe Nero,Eating Out,2,1692
7,April,2010,Cubit and West rent,Rent,660,1032
7,April,2010,Wild Bean Cafe,Eating Out,2,1030
8,April,2010,Costa Coffee,Eating Out,2,1028
8,April,2010,McDonalds,Eating Out,7,1021
9,April,2010,ASDA,Groceries,72,949
9,April,2010,Chicken Cottage,Eating Out,8,941
11,April,2010,Pizza Express,Eating Out,50,891
11,April,2010,ATM Cash Withdrawal,General,80,811
12,April,2010,South West Trains,Transport,38,773
12,April,2010,Wild Bean Cafe,Eating Out,2,771
12,April,2010,Greggs,Eating Out,5,766
13,April,2010,Costa Coffee,Eating Out,1,765
14,April,2010,Caffe Nero,Eating Out,2,763
14,April,2010,The West Cornwall Pasty Company,Eating Out,4,759
15,April,2010,BRGAS-Electricity,Bills,31,728
15,April,2010,BRGAS-Gas,Bills,36,692
15,April,2010,Starbucks Coffee,Eating Out,2,690
15,April,2010,Greggs,Eating Out,6,684
16,April,2010,LBS Council Tax,Bills,50,634
16,April,2010,Waitrose,Groceries,53,581
16,April,2010,Costa Coffee,Eating Out,2,579
16,April,2010,Chicken Cottage,Eating Out,4,575
16,April,2010,Pizza Express,Eating Out,57,518
17,April,2010,ATM Cash Withdrawal,General,70,448
19,April,2010,South West Trains,Transport,36,412
19,April,2010,Pret A Manger,Eating Out,4,408
20,April,2010,VIRGIN MEDIA PYMTS,Bills,28,380
20,April,2010,Wild Bean Cafe,Eating Out,1,379
20,April,2010,McDonalds,Eating Out,6,373
21,April,2010,Starbucks Coffee,Eating Out,1,372
21,April,2010,Greggs,Eating Out,7,365
22,April,2010,Costa Coffee,Eating Out,1,364
22,April,2010,Chicken Cottage,Eating Out,4,360
23,April,2010,ASDA,Groceries,89,271
23,April,2010,Greggs,Eating Out,6,265
24,April,2010,O2,Bills,33,232
26,April,2010,South West Trains,Transport,26,206
26,April,2010,Pret A Manger,Eating Out,8,198
28,April,2010,Wild Bean Cafe,Eating Out,2,196
28,April,2010,McDonalds,Eating Out,8,188
29,April,2010,Starbucks Coffee,Eating Out,2,186
29,April,2010,Greggs,Eating Out,7,179
30,April,2010,Waitrose,Groceries,42,137
30,April,2010,Starbucks Coffee,Eating Out,2,135
30,April,2010,The West Cornwall Pasty Company,Eating Out,5,130
1,May,2010,Rhino Sports salary,General,1700,1830
1,May,2010,Scott's Restaurant,Eating Out,24,1806
1,May,2010,ATM Cash Withdrawal,General,50,1756
3,May,2010,South West Trains,Transport,35,1721
3,May,2010,Greggs,Eating Out,7,1714
4,May,2010,Starbucks Coffee,Eating Out,1,1713
4,May,2010,Pret A Manger,Eating Out,5,1708
4,May,2010,ATM Cash Withdrawal,General,50,1658
5,May,2010,Costa Coffee,Eating Out,2,1656
5,May,2010,Chicken Cottage,Eating Out,6,1650
5,May,2010,ATM Cash Withdrawal,General,70,1580
6,May,2010,Costa Coffee,Eating Out,2,1578
6,May,2010,McDonalds,Eating Out,5,1573
7,May,2010,Cubit and West rent,Rent,660,913
7,May,2010,ASDA,Groceries,87,826
7,May,2010,Wild Bean Cafe,Eating Out,2,824
7,May,2010,McDonalds,Eating Out,6,818
9,May,2010,Dominos Pizza,Eating Out,24,794
10,May,2010,South West Trains,Transport,27,767
10,May,2010,Chicken Cottage,Eating Out,8,759
11,May,2010,Starbucks Coffee,Eating Out,2,757
11,May,2010,Subway,Eating Out,7,750
12,May,2010,Caffe Nero,Eating Out,1,749
12,May,2010,Subway,Eating Out,6,743
13,May,2010,Costa Coffee,Eating Out,2,741
14,May,2010,Sainsburys,Groceries,82,659
14,May,2010,Wild Bean Cafe,Eating Out,1,658
14,May,2010,McDonalds,Eating Out,5,653
15,May,2010,BRGAS-Electricity,Bills,26,627
15,May,2010,BRGAS-Gas,Bills,21,606
15,May,2010,Ministry of Sound ClubXOYO Club,Eating Out,10,596
16,May,2010,LBS Council Tax,Bills,50,546
17,May,2010,South West Trains,Transport,29,517
17,May,2010,Wild Bean Cafe,Eating Out,1,516
18,May,2010,Wild Bean Cafe,Eating Out,2,514
19,May,2010,Chicken Cottage,Eating Out,6,508
20,May,2010,VIRGIN MEDIA PYMTS,Bills,28,480
20,May,2010,Wild Bean Cafe,Eating Out,1,479
20,May,2010,Chicken Cottage,Eating Out,6,473
21,May,2010,Sainsburys,Groceries,76,397
21,May,2010,Scott's Restaurant,Eating Out,44,353
23,May,2010,ATM Cash Withdrawal,General,40,313
24,May,2010,O2,Bills,36,277
24,May,2010,South West Trains,Transport,38,239
24,May,2010,Costa Coffee,Eating Out,1,238
25,May,2010,Starbucks Coffee,Eating Out,2,236
25,May,2010,Pret A Manger,Eating Out,5,231
26,May,2010,McDonalds,Eating Out,5,226
27,May,2010,Caffe Nero,Eating Out,2,224
27,May,2010,Greggs,Eating Out,6,218
28,May,2010,ASDA,Groceries,60,158
28,May,2010,Costa Coffee,Eating Out,1,157
28,May,2010,Subway,Eating Out,4,153
29,May,2010,ATM Cash Withdrawal,General,40,113
31,May,2010,South West Trains,Transport,31,82
1,June,2010,Rhino Sports salary,General,1700,1782
1,June,2010,Wild Bean Cafe,Eating Out,1,1781
1,June,2010,Subway,Eating Out,5,1776
2,June,2010,Caffe Nero,Eating Out,1,1775
2,June,2010,Greggs,Eating Out,6,1769
3,June,2010,The West Cornwall Pasty Company,Eating Out,5,1764
4,June,2010,ASDA,Groceries,63,1701
4,June,2010,Wild Bean Cafe,Eating Out,2,1699
4,June,2010,Greggs,Eating Out,6,1693
5,June,2010,Heaven Club,Eating Out,8,1685
5,June,2010,Heaven Club,Eating Out,12,1673
5,June,2010,Heaven Club,Eating Out,6,1667
5,June,2010,Heaven Club,Eating Out,16,1651
5,June,2010,Heaven Club,Eating Out,6,1645
6,June,2010,ATM Cash Withdrawal,General,20,1625
7,June,2010,Cubit and West rent,Rent,660,965
7,June,2010,South West Trains,Transport,26,939
7,June,2010,Caffe Nero,Eating Out,2,937
7,June,2010,Subway,Eating Out,7,930
8,June,2010,Caffe Nero,Eating Out,2,928
8,June,2010,McDonalds,Eating Out,6,922
9,June,2010,Pret A Manger,Eating Out,7,915
11,June,2010,Waitrose,Groceries,71,844
11,June,2010,The West Cornwall Pasty Company,Eating Out,6,838
14,June,2010,South West Trains,Transport,34,804
14,June,2010,Costa Coffee,Eating Out,1,803
15,June,2010,BRGAS-Electricity,Bills,41,762
15,June,2010,BRGAS-Gas,Bills,31,731
15,June,2010,Caffe Nero,Eating Out,1,730
15,June,2010,Chicken Cottage,Eating Out,7,723
15,June,2010,ATM Cash Withdrawal,General,30,693
16,June,2010,LBS Council Tax,Bills,50,643
16,June,2010,Wild Bean Cafe,Eating Out,2,641
16,June,2010,Chicken Cottage,Eating Out,7,634
17,June,2010,The West Cornwall Pasty Company,Eating Out,4,630
18,June,2010,ASDA,Groceries,58,572
18,June,2010,Costa Coffee,Eating Out,2,570
18,June,2010,Chicken Cottage,Eating Out,5,565
19,June,2010,Restaurant Gordon RamsayPortland Restaurant,Eating Out,55,510
20,June,2010,VIRGIN MEDIA PYMTS,Bills,39,471
20,June,2010,Dominos Pizza,Eating Out,43,428
21,June,2010,South West Trains,Transport,31,397
21,June,2010,Starbucks Coffee,Eating Out,2,395
21,June,2010,McDonalds,Eating Out,8,387
22,June,2010,The West Cornwall Pasty Company,Eating Out,4,383
23,June,2010,Wild Bean Cafe,Eating Out,2,381
23,June,2010,Greggs,Eating Out,8,373
24,June,2010,O2,Bills,38,335
24,June,2010,Greggs,Eating Out,4,331
25,June,2010,Waitrose,Groceries,60,271
25,June,2010,Costa Coffee,Eating Out,2,269
25,June,2010,Chicken Cottage,Eating Out,5,264
28,June,2010,South West Trains,Transport,33,231
28,June,2010,Starbucks Coffee,Eating Out,2,229
28,June,2010,Chicken Cottage,Eating Out,7,222
29,June,2010,Costa Coffee,Eating Out,1,221
30,June,2010,Wild Bean Cafe,Eating Out,2,219
30,June,2010,Pret A Manger,Eating Out,7,212
1,July,2010,Rhino Sports salary,General,1700,1912
1,July,2010,Wild Bean Cafe,Eating Out,2,1910
1,July,2010,Greggs,Eating Out,7,1903
2,July,2010,Waitrose,Groceries,83,1820
2,July,2010,Wild Bean Cafe,Eating Out,2,1818
2,July,2010,Pizza Express,Eating Out,40,1778
3,July,2010,Restaurant Gordon RamsayPortland Restaurant,Eating Out,37,1741
5,July,2010,South West Trains,Transport,26,1715
6,July,2010,McDonalds,Eating Out,8,1707
7,July,2010,Cubit and West rent,Rent,660,1047
7,July,2010,Costa Coffee,Eating Out,1,1046
7,July,2010,Pret A Manger,Eating Out,8,1038
8,July,2010,Wild Bean Cafe,Eating Out,2,1036
8,July,2010,Subway,Eating Out,5,1031
8,July,2010,ATM Cash Withdrawal,General,80,951
9,July,2010,Sainsburys,Groceries,59,892
10,July,2010,Scott's Restaurant,Eating Out,46,846
12,July,2010,South West Trains,Transport,29,817
12,July,2010,Wild Bean Cafe,Eating Out,2,815
12,July,2010,McDonalds,Eating Out,8,807
13,July,2010,Pret A Manger,Eating Out,6,801
15,July,2010,BRGAS-Electricity,Bills,32,769
15,July,2010,BRGAS-Gas,Bills,38,731
15,July,2010,Costa Coffee,Eating Out,2,729
15,July,2010,Greggs,Eating Out,5,724
16,July,2010,LBS Council Tax,Bills,50,674
16,July,2010,ASDA,Groceries,72,602
16,July,2010,Costa Coffee,Eating Out,2,600
16,July,2010,Pret A Manger,Eating Out,5,595
18,July,2010,Restaurant Gordon RamsayPortland Restaurant,Eating Out,53,542
18,July,2010,ATM Cash Withdrawal,General,90,452
19,July,2010,South West Trains,Transport,33,419
19,July,2010,Caffe Nero,Eating Out,1,418
19,July,2010,The West Cornwall Pasty Company,Eating Out,7,411
20,July,2010,VIRGIN MEDIA PYMTS,Bills,38,373
20,July,2010,Caffe Nero,Eating Out,2,371
20,July,2010,The West Cornwall Pasty Company,Eating Out,6,365
21,July,2010,Costa Coffee,Eating Out,2,363
21,July,2010,Chicken Cottage,Eating Out,8,355
22,July,2010,Costa Coffee,Eating Out,2,353
23,July,2010,Sainsburys,Groceries,73,280
24,July,2010,O2,Bills,34,246
25,July,2010,Anglo restaurant,Eating Out,54,192
26,July,2010,South West Trains,Transport,29,163
26,July,2010,Caffe Nero,Eating Out,2,161
26,July,2010,Greggs,Eating Out,6,155
27,July,2010,Chicken Cottage,Eating Out,8,147
28,July,2010,Costa Coffee,Eating Out,2,145
28,July,2010,Chicken Cottage,Eating Out,5,140
29,July,2010,Wild Bean Cafe,Eating Out,2,138
29,July,2010,Chicken Cottage,Eating Out,4,134
30,July,2010,Morrisons,Groceries,73,61
30,July,2010,Starbucks Coffee,Eating Out,2,59
30,July,2010,The West Cornwall Pasty Company,Eating Out,7,52
1,August,2010,Rhino Sports salary,General,1700,1752
2,August,2010,South West Trains,Transport,32,1720
2,August,2010,Wild Bean Cafe,Eating Out,2,1718
2,August,2010,The West Cornwall Pasty Company,Eating Out,4,1714
2,August,2010,ATM Cash Withdrawal,General,60,1654
3,August,2010,Starbucks Coffee,Eating Out,1,1653
3,August,2010,Pret A Manger,Eating Out,5,1648
4,August,2010,Starbucks Coffee,Eating Out,1,1647
4,August,2010,Pret A Manger,Eating Out,7,1640
5,August,2010,Chicken Cottage,Eating Out,4,1636
5,August,2010,ATM Cash Withdrawal,General,10,1626
6,August,2010,Sainsburys,Groceries,64,1562
6,August,2010,Costa Coffee,Eating Out,2,1560
7,August,2010,Cubit and West rent,Rent,660,900
9,August,2010,South West Trains,Transport,37,863
9,August,2010,Starbucks Coffee,Eating Out,1,862
10,August,2010,Starbucks Coffee,Eating Out,2,860
10,August,2010,Pret A Manger,Eating Out,4,856
11,August,2010,Costa Coffee,Eating Out,2,854
11,August,2010,Chicken Cottage,Eating Out,6,848
12,August,2010,Caffe Nero,Eating Out,1,847
12,August,2010,Greggs,Eating Out,5,842
13,August,2010,ASDA,Groceries,53,789
15,August,2010,BRGAS-Electricity,Bills,33,756
15,August,2010,BRGAS-Gas,Bills,38,718
16,August,2010,LBS Council Tax,Bills,50,668
16,August,2010,South West Trains,Transport,31,637
16,August,2010,Wild Bean Cafe,Eating Out,2,635
16,August,2010,Subway,Eating Out,7,628
17,August,2010,Costa Coffee,Eating Out,1,627
18,August,2010,Subway,Eating Out,6,621
19,August,2010,Starbucks Coffee,Eating Out,2,619
20,August,2010,VIRGIN MEDIA PYMTS,Bills,41,578
20,August,2010,Morrisons,Groceries,51,527
20,August,2010,Caffe Nero,Eating Out,2,525
20,August,2010,Pret A Manger,Eating Out,6,519
22,August,2010,Scott's Restaurant,Eating Out,47,472
23,August,2010,South West Trains,Transport,34,438
23,August,2010,Wild Bean Cafe,Eating Out,2,436
23,August,2010,The West Cornwall Pasty Company,Eating Out,7,429
24,August,2010,O2,Bills,30,399
24,August,2010,Costa Coffee,Eating Out,2,397
25,August,2010,Wild Bean Cafe,Eating Out,2,395
26,August,2010,Wild Bean Cafe,Eating Out,2,393
26,August,2010,The West Cornwall Pasty Company,Eating Out,6,387
27,August,2010,Tescos,Groceries,77,310
30,August,2010,South West Trains,Transport,36,274
30,August,2010,Wild Bean Cafe,Eating Out,2,272
30,August,2010,Subway,Eating Out,6,266
31,August,2010,Costa Coffee,Eating Out,2,264
31,August,2010,Pret A Manger,Eating Out,8,256
1,September,2010,Rhino Sports salary,General,1700,1956
1,September,2010,Wild Bean Cafe,Eating Out,2,1954
2,September,2010,Starbucks Coffee,Eating Out,2,1952
3,September,2010,Morrisons,Groceries,74,1878
3,September,2010,McDonalds,Eating Out,8,1870
3,September,2010,Anglo restaurant,Eating Out,35,1835
6,September,2010,South West Trains,Transport,27,1808
6,September,2010,Costa Coffee,Eating Out,2,1806
6,September,2010,McDonalds,Eating Out,8,1798
7,September,2010,Cubit and West rent,Rent,660,1138
7,September,2010,Caffe Nero,Eating Out,1,1137
7,September,2010,The West Cornwall Pasty Company,Eating Out,4,1133
8,September,2010,Wild Bean Cafe,Eating Out,1,1132
8,September,2010,McDonalds,Eating Out,7,1125
9,September,2010,Caffe Nero,Eating Out,2,1123
10,September,2010,Morrisons,Groceries,54,1069
10,September,2010,Caffe Nero,Eating Out,1,1068
11,September,2010,Pizza Express,Eating Out,36,1032
13,September,2010,South West Trains,Transport,27,1005
13,September,2010,Costa Coffee,Eating Out,2,1003
14,September,2010,Wild Bean Cafe,Eating Out,1,1002
14,September,2010,The West Cornwall Pasty Company,Eating Out,5,997
15,September,2010,BRGAS-Electricity,Bills,23,974
15,September,2010,BRGAS-Gas,Bills,35,939
15,September,2010,Caffe Nero,Eating Out,1,938
15,September,2010,Greggs,Eating Out,7,931
16,September,2010,LBS Council Tax,Bills,50,881
16,September,2010,Caffe Nero,Eating Out,2,879
16,September,2010,Pret A Manger,Eating Out,8,871
17,September,2010,Tescos,Groceries,85,786
17,September,2010,Costa Coffee,Eating Out,2,784
17,September,2010,Chicken Cottage,Eating Out,6,778
17,September,2010,Pizza Express,Eating Out,39,739
18,September,2010,Dominos Pizza,Eating Out,58,681
20,September,2010,VIRGIN MEDIA PYMTS,Bills,41,640
20,September,2010,South West Trains,Transport,36,604
20,September,2010,Starbucks Coffee,Eating Out,2,602
20,September,2010,Subway,Eating Out,7,595
21,September,2010,Wild Bean Cafe,Eating Out,2,593
22,September,2010,Pret A Manger,Eating Out,6,587
22,September,2010,ATM Cash Withdrawal,General,60,527
23,September,2010,Starbucks Coffee,Eating Out,2,525
24,September,2010,O2,Bills,35,490
24,September,2010,Waitrose,Groceries,83,407
24,September,2010,Chicken Cottage,Eating Out,4,403
25,September,2010,The Grand Pub,Eating Out,10,393
25,September,2010,The Grand Pub,Eating Out,10,383
25,September,2010,The Grand Pub,Eating Out,15,368
25,September,2010,The Grand Pub,Eating Out,13,355
25,September,2010,The Grand Pub,Eating Out,15,340
25,September,2010,The Grand Pub,Eating Out,15,325
27,September,2010,South West Trains,Transport,28,297
27,September,2010,Caffe Nero,Eating Out,2,295
27,September,2010,McDonalds,Eating Out,7,288
27,September,2010,ATM Cash Withdrawal,General,50,238
28,September,2010,Costa Coffee,Eating Out,1,237
29,September,2010,Chicken Cottage,Eating Out,6,231
29,September,2010,ATM Cash Withdrawal,General,90,141
30,September,2010,Caffe Nero,Eating Out,2,139
30,September,2010,Subway,Eating Out,7,132
1,October,2010,Rhino Sports salary,General,1700,1832
1,October,2010,Tescos,Groceries,85,1747
1,October,2010,Caffe Nero,Eating Out,2,1745
1,October,2010,The West Cornwall Pasty Company,Eating Out,6,1739
4,October,2010,South West Trains,Transport,37,1702
4,October,2010,Wild Bean Cafe,Eating Out,2,1700
4,October,2010,Subway,Eating Out,5,1695
5,October,2010,Wild Bean Cafe,Eating Out,2,1693
6,October,2010,The West Cornwall Pasty Company,Eating Out,5,1688
7,October,2010,Cubit and West rent,Rent,660,1028
7,October,2010,Wild Bean Cafe,Eating Out,2,1026
7,October,2010,Greggs,Eating Out,7,1019
7,October,2010,ATM Cash Withdrawal,General,60,959
8,October,2010,Morrisons,Groceries,43,916
8,October,2010,Caffe Nero,Eating Out,2,914
8,October,2010,Subway,Eating Out,5,909
8,October,2010,Anglo restaurant,Eating Out,42,867
11,October,2010,South West Trains,Transport,37,830
11,October,2010,Starbucks Coffee,Eating Out,2,828
11,October,2010,McDonalds,Eating Out,4,824
12,October,2010,Starbucks Coffee,Eating Out,2,822
13,October,2010,Costa Coffee,Eating Out,1,821
13,October,2010,Subway,Eating Out,7,814
14,October,2010,Wild Bean Cafe,Eating Out,1,813
14,October,2010,Greggs,Eating Out,5,808
15,October,2010,BRGAS-Electricity,Bills,31,777
15,October,2010,BRGAS-Gas,Bills,33,744
15,October,2010,Waitrose,Groceries,60,684
15,October,2010,The West Cornwall Pasty Company,Eating Out,7,677
15,October,2010,Anglo restaurant,Eating Out,48,629
15,October,2010,ATM Cash Withdrawal,General,60,569
16,October,2010,LBS Council Tax,Bills,50,519
16,October,2010,Pizza Express,Eating Out,25,494
18,October,2010,South West Trains,Transport,28,466
18,October,2010,Wild Bean Cafe,Eating Out,2,464
19,October,2010,Starbucks Coffee,Eating Out,2,462
19,October,2010,McDonalds,Eating Out,7,455
20,October,2010,VIRGIN MEDIA PYMTS,Bills,37,418
20,October,2010,Starbucks Coffee,Eating Out,2,416
21,October,2010,Costa Coffee,Eating Out,2,414
21,October,2010,McDonalds,Eating Out,8,406
22,October,2010,ASDA,Groceries,76,330
22,October,2010,Caffe Nero,Eating Out,2,328
22,October,2010,Pret A Manger,Eating Out,4,324
23,October,2010,ATM Cash Withdrawal,General,30,294
24,October,2010,O2,Bills,36,258
25,October,2010,South West Trains,Transport,38,220
25,October,2010,Costa Coffee,Eating Out,2,218
25,October,2010,Chicken Cottage,Eating Out,5,213
26,October,2010,Caffe Nero,Eating Out,2,211
26,October,2010,McDonalds,Eating Out,6,205
27,October,2010,Costa Coffee,Eating Out,1,204
27,October,2010,The West Cornwall Pasty Company,Eating Out,5,199
28,October,2010,Wild Bean Cafe,Eating Out,2,197
28,October,2010,Chicken Cottage,Eating Out,8,189
29,October,2010,ASDA,Groceries,82,107
29,October,2010,Caffe Nero,Eating Out,2,105
29,October,2010,The West Cornwall Pasty Company,Eating Out,4,101
31,October,2010,ATM Cash Withdrawal,General,90,11
1,November,2010,Rhino Sports salary,General,1700,1711
1,November,2010,South West Trains,Transport,34,1677
1,November,2010,Caffe Nero,Eating Out,2,1675
2,November,2010,Costa Coffee,Eating Out,1,1674
3,November,2010,Chicken Cottage,Eating Out,5,1669
4,November,2010,Costa Coffee,Eating Out,2,1667
4,November,2010,Pret A Manger,Eating Out,6,1661
5,November,2010,ASDA,Groceries,74,1587
5,November,2010,The West Cornwall Pasty Company,Eating Out,5,1582
5,November,2010,Fabric Club,Eating Out,12,1570
5,November,2010,Fabric Club,Eating Out,10,1560
5,November,2010,Fabric Club,Eating Out,16,1544
6,November,2010,Scott's Restaurant,Eating Out,56,1488
7,November,2010,Cubit and West rent,Rent,660,828
8,November,2010,South West Trains,Transport,37,791
8,November,2010,Wild Bean Cafe,Eating Out,2,789
8,November,2010,Pret A Manger,Eating Out,5,784
9,November,2010,McDonalds,Eating Out,7,777
10,November,2010,Caffe Nero,Eating Out,1,776
10,November,2010,McDonalds,Eating Out,7,769
11,November,2010,Caffe Nero,Eating Out,2,767
12,November,2010,ASDA,Groceries,51,716
12,November,2010,Starbucks Coffee,Eating Out,2,714
12,November,2010,McDonalds,Eating Out,6,708
15,November,2010,BRGAS-Electricity,Bills,35,673
15,November,2010,BRGAS-Gas,Bills,91,582
15,November,2010,South West Trains,Transport,35,547
16,November,2010,LBS Council Tax,Bills,50,497
16,November,2010,Costa Coffee,Eating Out,2,495
16,November,2010,McDonalds,Eating Out,7,488
17,November,2010,Starbucks Coffee,Eating Out,2,486
18,November,2010,Starbucks Coffee,Eating Out,2,484
18,November,2010,Pret A Manger,Eating Out,7,477
19,November,2010,Waitrose,Groceries,77,400
19,November,2010,Pret A Manger,Eating Out,7,393
19,November,2010,Pizza Express,Eating Out,41,352
20,November,2010,VIRGIN MEDIA PYMTS,Bills,37,315
22,November,2010,South West Trains,Transport,37,278
22,November,2010,Starbucks Coffee,Eating Out,1,277
22,November,2010,Chicken Cottage,Eating Out,4,273
24,November,2010,O2,Bills,32,241
24,November,2010,Starbucks Coffee,Eating Out,2,239
24,November,2010,McDonalds,Eating Out,7,232
25,November,2010,Costa Coffee,Eating Out,2,230
26,November,2010,Morrisons,Groceries,46,184
26,November,2010,Starbucks Coffee,Eating Out,2,182
29,November,2010,South West Trains,Transport,31,151
29,November,2010,Starbucks Coffee,Eating Out,1,150
29,November,2010,Pret A Manger,Eating Out,6,144
30,November,2010,Costa Coffee,Eating Out,2,142
1,December,2010,Rhino Sports salary,General,1700,1842
1,December,2010,Starbucks Coffee,Eating Out,2,1840
2,December,2010,The West Cornwall Pasty Company,Eating Out,4,1836
3,December,2010,Morrisons,Groceries,57,1779
4,December,2010,Scott's Restaurant,Eating Out,53,1726
6,December,2010,South West Trains,Transport,32,1694
6,December,2010,Caffe Nero,Eating Out,2,1692
7,December,2010,Cubit and West rent,Rent,660,1032
7,December,2010,Wild Bean Cafe,Eating Out,1,1031
7,December,2010,Pret A Manger,Eating Out,7,1024
8,December,2010,Costa Coffee,Eating Out,2,1022
8,December,2010,Greggs,Eating Out,6,1016
9,December,2010,Caffe Nero,Eating Out,2,1014
9,December,2010,ATM Cash Withdrawal,General,60,954
10,December,2010,Sainsburys,Groceries,83,871
10,December,2010,Caffe Nero,Eating Out,2,869
10,December,2010,McDonalds,Eating Out,4,865
10,December,2010,Scott's Restaurant,Eating Out,42,823
13,December,2010,South West Trains,Transport,35,788
13,December,2010,Wild Bean Cafe,Eating Out,1,787
13,December,2010,McDonalds,Eating Out,7,780
14,December,2010,Caffe Nero,Eating Out,2,778
14,December,2010,McDonalds,Eating Out,6,772
15,December,2010,BRGAS-Electricity,Bills,41,731
15,December,2010,BRGAS-Gas,Bills,34,697
15,December,2010,The West Cornwall Pasty Company,Eating Out,8,689
15,December,2010,ATM Cash Withdrawal,General,40,649
16,December,2010,LBS Council Tax,Bills,50,599
16,December,2010,Wild Bean Cafe,Eating Out,2,597
16,December,2010,McDonalds,Eating Out,4,593
17,December,2010,ASDA,Groceries,44,549
17,December,2010,Wild Bean Cafe,Eating Out,1,548
20,December,2010,VIRGIN MEDIA PYMTS,Bills,38,510
20,December,2010,South West Trains,Transport,37,473
20,December,2010,Starbucks Coffee,Eating Out,1,472
21,December,2010,Costa Coffee,Eating Out,2,470
21,December,2010,Pret A Manger,Eating Out,7,463
22,December,2010,Costa Coffee,Eating Out,1,462
23,December,2010,Costa Coffee,Eating Out,2,460
23,December,2010,Pret A Manger,Eating Out,6,454
24,December,2010,O2,Bills,36,418
24,December,2010,Morrisons,Groceries,79,339
24,December,2010,Costa Coffee,Eating Out,1,338
24,December,2010,Scott's Restaurant,Eating Out,56,282
27,December,2010,South West Trains,Transport,37,245
27,December,2010,Wild Bean Cafe,Eating Out,2,243
28,December,2010,Wild Bean Cafe,Eating Out,2,241
28,December,2010,Pret A Manger,Eating Out,6,235
29,December,2010,Wild Bean Cafe,Eating Out,2,233
29,December,2010,Subway,Eating Out,6,227
30,December,2010,Costa Coffee,Eating Out,1,226
30,December,2010,Pret A Manger,Eating Out,6,220
31,December,2010,Tescos,Groceries,88,132
31,December,2010,Caffe Nero,Eating Out,2,130
1,January,2011,Rhino Sports salary,General,1700,1830
3,January,2011,South West Trains,Transport,30,1800
3,January,2011,Wild Bean Cafe,Eating Out,1,1799
4,January,2011,Starbucks Coffee,Eating Out,2,1797
4,January,2011,Subway,Eating Out,5,1792
5,January,2011,Costa Coffee,Eating Out,2,1790
6,January,2011,Starbucks Coffee,Eating Out,1,1789
6,January,2011,The West Cornwall Pasty Company,Eating Out,8,1781
7,January,2011,Cubit and West rent,Rent,660,1121
7,January,2011,ASDA,Groceries,82,1039
7,January,2011,Caffe Nero,Eating Out,1,1038
7,January,2011,Subway,Eating Out,8,1030
8,January,2011,ATM Cash Withdrawal,General,60,970
10,January,2011,South West Trains,Transport,25,945
10,January,2011,Wild Bean Cafe,Eating Out,1,944
10,January,2011,The West Cornwall Pasty Company,Eating Out,5,939
11,January,2011,Costa Coffee,Eating Out,2,937
11,January,2011,Chicken Cottage,Eating Out,5,932
12,January,2011,Wild Bean Cafe,Eating Out,2,930
12,January,2011,The West Cornwall Pasty Company,Eating Out,6,924
13,January,2011,Caffe Nero,Eating Out,2,922
13,January,2011,Greggs,Eating Out,6,916
14,January,2011,Sainsburys,Groceries,79,837
14,January,2011,Pret A Manger,Eating Out,6,831
15,January,2011,BRGAS-Electricity,Bills,88,743
15,January,2011,BRGAS-Gas,Bills,101,642
15,January,2011,ATM Cash Withdrawal,General,60,582
16,January,2011,LBS Council Tax,Bills,50,532
17,January,2011,South West Trains,Transport,37,495
17,January,2011,Starbucks Coffee,Eating Out,1,494
17,January,2011,Pret A Manger,Eating Out,7,487
18,January,2011,Caffe Nero,Eating Out,1,486
19,January,2011,Costa Coffee,Eating Out,2,484
19,January,2011,The West Cornwall Pasty Company,Eating Out,8,476
20,January,2011,VIRGIN MEDIA PYMTS,Bills,47,429
20,January,2011,Starbucks Coffee,Eating Out,1,428
21,January,2011,Waitrose,Groceries,59,369
21,January,2011,Wild Bean Cafe,Eating Out,1,368
21,January,2011,The West Cornwall Pasty Company,Eating Out,8,360
23,January,2011,Scott's Restaurant,Eating Out,53,307
24,January,2011,O2,Bills,33,274
24,January,2011,South West Trains,Transport,24,250
24,January,2011,Wild Bean Cafe,Eating Out,2,248
25,January,2011,The West Cornwall Pasty Company,Eating Out,4,244
26,January,2011,McDonalds,Eating Out,7,237
27,January,2011,Costa Coffee,Eating Out,2,235
28,January,2011,Waitrose,Groceries,67,168
28,January,2011,Wild Bean Cafe,Eating Out,2,166
28,January,2011,Anglo restaurant,Eating Out,33,133
31,January,2011,South West Trains,Transport,34,99
31,January,2011,Chicken Cottage,Eating Out,8,91
31,January,2011,ATM Cash Withdrawal,General,50,41
1,February,2011,Rhino Sports salary,General,1700,1741
1,February,2011,Starbucks Coffee,Eating Out,1,1740
1,February,2011,Greggs,Eating Out,6,1734
2,February,2011,Starbucks Coffee,Eating Out,2,1732
2,February,2011,Subway,Eating Out,8,1724
3,February,2011,Starbucks Coffee,Eating Out,1,1723
4,February,2011,Sainsburys,Groceries,63,1660
4,February,2011,Caffe Nero,Eating Out,1,1659
4,February,2011,Pret A Manger,Eating Out,5,1654
7,February,2011,Cubit and West rent,Rent,660,994
7,February,2011,South West Trains,Transport,25,969
7,February,2011,Caffe Nero,Eating Out,1,968
7,February,2011,McDonalds,Eating Out,6,962
8,February,2011,Wild Bean Cafe,Eating Out,2,960
8,February,2011,Subway,Eating Out,6,954
9,February,2011,Caffe Nero,Eating Out,2,952
9,February,2011,Greggs,Eating Out,6,946
10,February,2011,Greggs,Eating Out,5,941
11,February,2011,Tescos,Groceries,78,863
11,February,2011,Caffe Nero,Eating Out,2,861
11,February,2011,ATM Cash Withdrawal,General,80,781
14,February,2011,South West Trains,Transport,25,756
14,February,2011,Caffe Nero,Eating Out,2,754
14,February,2011,Chicken Cottage,Eating Out,6,748
15,February,2011,BRGAS-Electricity,Bills,22,726
15,February,2011,BRGAS-Gas,Bills,21,705
15,February,2011,Caffe Nero,Eating Out,1,704
15,February,2011,McDonalds,Eating Out,5,699
16,February,2011,LBS Council Tax,Bills,50,649
16,February,2011,Wild Bean Cafe,Eating Out,2,647
17,February,2011,Costa Coffee,Eating Out,1,646
18,February,2011,Tescos,Groceries,66,580
18,February,2011,Wild Bean Cafe,Eating Out,2,578
18,February,2011,Greggs,Eating Out,4,574
18,February,2011,Dominos Pizza,Eating Out,38,536
19,February,2011,Pizza Express,Eating Out,28,508
20,February,2011,VIRGIN MEDIA PYMTS,Bills,37,471
21,February,2011,South West Trains,Transport,36,435
22,February,2011,Starbucks Coffee,Eating Out,2,433
22,February,2011,Pret A Manger,Eating Out,4,429
23,February,2011,Costa Coffee,Eating Out,2,427
24,February,2011,O2,Bills,34,393
24,February,2011,Starbucks Coffee,Eating Out,2,391
24,February,2011,Chicken Cottage,Eating Out,7,384
25,February,2011,Morrisons,Groceries,63,321
26,February,2011,Scott's Restaurant,Eating Out,59,262
28,February,2011,South West Trains,Transport,34,228
28,February,2011,Pret A Manger,Eating Out,6,222
1,March,2011,Rhino Sports salary,General,1700,1922
1,March,2011,Wild Bean Cafe,Eating Out,2,1920
1,March,2011,The West Cornwall Pasty Company,Eating Out,7,1913
1,March,2011,ATM Cash Withdrawal,General,30,1883
2,March,2011,Starbucks Coffee,Eating Out,2,1881
3,March,2011,Starbucks Coffee,Eating Out,2,1879
3,March,2011,ATM Cash Withdrawal,General,90,1789
4,March,2011,Tescos,Groceries,46,1743
4,March,2011,Wild Bean Cafe,Eating Out,2,1741
7,March,2011,Cubit and West rent,Rent,660,1081
7,March,2011,South West Trains,Transport,36,1045
7,March,2011,Starbucks Coffee,Eating Out,2,1043
7,March,2011,The West Cornwall Pasty Company,Eating Out,7,1036
8,March,2011,Costa Coffee,Eating Out,2,1034
8,March,2011,ATM Cash Withdrawal,General,40,994
10,March,2011,Wild Bean Cafe,Eating Out,1,993
11,March,2011,ASDA,Groceries,89,904
11,March,2011,Costa Coffee,Eating Out,2,902
12,March,2011,ATM Cash Withdrawal,General,60,842
14,March,2011,South West Trains,Transport,35,807
14,March,2011,Costa Coffee,Eating Out,2,805
14,March,2011,The West Cornwall Pasty Company,Eating Out,8,797
15,March,2011,BRGAS-Electricity,Bills,24,773
15,March,2011,BRGAS-Gas,Bills,41,732
15,March,2011,Costa Coffee,Eating Out,2,730
15,March,2011,The West Cornwall Pasty Company,Eating Out,6,724
16,March,2011,LBS Council Tax,Bills,50,674
16,March,2011,Wild Bean Cafe,Eating Out,1,673
16,March,2011,Subway,Eating Out,8,665
17,March,2011,Caffe Nero,Eating Out,2,663
18,March,2011,Morrisons,Groceries,63,600
18,March,2011,Costa Coffee,Eating Out,1,599
18,March,2011,Subway,Eating Out,8,591
19,March,2011,Restaurant Gordon RamsayPortland Restaurant,Eating Out,41,550
20,March,2011,VIRGIN MEDIA PYMTS,Bills,54,496
21,March,2011,South West Trains,Transport,37,459
21,March,2011,Caffe Nero,Eating Out,1,458
23,March,2011,Costa Coffee,Eating Out,2,456
24,March,2011,O2,Bills,36,420
24,March,2011,Wild Bean Cafe,Eating Out,2,418
24,March,2011,Pret A Manger,Eating Out,8,410
25,March,2011,Morrisons,Groceries,53,357
25,March,2011,Starbucks Coffee,Eating Out,1,356
26,March,2011,Pizza Express,Eating Out,43,313
28,March,2011,South West Trains,Transport,36,277
28,March,2011,Costa Coffee,Eating Out,2,275
28,March,2011,McDonalds,Eating Out,6,269
29,March,2011,Starbucks Coffee,Eating Out,2,267
30,March,2011,Caffe Nero,Eating Out,1,266
31,March,2011,McDonalds,Eating Out,5,261
1,April,2011,Rhino Sports salary,General,1700,1961
1,April,2011,ASDA,Groceries,55,1906
1,April,2011,Wild Bean Cafe,Eating Out,1,1905
1,April,2011,Subway,Eating Out,4,1901
1,April,2011,Restaurant Gordon RamsayPortland Restaurant,Eating Out,35,1866
4,April,2011,South West Trains,Transport,37,1829
4,April,2011,Wild Bean Cafe,Eating Out,2,1827
4,April,2011,Subway,Eating Out,7,1820
5,April,2011,Costa Coffee,Eating Out,1,1819
5,April,2011,McDonalds,Eating Out,7,1812
6,April,2011,Subway,Eating Out,6,1806
7,April,2011,Cubit and West rent,Rent,660,1146
7,April,2011,Starbucks Coffee,Eating Out,2,1144
7,April,2011,McDonalds,Eating Out,5,1139
8,April,2011,Morrisons,Groceries,48,1091
8,April,2011,The West Cornwall Pasty Company,Eating Out,6,1085
9,April,2011,Scott's Restaurant,Eating Out,33,1052
11,April,2011,South West Trains,Transport,32,1020
11,April,2011,Wild Bean Cafe,Eating Out,2,1018
11,April,2011,Subway,Eating Out,7,1011
12,April,2011,Caffe Nero,Eating Out,2,1009
13,April,2011,Wild Bean Cafe,Eating Out,1,1008
13,April,2011,Subway,Eating Out,8,1000
14,April,2011,The West Cornwall Pasty Company,Eating Out,4,996
15,April,2011,BRGAS-Electricity,Bills,30,966
15,April,2011,BRGAS-Gas,Bills,22,944
15,April,2011,Waitrose,Groceries,53,891
15,April,2011,Costa Coffee,Eating Out,2,889
16,April,2011,LBS Council Tax,Bills,50,839
18,April,2011,South West Trains,Transport,25,814
18,April,2011,Chicken Cottage,Eating Out,8,806
19,April,2011,Chicken Cottage,Eating Out,7,799
20,April,2011,VIRGIN MEDIA PYMTS,Bills,54,745
20,April,2011,Costa Coffee,Eating Out,1,744
20,April,2011,Chicken Cottage,Eating Out,8,736
21,April,2011,Caffe Nero,Eating Out,2,734
21,April,2011,Subway,Eating Out,4,730
22,April,2011,Morrisons,Groceries,53,677
22,April,2011,Costa Coffee,Eating Out,2,675
22,April,2011,Chicken Cottage,Eating Out,4,671
24,April,2011,O2,Bills,34,637
25,April,2011,South West Trains,Transport,33,604
25,April,2011,Caffe Nero,Eating Out,1,603
25,April,2011,Chicken Cottage,Eating Out,7,596
26,April,2011,Wild Bean Cafe,Eating Out,2,594
26,April,2011,Greggs,Eating Out,6,588
27,April,2011,Costa Coffee,Eating Out,2,586
27,April,2011,McDonalds,Eating Out,6,580
28,April,2011,Starbucks Coffee,Eating Out,1,579
28,April,2011,McDonalds,Eating Out,6,573
29,April,2011,ASDA,Groceries,45,528
29,April,2011,Subway,Eating Out,5,523
29,April,2011,Anglo restaurant,Eating Out,40,483
29,April,2011,ATM Cash Withdrawal,General,80,403
1,May,2011,Rhino Sports salary,General,1700,2103
2,May,2011,South West Trains,Transport,31,2072
2,May,2011,Costa Coffee,Eating Out,1,2071
2,May,2011,The West Cornwall Pasty Company,Eating Out,8,2063
3,May,2011,Caffe Nero,Eating Out,2,2061
4,May,2011,Costa Coffee,Eating Out,2,2059
4,May,2011,Pret A Manger,Eating Out,7,2052
5,May,2011,Costa Coffee,Eating Out,1,2051
6,May,2011,Morrisons,Groceries,79,1972
6,May,2011,Caffe Nero,Eating Out,2,1970
6,May,2011,McDonalds,Eating Out,4,1966
6,May,2011,Anglo restaurant,Eating Out,49,1917
7,May,2011,Cubit and West rent,Rent,660,1257
9,May,2011,South West Trains,Transport,35,1222
9,May,2011,McDonalds,Eating Out,4,1218
10,May,2011,The West Cornwall Pasty Company,Eating Out,4,1214
11,May,2011,Costa Coffee,Eating Out,1,1213
11,May,2011,Chicken Cottage,Eating Out,7,1206
12,May,2011,Wild Bean Cafe,Eating Out,2,1204
13,May,2011,Waitrose,Groceries,59,1145
13,May,2011,Starbucks Coffee,Eating Out,1,1144
13,May,2011,The West Cornwall Pasty Company,Eating Out,7,1137
14,May,2011,Anglo restaurant,Eating Out,47,1090
15,May,2011,BRGAS-Electricity,Bills,35,1055
15,May,2011,BRGAS-Gas,Bills,38,1017
16,May,2011,LBS Council Tax,Bills,50,967
16,May,2011,South West Trains,Transport,26,941
16,May,2011,Wild Bean Cafe,Eating Out,1,940
17,May,2011,Caffe Nero,Eating Out,1,939
17,May,2011,Pret A Manger,Eating Out,8,931
18,May,2011,Costa Coffee,Eating Out,2,929
19,May,2011,Starbucks Coffee,Eating Out,2,927
19,May,2011,Chicken Cottage,Eating Out,4,923
20,May,2011,VIRGIN MEDIA PYMTS,Bills,28,895
20,May,2011,ASDA,Groceries,77,818
20,May,2011,Pret A Manger,Eating Out,7,811
23,May,2011,South West Trains,Transport,27,784
23,May,2011,Caffe Nero,Eating Out,2,782
23,May,2011,Subway,Eating Out,6,776
24,May,2011,O2,Bills,31,745
24,May,2011,Subway,Eating Out,7,738
25,May,2011,Starbucks Coffee,Eating Out,1,737
25,May,2011,Greggs,Eating Out,8,729
26,May,2011,Caffe Nero,Eating Out,1,728
26,May,2011,Subway,Eating Out,7,721
27,May,2011,Sainsburys,Groceries,56,665
27,May,2011,Costa Coffee,Eating Out,1,664
27,May,2011,McDonalds,Eating Out,6,658
30,May,2011,South West Trains,Transport,32,626
30,May,2011,Starbucks Coffee,Eating Out,2,624
30,May,2011,Greggs,Eating Out,4,620
31,May,2011,Subway,Eating Out,5,615
1,June,2011,Rhino Sports salary,General,1700,2315
1,June,2011,The West Cornwall Pasty Company,Eating Out,7,2308
2,June,2011,The West Cornwall Pasty Company,Eating Out,4,2304
3,June,2011,Morrisons,Groceries,59,2245
3,June,2011,Costa Coffee,Eating Out,2,2243
3,June,2011,The West Cornwall Pasty Company,Eating Out,8,2235
4,June,2011,Dominos Pizza,Eating Out,37,2198
6,June,2011,South West Trains,Transport,33,2165
6,June,2011,Wild Bean Cafe,Eating Out,2,2163
7,June,2011,Cubit and West rent,Rent,660,1503
7,June,2011,Wild Bean Cafe,Eating Out,2,1501
8,June,2011,Caffe Nero,Eating Out,2,1499
8,June,2011,The West Cornwall Pasty Company,Eating Out,4,1495
9,June,2011,Starbucks Coffee,Eating Out,1,1494
9,June,2011,Chicken Cottage,Eating Out,5,1489
10,June,2011,Waitrose,Groceries,65,1424
10,June,2011,Costa Coffee,Eating Out,2,1422
10,June,2011,McDonalds,Eating Out,4,1418
13,June,2011,South West Trains,Transport,29,1389
13,June,2011,Starbucks Coffee,Eating Out,2,1387
13,June,2011,Pret A Manger,Eating Out,4,1383
14,June,2011,Costa Coffee,Eating Out,2,1381
14,June,2011,Subway,Eating Out,6,1375
15,June,2011,BRGAS-Electricity,Bills,31,1344
15,June,2011,BRGAS-Gas,Bills,25,1319
15,June,2011,Caffe Nero,Eating Out,2,1317
16,June,2011,LBS Council Tax,Bills,50,1267
16,June,2011,Costa Coffee,Eating Out,1,1266
17,June,2011,ASDA,Groceries,48,1218
17,June,2011,Caffe Nero,Eating Out,2,1216
19,June,2011,Scott's Restaurant,Eating Out,57,1159
20,June,2011,VIRGIN MEDIA PYMTS,Bills,51,1108
20,June,2011,South West Trains,Transport,38,1070
21,June,2011,Caffe Nero,Eating Out,1,1069
21,June,2011,The West Cornwall Pasty Company,Eating Out,7,1062
22,June,2011,Caffe Nero,Eating Out,2,1060
22,June,2011,Chicken Cottage,Eating Out,5,1055
23,June,2011,Costa Coffee,Eating Out,2,1053
23,June,2011,The West Cornwall Pasty Company,Eating Out,6,1047
24,June,2011,O2,Bills,33,1014
24,June,2011,Morrisons,Groceries,76,938
24,June,2011,Costa Coffee,Eating Out,1,937
24,June,2011,Greggs,Eating Out,8,929
24,June,2011,Scott's Restaurant,Eating Out,35,894
27,June,2011,South West Trains,Transport,33,861
27,June,2011,Starbucks Coffee,Eating Out,1,860
28,June,2011,Caffe Nero,Eating Out,2,858
28,June,2011,Chicken Cottage,Eating Out,5,853
29,June,2011,Caffe Nero,Eating Out,1,852
29,June,2011,Chicken Cottage,Eating Out,5,847
30,June,2011,Subway,Eating Out,7,840
30,June,2011,ATM Cash Withdrawal,General,20,820
1,July,2011,Rhino Sports salary,General,1700,2520
1,July,2011,Morrisons,Groceries,48,2472
1,July,2011,Costa Coffee,Eating Out,2,2470
3,July,2011,Dominos Pizza,Eating Out,32,2438
4,July,2011,South West Trains,Transport,35,2403
4,July,2011,Caffe Nero,Eating Out,2,2401
4,July,2011,Subway,Eating Out,4,2397
5,July,2011,Chicken Cottage,Eating Out,8,2389
6,July,2011,Caffe Nero,Eating Out,1,2388
6,July,2011,McDonalds,Eating Out,5,2383
7,July,2011,Cubit and West rent,Rent,660,1723
7,July,2011,Caffe Nero,Eating Out,2,1721
7,July,2011,Greggs,Eating Out,4,1717
8,July,2011,Waitrose,Groceries,58,1659
8,July,2011,Wild Bean Cafe,Eating Out,1,1658
8,July,2011,Pizza Express,Eating Out,55,1603
8,July,2011,ATM Cash Withdrawal,General,30,1573
10,July,2011,ATM Cash Withdrawal,General,40,1533
11,July,2011,South West Trains,Transport,27,1506
11,July,2011,Caffe Nero,Eating Out,1,1505
11,July,2011,The West Cornwall Pasty Company,Eating Out,7,1498
12,July,2011,Costa Coffee,Eating Out,1,1497
12,July,2011,McDonalds,Eating Out,6,1491
13,July,2011,Starbucks Coffee,Eating Out,2,1489
13,July,2011,ATM Cash Withdrawal,General,90,1399
14,July,2011,Pret A Manger,Eating Out,6,1393
15,July,2011,BRGAS-Electricity,Bills,41,1352
15,July,2011,BRGAS-Gas,Bills,21,1331
15,July,2011,Waitrose,Groceries,57,1274
15,July,2011,Costa Coffee,Eating Out,2,1272
15,July,2011,Pret A Manger,Eating Out,5,1267
16,July,2011,LBS Council Tax,Bills,50,1217
18,July,2011,South West Trains,Transport,32,1185
18,July,2011,Wild Bean Cafe,Eating Out,2,1183
18,July,2011,Subway,Eating Out,4,1179
19,July,2011,Starbucks Coffee,Eating Out,1,1178
19,July,2011,Chicken Cottage,Eating Out,8,1170
20,July,2011,VIRGIN MEDIA PYMTS,Bills,43,1127
20,July,2011,Caffe Nero,Eating Out,2,1125
20,July,2011,McDonalds,Eating Out,5,1120
21,July,2011,Caffe Nero,Eating Out,2,1118
22,July,2011,Tescos,Groceries,69,1049
22,July,2011,Costa Coffee,Eating Out,2,1047
22,July,2011,Subway,Eating Out,6,1041
24,July,2011,O2,Bills,35,1006
25,July,2011,South West Trains,Transport,26,980
25,July,2011,Costa Coffee,Eating Out,2,978
25,July,2011,The West Cornwall Pasty Company,Eating Out,5,973
26,July,2011,Starbucks Coffee,Eating Out,1,972
26,July,2011,The West Cornwall Pasty Company,Eating Out,7,965
27,July,2011,Costa Coffee,Eating Out,1,964
28,July,2011,Wild Bean Cafe,Eating Out,2,962
28,July,2011,Chicken Cottage,Eating Out,5,957
29,July,2011,Waitrose,Groceries,70,887
29,July,2011,ATM Cash Withdrawal,General,70,817
29,July,2011,British Airways,General,154,663
1,August,2011,Rhino Sports salary,General,1700,2363
1,August,2011,South West Trains,Transport,28,2335
1,August,2011,McDonalds,Eating Out,7,2328
2,August,2011,Starbucks Coffee,Eating Out,1,2327
3,August,2011,Starbucks Coffee,Eating Out,2,2325
3,August,2011,The West Cornwall Pasty Company,Eating Out,8,2317
4,August,2011,Starbucks Coffee,Eating Out,1,2316
5,August,2011,Waitrose,Groceries,65,2251
5,August,2011,Starbucks Coffee,Eating Out,1,2250
6,August,2011,Scott's Restaurant,Eating Out,55,2195
6,August,2011,ATM Cash Withdrawal,General,90,2105
7,August,2011,Cubit and West rent,Rent,660,1445
8,August,2011,South West Trains,Transport,25,1420
8,August,2011,Chicken Cottage,Eating Out,4,1416
8,August,2011,ATM Cash Withdrawal,General,70,1346
9,August,2011,Costa Coffee,Eating Out,1,1345
9,August,2011,Pret A Manger,Eating Out,4,1341
10,August,2011,Caffe Nero,Eating Out,1,1340
10,August,2011,Pret A Manger,Eating Out,6,1334
11,August,2011,Starbucks Coffee,Eating Out,2,1332
11,August,2011,Subway,Eating Out,4,1328
12,August,2011,Sainsburys,Groceries,86,1242
12,August,2011,ATM Cash Withdrawal,General,30,1212
15,August,2011,BRGAS-Electricity,Bills,21,1191
15,August,2011,BRGAS-Gas,Bills,21,1170
15,August,2011,South West Trains,Transport,36,1134
15,August,2011,Costa Coffee,Eating Out,2,1132
15,August,2011,McDonalds,Eating Out,4,1128
16,August,2011,LBS Council Tax,Bills,50,1078
16,August,2011,Starbucks Coffee,Eating Out,2,1076
16,August,2011,ATM Cash Withdrawal,General,60,1016
17,August,2011,Caffe Nero,Eating Out,2,1014
17,August,2011,Subway,Eating Out,4,1010
18,August,2011,Wild Bean Cafe,Eating Out,1,1009
18,August,2011,McDonalds,Eating Out,7,1002
19,August,2011,Tescos,Groceries,88,914
19,August,2011,Wild Bean Cafe,Eating Out,2,912
19,August,2011,Greggs,Eating Out,5,907
20,August,2011,VIRGIN MEDIA PYMTS,Bills,44,863
21,August,2011,Dominos Pizza,Eating Out,30,833
22,August,2011,South West Trains,Transport,37,796
22,August,2011,Starbucks Coffee,Eating Out,1,795
22,August,2011,Greggs,Eating Out,5,790
23,August,2011,Caffe Nero,Eating Out,2,788
24,August,2011,O2,Bills,37,751
24,August,2011,Costa Coffee,Eating Out,2,749
25,August,2011,Wild Bean Cafe,Eating Out,1,748
26,August,2011,Sainsburys,Groceries,52,696
26,August,2011,Caffe Nero,Eating Out,2,694
26,August,2011,Pret A Manger,Eating Out,6,688
26,August,2011,ATM Cash Withdrawal,General,80,608
29,August,2011,South West Trains,Transport,25,583
29,August,2011,Costa Coffee,Eating Out,1,582
30,August,2011,Costa Coffee,Eating Out,2,580
30,August,2011,Chicken Cottage,Eating Out,8,572
1,September,2011,Rhino Sports salary,General,1700,2272
1,September,2011,Starbucks Coffee,Eating Out,1,2271
1,September,2011,Pret A Manger,Eating Out,6,2265
2,September,2011,Sainsburys,Groceries,88,2177
2,September,2011,Pret A Manger,Eating Out,4,2173
5,September,2011,South West Trains,Transport,29,2144
5,September,2011,Starbucks Coffee,Eating Out,2,2142
5,September,2011,Pret A Manger,Eating Out,8,2134
6,September,2011,Wild Bean Cafe,Eating Out,1,2133
6,September,2011,Chicken Cottage,Eating Out,5,2128
7,September,2011,Cubit and West rent,Rent,660,1468
8,September,2011,Caffe Nero,Eating Out,2,1466
8,September,2011,Pret A Manger,Eating Out,6,1460
9,September,2011,Tescos,Groceries,42,1418
9,September,2011,Caffe Nero,Eating Out,2,1416
9,September,2011,Greggs,Eating Out,7,1409
12,September,2011,South West Trains,Transport,25,1384
13,September,2011,Starbucks Coffee,Eating Out,1,1383
13,September,2011,Pret A Manger,Eating Out,4,1379
14,September,2011,Costa Coffee,Eating Out,1,1378
14,September,2011,McDonalds,Eating Out,8,1370
15,September,2011,BRGAS-Electricity,Bills,21,1349
15,September,2011,BRGAS-Gas,Bills,37,1312
15,September,2011,Costa Coffee,Eating Out,1,1311
15,September,2011,Chicken Cottage,Eating Out,5,1306
16,September,2011,LBS Council Tax,Bills,50,1256
16,September,2011,Tescos,Groceries,50,1206
16,September,2011,Costa Coffee,Eating Out,2,1204
16,September,2011,Pret A Manger,Eating Out,6,1198
19,September,2011,South West Trains,Transport,32,1166
19,September,2011,Subway,Eating Out,5,1161
20,September,2011,VIRGIN MEDIA PYMTS,Bills,35,1126
20,September,2011,Starbucks Coffee,Eating Out,1,1125
20,September,2011,Subway,Eating Out,7,1118
21,September,2011,The West Cornwall Pasty Company,Eating Out,5,1113
22,September,2011,Starbucks Coffee,Eating Out,2,1111
22,September,2011,McDonalds,Eating Out,7,1104
23,September,2011,ASDA,Groceries,61,1043
23,September,2011,Caffe Nero,Eating Out,1,1042
23,September,2011,McDonalds,Eating Out,6,1036
24,September,2011,O2,Bills,30,1006
25,September,2011,Dominos Pizza,Eating Out,58,948
26,September,2011,South West Trains,Transport,27,921
27,September,2011,Wild Bean Cafe,Eating Out,1,920
28,September,2011,Caffe Nero,Eating Out,1,919
29,September,2011,Costa Coffee,Eating Out,2,917
29,September,2011,Greggs,Eating Out,6,911
30,September,2011,Tescos,Groceries,48,863
30,September,2011,Starbucks Coffee,Eating Out,2,861
30,September,2011,McDonalds,Eating Out,8,853
30,September,2011,Dominos Pizza,Eating Out,26,827
1,October,2011,Rhino Sports salary,General,1700,2527
3,October,2011,South West Trains,Transport,34,2493
3,October,2011,Caffe Nero,Eating Out,2,2491
3,October,2011,Chicken Cottage,Eating Out,7,2484
4,October,2011,Wild Bean Cafe,Eating Out,2,2482
4,October,2011,Chicken Cottage,Eating Out,6,2476
5,October,2011,Costa Coffee,Eating Out,1,2475
5,October,2011,The West Cornwall Pasty Company,Eating Out,8,2467
5,October,2011,ATM Cash Withdrawal,General,30,2437
6,October,2011,Wild Bean Cafe,Eating Out,1,2436
6,October,2011,Greggs,Eating Out,6,2430
7,October,2011,Cubit and West rent,Rent,660,1770
7,October,2011,Tescos,Groceries,62,1708
7,October,2011,Starbucks Coffee,Eating Out,2,1706
7,October,2011,McDonalds,Eating Out,8,1698
7,October,2011,ATM Cash Withdrawal,General,40,1658
8,October,2011,ATM Cash Withdrawal,General,70,1588
10,October,2011,South West Trains,Transport,27,1561
10,October,2011,Caffe Nero,Eating Out,2,1559
11,October,2011,McDonalds,Eating Out,8,1551
12,October,2011,Wild Bean Cafe,Eating Out,2,1549
12,October,2011,McDonalds,Eating Out,4,1545
13,October,2011,Wild Bean Cafe,Eating Out,1,1544
13,October,2011,McDonalds,Eating Out,5,1539
14,October,2011,Waitrose,Groceries,78,1461
14,October,2011,Caffe Nero,Eating Out,2,1459
14,October,2011,The West Cornwall Pasty Company,Eating Out,4,1455
14,October,2011,Scott's Restaurant,Eating Out,47,1408
15,October,2011,BRGAS-Electricity,Bills,35,1373
15,October,2011,BRGAS-Gas,Bills,39,1334
16,October,2011,LBS Council Tax,Bills,50,1284
17,October,2011,South West Trains,Transport,32,1252
17,October,2011,McDonalds,Eating Out,7,1245
18,October,2011,McDonalds,Eating Out,8,1237
19,October,2011,Starbucks Coffee,Eating Out,1,1236
20,October,2011,VIRGIN MEDIA PYMTS,Bills,28,1208
20,October,2011,Costa Coffee,Eating Out,2,1206
20,October,2011,McDonalds,Eating Out,8,1198
21,October,2011,Morrisons,Groceries,74,1124
21,October,2011,Costa Coffee,Eating Out,2,1122
23,October,2011,Restaurant Gordon RamsayPortland Restaurant,Eating Out,55,1067
23,October,2011,ATM Cash Withdrawal,General,80,987
24,October,2011,O2,Bills,36,951
24,October,2011,South West Trains,Transport,35,916
24,October,2011,Starbucks Coffee,Eating Out,1,915
24,October,2011,Subway,Eating Out,7,908
25,October,2011,McDonalds,Eating Out,8,900
26,October,2011,Subway,Eating Out,7,893
27,October,2011,McDonalds,Eating Out,4,889
28,October,2011,Waitrose,Groceries,79,810
28,October,2011,Costa Coffee,Eating Out,2,808
31,October,2011,South West Trains,Transport,36,772
31,October,2011,Caffe Nero,Eating Out,2,770
1,November,2011,Rhino Sports salary,General,1700,2470
1,November,2011,Caffe Nero,Eating Out,1,2469
1,November,2011,Greggs,Eating Out,5,2464
2,November,2011,Caffe Nero,Eating Out,2,2462
2,November,2011,Subway,Eating Out,4,2458
3,November,2011,Costa Coffee,Eating Out,1,2457
3,November,2011,The West Cornwall Pasty Company,Eating Out,5,2452
4,November,2011,Morrisons,Groceries,61,2391
4,November,2011,Caffe Nero,Eating Out,2,2389
4,November,2011,Pret A Manger,Eating Out,8,2381
6,November,2011,ATM Cash Withdrawal,General,90,2291
7,November,2011,Cubit and West rent,Rent,660,1631
7,November,2011,South West Trains,Transport,37,1594
7,November,2011,Wild Bean Cafe,Eating Out,1,1593
7,November,2011,McDonalds,Eating Out,5,1588
8,November,2011,Costa Coffee,Eating Out,1,1587
9,November,2011,Starbucks Coffee,Eating Out,2,1585
9,November,2011,McDonalds,Eating Out,4,1581
10,November,2011,Wild Bean Cafe,Eating Out,2,1579
10,November,2011,Chicken Cottage,Eating Out,4,1575
10,November,2011,ATM Cash Withdrawal,General,80,1495
11,November,2011,Tescos,Groceries,79,1416
11,November,2011,Wild Bean Cafe,Eating Out,2,1414
11,November,2011,The West Cornwall Pasty Company,Eating Out,8,1406
12,November,2011,Heaven Club,Eating Out,13,1393
14,November,2011,South West Trains,Transport,38,1355
14,November,2011,Starbucks Coffee,Eating Out,1,1354
14,November,2011,McDonalds,Eating Out,5,1349
15,November,2011,BRGAS-Electricity,Bills,66,1283
15,November,2011,BRGAS-Gas,Bills,78,1205
15,November,2011,Wild Bean Cafe,Eating Out,1,1204
15,November,2011,Subway,Eating Out,5,1199
16,November,2011,LBS Council Tax,Bills,50,1149
16,November,2011,Caffe Nero,Eating Out,2,1147
16,November,2011,Chicken Cottage,Eating Out,7,1140
17,November,2011,Costa Coffee,Eating Out,2,1138
17,November,2011,McDonalds,Eating Out,5,1133
18,November,2011,Tescos,Groceries,72,1061
18,November,2011,Starbucks Coffee,Eating Out,2,1059
18,November,2011,Chicken Cottage,Eating Out,4,1055
19,November,2011,Anglo restaurant,Eating Out,52,1003
20,November,2011,VIRGIN MEDIA PYMTS,Bills,58,945
20,November,2011,Dominos Pizza,Eating Out,34,911
21,November,2011,South West Trains,Transport,36,875
21,November,2011,Wild Bean Cafe,Eating Out,2,873
21,November,2011,Pret A Manger,Eating Out,8,865
22,November,2011,Caffe Nero,Eating Out,1,864
22,November,2011,Subway,Eating Out,4,860
23,November,2011,Caffe Nero,Eating Out,2,858
23,November,2011,Greggs,Eating Out,6,852
24,November,2011,O2,Bills,35,817
24,November,2011,Caffe Nero,Eating Out,2,815
24,November,2011,McDonalds,Eating Out,6,809
25,November,2011,Sainsburys,Groceries,83,726
25,November,2011,Caffe Nero,Eating Out,2,724
28,November,2011,South West Trains,Transport,38,686
28,November,2011,Wild Bean Cafe,Eating Out,1,685
28,November,2011,Pret A Manger,Eating Out,8,677
1,December,2011,Rhino Sports salary,General,1700,2377
1,December,2011,Wild Bean Cafe,Eating Out,1,2376
2,December,2011,Sainsburys,Groceries,53,2323
3,December,2011,ATM Cash Withdrawal,General,60,2263
5,December,2011,South West Trains,Transport,32,2231
5,December,2011,McDonalds,Eating Out,8,2223
6,December,2011,Costa Coffee,Eating Out,1,2222
6,December,2011,Chicken Cottage,Eating Out,7,2215
7,December,2011,Cubit and West rent,Rent,660,1555
7,December,2011,Wild Bean Cafe,Eating Out,1,1554
7,December,2011,McDonalds,Eating Out,5,1549
8,December,2011,Caffe Nero,Eating Out,1,1548
8,December,2011,Subway,Eating Out,6,1542
9,December,2011,Sainsburys,Groceries,83,1459
9,December,2011,Costa Coffee,Eating Out,1,1458
12,December,2011,South West Trains,Transport,34,1424
12,December,2011,The West Cornwall Pasty Company,Eating Out,5,1419
13,December,2011,Costa Coffee,Eating Out,2,1417
13,December,2011,Pret A Manger,Eating Out,5,1412
14,December,2011,Costa Coffee,Eating Out,2,1410
15,December,2011,BRGAS-Electricity,Bills,31,1379
15,December,2011,BRGAS-Gas,Bills,36,1343
15,December,2011,Starbucks Coffee,Eating Out,1,1342
15,December,2011,Subway,Eating Out,7,1335
16,December,2011,LBS Council Tax,Bills,50,1285
16,December,2011,Waitrose,Groceries,59,1226
16,December,2011,Costa Coffee,Eating Out,2,1224
16,December,2011,Pret A Manger,Eating Out,5,1219
17,December,2011,Pizza Express,Eating Out,55,1164
18,December,2011,ATM Cash Withdrawal,General,70,1094
19,December,2011,South West Trains,Transport,27,1067
19,December,2011,Caffe Nero,Eating Out,2,1065
19,December,2011,Pret A Manger,Eating Out,4,1061
20,December,2011,VIRGIN MEDIA PYMTS,Bills,39,1022
20,December,2011,Caffe Nero,Eating Out,1,1021
20,December,2011,Greggs,Eating Out,5,1016
21,December,2011,Caffe Nero,Eating Out,2,1014
21,December,2011,Subway,Eating Out,7,1007
22,December,2011,Starbucks Coffee,Eating Out,2,1005
23,December,2011,Sainsburys,Groceries,86,919
23,December,2011,Wild Bean Cafe,Eating Out,2,917
23,December,2011,The West Cornwall Pasty Company,Eating Out,7,910
24,December,2011,O2,Bills,36,874
26,December,2011,South West Trains,Transport,32,842
26,December,2011,Wild Bean Cafe,Eating Out,2,840
26,December,2011,Chicken Cottage,Eating Out,8,832
27,December,2011,Wild Bean Cafe,Eating Out,2,830
27,December,2011,Subway,Eating Out,8,822
28,December,2011,Costa Coffee,Eating Out,2,820
29,December,2011,Starbucks Coffee,Eating Out,2,818
29,December,2011,Chicken Cottage,Eating Out,7,811
30,December,2011,Sainsburys,Groceries,62,749
30,December,2011,Costa Coffee,Eating Out,1,748
30,December,2011,Anglo restaurant,Eating Out,35,713
31,December,2011,Scott's Restaurant,Eating Out,57,656
1,January,2012,Rhino Sports salary,General,1700,2356
2,January,2012,South West Trains,Transport,33,2323
2,January,2012,Greggs,Eating Out,7,2316
2,January,2012,ATM Cash Withdrawal,General,80,2236
4,January,2012,Wild Bean Cafe,Eating Out,2,2234
4,January,2012,Chicken Cottage,Eating Out,6,2228
5,January,2012,Chicken Cottage,Eating Out,6,2222
6,January,2012,Morrisons,Groceries,76,2146
6,January,2012,Starbucks Coffee,Eating Out,2,2144
7,January,2012,Cubit and West rent,Rent,660,1484
8,January,2012,Pizza Express,Eating Out,54,1430
9,January,2012,South West Trains,Transport,32,1398
9,January,2012,Caffe Nero,Eating Out,2,1396
9,January,2012,Greggs,Eating Out,6,1390
11,January,2012,Starbucks Coffee,Eating Out,2,1388
11,January,2012,Chicken Cottage,Eating Out,7,1381
13,January,2012,ASDA,Groceries,88,1293
13,January,2012,The West Cornwall Pasty Company,Eating Out,7,1286
13,January,2012,Pizza Express,Eating Out,25,1261
15,January,2012,BRGAS-Electricity,Bills,53,1208
15,January,2012,BRGAS-Gas,Bills,62,1146
16,January,2012,LBS Council Tax,Bills,50,1096
16,January,2012,South West Trains,Transport,26,1070
16,January,2012,Costa Coffee,Eating Out,2,1068
17,January,2012,Caffe Nero,Eating Out,2,1066
18,January,2012,Caffe Nero,Eating Out,2,1064
19,January,2012,The West Cornwall Pasty Company,Eating Out,4,1060
20,January,2012,VIRGIN MEDIA PYMTS,Bills,57,1003
20,January,2012,Sainsburys,Groceries,57,946
20,January,2012,Costa Coffee,Eating Out,2,944
20,January,2012,The West Cornwall Pasty Company,Eating Out,7,937
23,January,2012,South West Trains,Transport,25,912
23,January,2012,Caffe Nero,Eating Out,2,910
23,January,2012,McDonalds,Eating Out,5,905
23,January,2012,ATM Cash Withdrawal,General,20,885
24,January,2012,O2,Bills,36,849
24,January,2012,Wild Bean Cafe,Eating Out,2,847
25,January,2012,Starbucks Coffee,Eating Out,1,846
25,January,2012,The West Cornwall Pasty Company,Eating Out,5,841
25,January,2012,ATM Cash Withdrawal,General,30,811
26,January,2012,Costa Coffee,Eating Out,2,809
26,January,2012,McDonalds,Eating Out,5,804
26,January,2012,ATM Cash Withdrawal,General,90,714
27,January,2012,Waitrose,Groceries,49,665
27,January,2012,Caffe Nero,Eating Out,2,663
27,January,2012,Restaurant Gordon RamsayPortland Restaurant,Eating Out,46,617
30,January,2012,South West Trains,Transport,36,581
30,January,2012,Starbucks Coffee,Eating Out,2,579
31,January,2012,Starbucks Coffee,Eating Out,1,578
31,January,2012,Greggs,Eating Out,4,574
1,February,2012,Rhino Sports salary,General,1700,2274
1,February,2012,Wild Bean Cafe,Eating Out,1,2273
1,February,2012,Greggs,Eating Out,6,2267
2,February,2012,Costa Coffee,Eating Out,1,2266
2,February,2012,Chicken Cottage,Eating Out,7,2259
3,February,2012,Waitrose,Groceries,62,2197
3,February,2012,Costa Coffee,Eating Out,2,2195
3,February,2012,Dominos Pizza,Eating Out,49,2146
6,February,2012,South West Trains,Transport,29,2117
6,February,2012,Caffe Nero,Eating Out,2,2115
6,February,2012,McDonalds,Eating Out,5,2110
7,February,2012,Cubit and West rent,Rent,660,1450
7,February,2012,Wild Bean Cafe,Eating Out,2,1448
8,February,2012,The West Cornwall Pasty Company,Eating Out,8,1440
9,February,2012,Starbucks Coffee,Eating Out,2,1438
10,February,2012,Sainsburys,Groceries,89,1349
10,February,2012,Caffe Nero,Eating Out,2,1347
10,February,2012,McDonalds,Eating Out,7,1340
10,February,2012,Anglo restaurant,Eating Out,48,1292
13,February,2012,South West Trains,Transport,37,1255
13,February,2012,Costa Coffee,Eating Out,2,1253
14,February,2012,The West Cornwall Pasty Company,Eating Out,8,1245
15,February,2012,BRGAS-Electricity,Bills,30,1215
15,February,2012,BRGAS-Gas,Bills,41,1174
15,February,2012,Caffe Nero,Eating Out,1,1173
15,February,2012,Greggs,Eating Out,5,1168
16,February,2012,LBS Council Tax,Bills,50,1118
16,February,2012,Wild Bean Cafe,Eating Out,2,1116
16,February,2012,Pret A Manger,Eating Out,5,1111
17,February,2012,Sainsburys,Groceries,74,1037
17,February,2012,Starbucks Coffee,Eating Out,2,1035
17,February,2012,Greggs,Eating Out,5,1030
20,February,2012,VIRGIN MEDIA PYMTS,Bills,37,993
20,February,2012,South West Trains,Transport,35,958
20,February,2012,Caffe Nero,Eating Out,1,957
20,February,2012,Chicken Cottage,Eating Out,7,950
21,February,2012,Starbucks Coffee,Eating Out,2,948
21,February,2012,McDonalds,Eating Out,5,943
22,February,2012,McDonalds,Eating Out,6,937
23,February,2012,Starbucks Coffee,Eating Out,1,936
24,February,2012,O2,Bills,30,906
24,February,2012,Waitrose,Groceries,44,862
24,February,2012,Starbucks Coffee,Eating Out,1,861
24,February,2012,Greggs,Eating Out,5,856
24,February,2012,Pizza Express,Eating Out,24,832
27,February,2012,South West Trains,Transport,32,800
27,February,2012,Wild Bean Cafe,Eating Out,1,799
28,February,2012,Costa Coffee,Eating Out,2,797
28,February,2012,Subway,Eating Out,6,791
29,February,2012,Starbucks Coffee,Eating Out,2,789
1,March,2012,Rhino Sports salary,General,1700,2489
1,March,2012,Costa Coffee,Eating Out,2,2487
1,March,2012,McDonalds,Eating Out,5,2482
2,March,2012,Tescos,Groceries,89,2393
2,March,2012,Greggs,Eating Out,5,2388
4,March,2012,Anglo restaurant,Eating Out,43,2345
5,March,2012,South West Trains,Transport,34,2311
5,March,2012,Caffe Nero,Eating Out,2,2309
5,March,2012,McDonalds,Eating Out,6,2303
6,March,2012,Starbucks Coffee,Eating Out,2,2301
6,March,2012,The West Cornwall Pasty Company,Eating Out,7,2294
7,March,2012,Cubit and West rent,Rent,660,1634
7,March,2012,Subway,Eating Out,6,1628
8,March,2012,Wild Bean Cafe,Eating Out,1,1627
8,March,2012,The West Cornwall Pasty Company,Eating Out,4,1623
8,March,2012,ATM Cash Withdrawal,General,10,1613
9,March,2012,Morrisons,Groceries,73,1540
9,March,2012,Costa Coffee,Eating Out,2,1538
9,March,2012,Subway,Eating Out,6,1532
9,March,2012,Scott's Restaurant,Eating Out,34,1498
12,March,2012,South West Trains,Transport,28,1470
12,March,2012,Caffe Nero,Eating Out,1,1469
12,March,2012,The West Cornwall Pasty Company,Eating Out,5,1464
13,March,2012,Starbucks Coffee,Eating Out,2,1462
13,March,2012,Greggs,Eating Out,8,1454
14,March,2012,Chicken Cottage,Eating Out,4,1450
15,March,2012,BRGAS-Electricity,Bills,44,1406
15,March,2012,BRGAS-Gas,Bills,39,1367
15,March,2012,Caffe Nero,Eating Out,1,1366
15,March,2012,Chicken Cottage,Eating Out,7,1359
16,March,2012,LBS Council Tax,Bills,50,1309
16,March,2012,ASDA,Groceries,82,1227
16,March,2012,Chicken Cottage,Eating Out,6,1221
16,March,2012,ATM Cash Withdrawal,General,70,1151
17,March,2012,Pizza Express,Eating Out,46,1105
19,March,2012,South West Trains,Transport,31,1074
19,March,2012,Starbucks Coffee,Eating Out,2,1072
19,March,2012,McDonalds,Eating Out,7,1065
20,March,2012,VIRGIN MEDIA PYMTS,Bills,56,1009
20,March,2012,Costa Coffee,Eating Out,1,1008
20,March,2012,McDonalds,Eating Out,8,1000
21,March,2012,Caffe Nero,Eating Out,2,998
21,March,2012,McDonalds,Eating Out,6,992
22,March,2012,Costa Coffee,Eating Out,1,991
22,March,2012,The West Cornwall Pasty Company,Eating Out,7,984
23,March,2012,ASDA,Groceries,69,915
23,March,2012,Wild Bean Cafe,Eating Out,1,914
23,March,2012,Pret A Manger,Eating Out,6,908
24,March,2012,O2,Bills,35,873
26,March,2012,South West Trains,Transport,33,840
26,March,2012,Caffe Nero,Eating Out,2,838
27,March,2012,Caffe Nero,Eating Out,2,836
27,March,2012,Chicken Cottage,Eating Out,6,830
28,March,2012,Starbucks Coffee,Eating Out,1,829
29,March,2012,Caffe Nero,Eating Out,2,827
29,March,2012,Chicken Cottage,Eating Out,4,823
30,March,2012,ASDA,Groceries,69,754
30,March,2012,Wild Bean Cafe,Eating Out,1,753
30,March,2012,Greggs,Eating Out,6,747
31,March,2012,Restaurant Gordon RamsayPortland Restaurant,Eating Out,35,712
1,April,2012,Rhino Sports salary,General,1700,2412
2,April,2012,South West Trains,Transport,31,2381
2,April,2012,Costa Coffee,Eating Out,1,2380
2,April,2012,The West Cornwall Pasty Company,Eating Out,7,2373
2,April,2012,ATM Cash Withdrawal,General,50,2323
3,April,2012,Costa Coffee,Eating Out,1,2322
3,April,2012,The West Cornwall Pasty Company,Eating Out,8,2314
4,April,2012,Starbucks Coffee,Eating Out,2,2312
5,April,2012,Caffe Nero,Eating Out,1,2311
5,April,2012,The West Cornwall Pasty Company,Eating Out,5,2306
6,April,2012,Morrisons,Groceries,86,2220
6,April,2012,Chicken Cottage,Eating Out,8,2212
7,April,2012,Cubit and West rent,Rent,660,1552
7,April,2012,Dominos Pizza,Eating Out,41,1511
9,April,2012,South West Trains,Transport,33,1478
9,April,2012,Costa Coffee,Eating Out,2,1476
9,April,2012,Greggs,Eating Out,4,1472
10,April,2012,Wild Bean Cafe,Eating Out,2,1470
10,April,2012,Greggs,Eating Out,6,1464
11,April,2012,Starbucks Coffee,Eating Out,2,1462
12,April,2012,Costa Coffee,Eating Out,2,1460
12,April,2012,Chicken Cottage,Eating Out,4,1456
12,April,2012,ATM Cash Withdrawal,General,40,1416
13,April,2012,Tescos,Groceries,52,1364
13,April,2012,Costa Coffee,Eating Out,1,1363
13,April,2012,Chicken Cottage,Eating Out,6,1357
13,April,2012,Anglo restaurant,Eating Out,44,1313
13,April,2012,ATM Cash Withdrawal,General,60,1253
15,April,2012,BRGAS-Electricity,Bills,41,1212
15,April,2012,BRGAS-Gas,Bills,38,1174
16,April,2012,LBS Council Tax,Bills,50,1124
16,April,2012,South West Trains,Transport,25,1099
16,April,2012,Caffe Nero,Eating Out,1,1098
16,April,2012,Subway,Eating Out,7,1091
17,April,2012,Wild Bean Cafe,Eating Out,1,1090
18,April,2012,Starbucks Coffee,Eating Out,1,1089
18,April,2012,The West Cornwall Pasty Company,Eating Out,8,1081
18,April,2012,ATM Cash Withdrawal,General,80,1001
19,April,2012,Pret A Manger,Eating Out,5,996
20,April,2012,VIRGIN MEDIA PYMTS,Bills,42,954
20,April,2012,Sainsburys,Groceries,74,880
20,April,2012,Wild Bean Cafe,Eating Out,1,879
20,April,2012,Chicken Cottage,Eating Out,8,871
20,April,2012,ATM Cash Withdrawal,General,70,801
21,April,2012,Scott's Restaurant,Eating Out,32,769
23,April,2012,South West Trains,Transport,32,737
23,April,2012,Wild Bean Cafe,Eating Out,2,735
24,April,2012,O2,Bills,36,699
24,April,2012,Starbucks Coffee,Eating Out,1,698
24,April,2012,Greggs,Eating Out,5,693
25,April,2012,Wild Bean Cafe,Eating Out,1,692
26,April,2012,Costa Coffee,Eating Out,2,690
27,April,2012,Tescos,Groceries,70,620
27,April,2012,Caffe Nero,Eating Out,2,618
27,April,2012,Pret A Manger,Eating Out,6,612
27,April,2012,Scott's Restaurant,Eating Out,37,575
30,April,2012,South West Trains,Transport,26,549
30,April,2012,Greggs,Eating Out,5,544
1,May,2012,Rhino Sports salary,General,1700,2244
1,May,2012,Starbucks Coffee,Eating Out,2,2242
1,May,2012,The West Cornwall Pasty Company,Eating Out,7,2235
2,May,2012,Costa Coffee,Eating Out,1,2234
2,May,2012,Pret A Manger,Eating Out,5,2229
3,May,2012,Starbucks Coffee,Eating Out,2,2227
3,May,2012,ATM Cash Withdrawal,General,10,2217
4,May,2012,Sainsburys,Groceries,70,2147
4,May,2012,Costa Coffee,Eating Out,1,2146
6,May,2012,Restaurant Gordon RamsayPortland Restaurant,Eating Out,55,2091
7,May,2012,Cubit and West rent,Rent,660,1431
7,May,2012,South West Trains,Transport,36,1395
7,May,2012,Caffe Nero,Eating Out,1,1394
7,May,2012,Subway,Eating Out,7,1387
8,May,2012,Costa Coffee,Eating Out,1,1386
8,May,2012,Chicken Cottage,Eating Out,5,1381
9,May,2012,Caffe Nero,Eating Out,2,1379
10,May,2012,Starbucks Coffee,Eating Out,2,1377
11,May,2012,Waitrose,Groceries,71,1306
12,May,2012,Scott's Restaurant,Eating Out,25,1281
14,May,2012,South West Trains,Transport,36,1245
14,May,2012,Wild Bean Cafe,Eating Out,2,1243
14,May,2012,Greggs,Eating Out,6,1237
15,May,2012,BRGAS-Electricity,Bills,25,1212
15,May,2012,BRGAS-Gas,Bills,28,1184
15,May,2012,Costa Coffee,Eating Out,2,1182
15,May,2012,McDonalds,Eating Out,4,1178
16,May,2012,LBS Council Tax,Bills,50,1128
16,May,2012,Wild Bean Cafe,Eating Out,1,1127
16,May,2012,ATM Cash Withdrawal,General,20,1107
17,May,2012,Starbucks Coffee,Eating Out,1,1106
18,May,2012,Tescos,Groceries,78,1028
19,May,2012,Fabric Club,Eating Out,6,1022
19,May,2012,Fabric Club,Eating Out,14,1008
19,May,2012,Fabric Club,Eating Out,13,995
19,May,2012,Fabric Club,Eating Out,9,986
19,May,2012,Fabric Club,Eating Out,10,976
20,May,2012,VIRGIN MEDIA PYMTS,Bills,44,932
20,May,2012,Dominos Pizza,Eating Out,50,882
21,May,2012,South West Trains,Transport,31,851
21,May,2012,McDonalds,Eating Out,4,847
22,May,2012,Wild Bean Cafe,Eating Out,2,845
22,May,2012,Pret A Manger,Eating Out,5,840
23,May,2012,Wild Bean Cafe,Eating Out,1,839
23,May,2012,McDonalds,Eating Out,5,834
24,May,2012,O2,Bills,33,801
24,May,2012,Costa Coffee,Eating Out,2,799
24,May,2012,Greggs,Eating Out,8,791
25,May,2012,Sainsburys,Groceries,87,704
25,May,2012,McDonalds,Eating Out,8,696
25,May,2012,Pizza Express,Eating Out,27,669
28,May,2012,South West Trains,Transport,28,641
28,May,2012,Costa Coffee,Eating Out,2,639
28,May,2012,McDonalds,Eating Out,6,633
29,May,2012,Caffe Nero,Eating Out,1,632
30,May,2012,Wild Bean Cafe,Eating Out,1,631
30,May,2012,Subway,Eating Out,6,625
31,May,2012,Starbucks Coffee,Eating Out,2,623
1,June,2012,Rhino Sports salary,General,1700,2323
1,June,2012,Sainsburys,Groceries,47,2276
1,June,2012,Greggs,Eating Out,5,2271
4,June,2012,South West Trains,Transport,28,2243
5,June,2012,Greggs,Eating Out,4,2239
6,June,2012,Caffe Nero,Eating Out,2,2237
6,June,2012,Pret A Manger,Eating Out,8,2229
7,June,2012,Cubit and West rent,Rent,660,1569
7,June,2012,Wild Bean Cafe,Eating Out,2,1567
7,June,2012,Chicken Cottage,Eating Out,5,1562
8,June,2012,Tescos,Groceries,48,1514
8,June,2012,Wild Bean Cafe,Eating Out,2,1512
8,June,2012,Greggs,Eating Out,5,1507
10,June,2012,Dominos Pizza,Eating Out,32,1475
11,June,2012,South West Trains,Transport,38,1437
11,June,2012,Subway,Eating Out,5,1432
12,June,2012,Costa Coffee,Eating Out,2,1430
12,June,2012,McDonalds,Eating Out,6,1424
12,June,2012,ATM Cash Withdrawal,General,40,1384
13,June,2012,Greggs,Eating Out,6,1378
13,June,2012,ATM Cash Withdrawal,General,70,1308
15,June,2012,BRGAS-Electricity,Bills,35,1273
15,June,2012,BRGAS-Gas,Bills,25,1248
15,June,2012,Waitrose,Groceries,71,1177
15,June,2012,Starbucks Coffee,Eating Out,2,1175
16,June,2012,LBS Council Tax,Bills,50,1125
18,June,2012,South West Trains,Transport,34,1091
18,June,2012,Caffe Nero,Eating Out,2,1089
18,June,2012,Subway,Eating Out,6,1083
19,June,2012,Caffe Nero,Eating Out,2,1081
19,June,2012,McDonalds,Eating Out,7,1074
20,June,2012,VIRGIN MEDIA PYMTS,Bills,57,1017
20,June,2012,Starbucks Coffee,Eating Out,1,1016
21,June,2012,Wild Bean Cafe,Eating Out,2,1014
21,June,2012,The West Cornwall Pasty Company,Eating Out,7,1007
22,June,2012,Morrisons,Groceries,53,954
22,June,2012,Costa Coffee,Eating Out,2,952
22,June,2012,McDonalds,Eating Out,8,944
22,June,2012,Restaurant Gordon RamsayPortland Restaurant,Eating Out,50,894
24,June,2012,O2,Bills,33,861
25,June,2012,South West Trains,Transport,36,825
25,June,2012,Caffe Nero,Eating Out,2,823
25,June,2012,Greggs,Eating Out,5,818
26,June,2012,Starbucks Coffee,Eating Out,1,817
27,June,2012,Starbucks Coffee,Eating Out,2,815
27,June,2012,The West Cornwall Pasty Company,Eating Out,8,807
28,June,2012,Chicken Cottage,Eating Out,7,800
29,June,2012,Tescos,Groceries,65,735
29,June,2012,Caffe Nero,Eating Out,1,734
30,June,2012,ATM Cash Withdrawal,General,10,724
1,July,2012,Rhino Sports salary,General,1700,2424
1,July,2012,ATM Cash Withdrawal,General,10,2414
2,July,2012,South West Trains,Transport,27,2387
2,July,2012,The West Cornwall Pasty Company,Eating Out,8,2379
3,July,2012,Starbucks Coffee,Eating Out,1,2378
3,July,2012,The West Cornwall Pasty Company,Eating Out,6,2372
4,July,2012,Caffe Nero,Eating Out,2,2370
4,July,2012,McDonalds,Eating Out,5,2365
5,July,2012,Costa Coffee,Eating Out,2,2363
5,July,2012,Pret A Manger,Eating Out,6,2357
6,July,2012,Morrisons,Groceries,50,2307
6,July,2012,Costa Coffee,Eating Out,1,2306
6,July,2012,Pret A Manger,Eating Out,5,2301
7,July,2012,Cubit and West rent,Rent,660,1641
8,July,2012,Anglo restaurant,Eating Out,36,1605
9,July,2012,South West Trains,Transport,25,1580
9,July,2012,Caffe Nero,Eating Out,1,1579
9,July,2012,Pret A Manger,Eating Out,5,1574
10,July,2012,Wild Bean Cafe,Eating Out,2,1572
10,July,2012,Subway,Eating Out,6,1566
11,July,2012,Caffe Nero,Eating Out,2,1564
12,July,2012,Caffe Nero,Eating Out,1,1563
12,July,2012,Chicken Cottage,Eating Out,8,1555
13,July,2012,Morrisons,Groceries,48,1507
13,July,2012,Costa Coffee,Eating Out,2,1505
13,July,2012,The West Cornwall Pasty Company,Eating Out,5,1500
15,July,2012,BRGAS-Electricity,Bills,27,1473
15,July,2012,BRGAS-Gas,Bills,34,1439
16,July,2012,LBS Council Tax,Bills,50,1389
16,July,2012,South West Trains,Transport,38,1351
16,July,2012,Wild Bean Cafe,Eating Out,1,1350
17,July,2012,Wild Bean Cafe,Eating Out,2,1348
17,July,2012,McDonalds,Eating Out,4,1344
18,July,2012,Caffe Nero,Eating Out,1,1343
18,July,2012,The West Cornwall Pasty Company,Eating Out,8,1335
18,July,2012,ATM Cash Withdrawal,General,90,1245
19,July,2012,The West Cornwall Pasty Company,Eating Out,6,1239
20,July,2012,VIRGIN MEDIA PYMTS,Bills,29,1210
20,July,2012,Waitrose,Groceries,88,1122
20,July,2012,Wild Bean Cafe,Eating Out,2,1120
20,July,2012,McDonalds,Eating Out,5,1115
21,July,2012,Anglo restaurant,Eating Out,55,1060
22,July,2012,Pizza Express,Eating Out,47,1013
23,July,2012,South West Trains,Transport,27,986
23,July,2012,Starbucks Coffee,Eating Out,2,984
24,July,2012,O2,Bills,32,952
24,July,2012,Costa Coffee,Eating Out,2,950
24,July,2012,McDonalds,Eating Out,8,942
25,July,2012,Caffe Nero,Eating Out,2,940
26,July,2012,Costa Coffee,Eating Out,2,938
27,July,2012,Tescos,Groceries,84,854
27,July,2012,Caffe Nero,Eating Out,2,852
27,July,2012,Chicken Cottage,Eating Out,4,848
27,July,2012,ATM Cash Withdrawal,General,80,768
28,July,2012,ATM Cash Withdrawal,General,40,728
30,July,2012,South West Trains,Transport,33,695
30,July,2012,Caffe Nero,Eating Out,2,693
31,July,2012,Costa Coffee,Eating Out,2,691
31,July,2012,ATM Cash Withdrawal,General,50,641
1,August,2012,Rhino Sports salary,General,1700,2341
1,August,2012,Caffe Nero,Eating Out,2,2339
1,August,2012,Chicken Cottage,Eating Out,5,2334
2,August,2012,McDonalds,Eating Out,6,2328
3,August,2012,Tescos,Groceries,55,2273
3,August,2012,Caffe Nero,Eating Out,2,2271
6,August,2012,South West Trains,Transport,32,2239
6,August,2012,The West Cornwall Pasty Company,Eating Out,5,2234
7,August,2012,Cubit and West rent,Rent,660,1574
7,August,2012,Wild Bean Cafe,Eating Out,2,1572
7,August,2012,Chicken Cottage,Eating Out,6,1566
8,August,2012,Costa Coffee,Eating Out,2,1564
8,August,2012,The West Cornwall Pasty Company,Eating Out,4,1560
9,August,2012,Wild Bean Cafe,Eating Out,2,1558
9,August,2012,ATM Cash Withdrawal,General,90,1468
10,August,2012,Tescos,Groceries,43,1425
10,August,2012,Pret A Manger,Eating Out,8,1417
13,August,2012,South West Trains,Transport,31,1386
13,August,2012,Starbucks Coffee,Eating Out,1,1385
13,August,2012,McDonalds,Eating Out,6,1379
14,August,2012,Starbucks Coffee,Eating Out,2,1377
14,August,2012,Subway,Eating Out,8,1369
14,August,2012,ATM Cash Withdrawal,General,10,1359
15,August,2012,BRGAS-Electricity,Bills,44,1315
15,August,2012,BRGAS-Gas,Bills,24,1291
15,August,2012,Greggs,Eating Out,7,1284
16,August,2012,LBS Council Tax,Bills,50,1234
16,August,2012,Caffe Nero,Eating Out,1,1233
16,August,2012,The West Cornwall Pasty Company,Eating Out,5,1228
17,August,2012,Sainsburys,Groceries,62,1166
17,August,2012,Wild Bean Cafe,Eating Out,2,1164
17,August,2012,Restaurant Gordon RamsayPortland Restaurant,Eating Out,43,1121
20,August,2012,VIRGIN MEDIA PYMTS,Bills,46,1075
20,August,2012,South West Trains,Transport,28,1047
20,August,2012,Wild Bean Cafe,Eating Out,2,1045
20,August,2012,Greggs,Eating Out,5,1040
21,August,2012,Caffe Nero,Eating Out,1,1039
21,August,2012,Greggs,Eating Out,5,1034
22,August,2012,Caffe Nero,Eating Out,2,1032
23,August,2012,McDonalds,Eating Out,7,1025
24,August,2012,O2,Bills,31,994
24,August,2012,Sainsburys,Groceries,82,912
24,August,2012,Caffe Nero,Eating Out,2,910
27,August,2012,South West Trains,Transport,32,878
27,August,2012,Wild Bean Cafe,Eating Out,2,876
27,August,2012,McDonalds,Eating Out,4,872
28,August,2012,Starbucks Coffee,Eating Out,1,871
28,August,2012,McDonalds,Eating Out,6,865
29,August,2012,Wild Bean Cafe,Eating Out,1,864
29,August,2012,Pret A Manger,Eating Out,6,858
30,August,2012,Caffe Nero,Eating Out,2,856
30,August,2012,ATM Cash Withdrawal,General,90,766
31,August,2012,Morrisons,Groceries,68,698
31,August,2012,Starbucks Coffee,Eating Out,2,696
31,August,2012,Subway,Eating Out,4,692
31,August,2012,Pizza Express,Eating Out,58,634
1,September,2012,Rhino Sports salary,General,1700,2334
1,September,2012,ATM Cash Withdrawal,General,40,2294
3,September,2012,South West Trains,Transport,29,2265
3,September,2012,Caffe Nero,Eating Out,2,2263
4,September,2012,Caffe Nero,Eating Out,2,2261
4,September,2012,Chicken Cottage,Eating Out,7,2254
5,September,2012,The West Cornwall Pasty Company,Eating Out,8,2246
6,September,2012,Pret A Manger,Eating Out,4,2242
7,September,2012,Cubit and West rent,Rent,660,1582
7,September,2012,Waitrose,Groceries,69,1513
7,September,2012,Wild Bean Cafe,Eating Out,2,1511
10,September,2012,South West Trains,Transport,38,1473
10,September,2012,Wild Bean Cafe,Eating Out,2,1471
10,September,2012,McDonalds,Eating Out,8,1463
11,September,2012,Subway,Eating Out,4,1459
12,September,2012,Wild Bean Cafe,Eating Out,2,1457
12,September,2012,Subway,Eating Out,6,1451
13,September,2012,Greggs,Eating Out,4,1447
14,September,2012,Tescos,Groceries,54,1393
14,September,2012,Starbucks Coffee,Eating Out,2,1391
14,September,2012,Pret A Manger,Eating Out,5,1386
15,September,2012,BRGAS-Electricity,Bills,31,1355
15,September,2012,BRGAS-Gas,Bills,33,1322
16,September,2012,LBS Council Tax,Bills,50,1272
17,September,2012,South West Trains,Transport,25,1247
17,September,2012,Chicken Cottage,Eating Out,6,1241
18,September,2012,Subway,Eating Out,5,1236
18,September,2012,ATM Cash Withdrawal,General,90,1146
19,September,2012,Costa Coffee,Eating Out,2,1144
19,September,2012,Chicken Cottage,Eating Out,6,1138
20,September,2012,VIRGIN MEDIA PYMTS,Bills,40,1098
20,September,2012,Starbucks Coffee,Eating Out,2,1096
20,September,2012,McDonalds,Eating Out,5,1091
21,September,2012,Tescos,Groceries,50,1041
21,September,2012,Starbucks Coffee,Eating Out,1,1040
21,September,2012,Anglo restaurant,Eating Out,46,994
23,September,2012,Anglo restaurant,Eating Out,35,959
24,September,2012,O2,Bills,32,927
24,September,2012,South West Trains,Transport,34,893
24,September,2012,Subway,Eating Out,5,888
25,September,2012,Costa Coffee,Eating Out,1,887
25,September,2012,Subway,Eating Out,4,883
26,September,2012,Wild Bean Cafe,Eating Out,2,881
26,September,2012,Subway,Eating Out,7,874
27,September,2012,Wild Bean Cafe,Eating Out,1,873
28,September,2012,ASDA,Groceries,71,802
28,September,2012,Caffe Nero,Eating Out,1,801
1,October,2012,Rhino Sports salary,General,1700,2501
1,October,2012,South West Trains,Transport,30,2471
1,October,2012,McDonalds,Eating Out,8,2463
2,October,2012,Costa Coffee,Eating Out,1,2462
2,October,2012,The West Cornwall Pasty Company,Eating Out,7,2455
3,October,2012,Caffe Nero,Eating Out,1,2454
3,October,2012,The West Cornwall Pasty Company,Eating Out,4,2450
4,October,2012,Costa Coffee,Eating Out,2,2448
4,October,2012,Pret A Manger,Eating Out,7,2441
5,October,2012,Waitrose,Groceries,52,2389
5,October,2012,Greggs,Eating Out,5,2384
7,October,2012,Cubit and West rent,Rent,660,1724
8,October,2012,South West Trains,Transport,24,1700
8,October,2012,Caffe Nero,Eating Out,2,1698
8,October,2012,Subway,Eating Out,6,1692
10,October,2012,Starbucks Coffee,Eating Out,1,1691
10,October,2012,McDonalds,Eating Out,8,1683
11,October,2012,Caffe Nero,Eating Out,2,1681
11,October,2012,Greggs,Eating Out,5,1676
12,October,2012,ASDA,Groceries,88,1588
13,October,2012,The Grand Pub,Eating Out,15,1573
13,October,2012,The Grand Pub,Eating Out,5,1568
13,October,2012,The Grand Pub,Eating Out,16,1552
13,October,2012,The Grand Pub,Eating Out,7,1545
13,October,2012,The Grand Pub,Eating Out,10,1535
13,October,2012,The Grand Pub,Eating Out,16,1519
15,October,2012,BRGAS-Electricity,Bills,35,1484
15,October,2012,BRGAS-Gas,Bills,31,1453
15,October,2012,South West Trains,Transport,38,1415
15,October,2012,Wild Bean Cafe,Eating Out,2,1413
15,October,2012,Subway,Eating Out,5,1408
16,October,2012,LBS Council Tax,Bills,50,1358
16,October,2012,Chicken Cottage,Eating Out,6,1352
17,October,2012,Costa Coffee,Eating Out,2,1350
18,October,2012,Starbucks Coffee,Eating Out,1,1349
18,October,2012,Greggs,Eating Out,6,1343
19,October,2012,ASDA,Groceries,87,1256
19,October,2012,Starbucks Coffee,Eating Out,1,1255
19,October,2012,Subway,Eating Out,5,1250
20,October,2012,VIRGIN MEDIA PYMTS,Bills,33,1217
22,October,2012,South West Trains,Transport,38,1179
22,October,2012,Wild Bean Cafe,Eating Out,1,1178
22,October,2012,McDonalds,Eating Out,6,1172
23,October,2012,Wild Bean Cafe,Eating Out,2,1170
23,October,2012,Chicken Cottage,Eating Out,6,1164
23,October,2012,ATM Cash Withdrawal,General,50,1114
24,October,2012,O2,Bills,31,1083
24,October,2012,Starbucks Coffee,Eating Out,2,1081
24,October,2012,McDonalds,Eating Out,5,1076
25,October,2012,Caffe Nero,Eating Out,1,1075
25,October,2012,McDonalds,Eating Out,7,1068
26,October,2012,ASDA,Groceries,42,1026
26,October,2012,Costa Coffee,Eating Out,1,1025
26,October,2012,Chicken Cottage,Eating Out,7,1018
28,October,2012,Pizza Express,Eating Out,52,966
29,October,2012,South West Trains,Transport,36,930
29,October,2012,Caffe Nero,Eating Out,1,929
29,October,2012,Chicken Cottage,Eating Out,5,924
30,October,2012,Wild Bean Cafe,Eating Out,2,922
31,October,2012,Costa Coffee,Eating Out,1,921
31,October,2012,The West Cornwall Pasty Company,Eating Out,8,913
31,October,2012,ATM Cash Withdrawal,General,40,873
1,November,2012,Rhino Sports salary,General,1700,2573
1,November,2012,Caffe Nero,Eating Out,1,2572
1,November,2012,McDonalds,Eating Out,6,2566
2,November,2012,Morrisons,Groceries,82,2484
2,November,2012,Costa Coffee,Eating Out,2,2482
2,November,2012,McDonalds,Eating Out,5,2477
2,November,2012,Restaurant Gordon RamsayPortland Restaurant,Eating Out,25,2452
5,November,2012,South West Trains,Transport,28,2424
5,November,2012,Costa Coffee,Eating Out,2,2422
5,November,2012,Greggs,Eating Out,6,2416
6,November,2012,Caffe Nero,Eating Out,1,2415
6,November,2012,Chicken Cottage,Eating Out,7,2408
6,November,2012,ATM Cash Withdrawal,General,40,2368
7,November,2012,Cubit and West rent,Rent,660,1708
7,November,2012,Costa Coffee,Eating Out,2,1706
7,November,2012,Chicken Cottage,Eating Out,5,1701
8,November,2012,Wild Bean Cafe,Eating Out,2,1699
8,November,2012,Pret A Manger,Eating Out,5,1694
9,November,2012,Waitrose,Groceries,64,1630
9,November,2012,Starbucks Coffee,Eating Out,2,1628
9,November,2012,Pret A Manger,Eating Out,6,1622
10,November,2012,Scott's Restaurant,Eating Out,42,1580
12,November,2012,South West Trains,Transport,37,1543
12,November,2012,Caffe Nero,Eating Out,2,1541
12,November,2012,Pret A Manger,Eating Out,6,1535
13,November,2012,Caffe Nero,Eating Out,1,1534
13,November,2012,Pret A Manger,Eating Out,8,1526
13,November,2012,ATM Cash Withdrawal,General,40,1486
14,November,2012,The West Cornwall Pasty Company,Eating Out,5,1481
15,November,2012,BRGAS-Electricity,Bills,73,1408
15,November,2012,BRGAS-Gas,Bills,77,1331
15,November,2012,Starbucks Coffee,Eating Out,2,1329
15,November,2012,Chicken Cottage,Eating Out,7,1322
16,November,2012,LBS Council Tax,Bills,50,1272
16,November,2012,Morrisons,Groceries,78,1194
16,November,2012,Costa Coffee,Eating Out,2,1192
16,November,2012,Greggs,Eating Out,4,1188
17,November,2012,Pizza Express,Eating Out,57,1131
19,November,2012,South West Trains,Transport,28,1103
19,November,2012,Costa Coffee,Eating Out,2,1101
19,November,2012,Chicken Cottage,Eating Out,6,1095
20,November,2012,VIRGIN MEDIA PYMTS,Bills,51,1044
20,November,2012,McDonalds,Eating Out,8,1036
21,November,2012,Starbucks Coffee,Eating Out,2,1034
22,November,2012,Caffe Nero,Eating Out,1,1033
22,November,2012,ATM Cash Withdrawal,General,40,993
23,November,2012,ASDA,Groceries,44,949
23,November,2012,Caffe Nero,Eating Out,1,948
23,November,2012,Pizza Express,Eating Out,59,889
24,November,2012,O2,Bills,33,856
26,November,2012,South West Trains,Transport,24,832
26,November,2012,Caffe Nero,Eating Out,2,830
26,November,2012,The West Cornwall Pasty Company,Eating Out,4,826
27,November,2012,Chicken Cottage,Eating Out,7,819
28,November,2012,Subway,Eating Out,6,813
29,November,2012,Wild Bean Cafe,Eating Out,1,812
29,November,2012,ATM Cash Withdrawal,General,80,732
30,November,2012,Sainsburys,Groceries,69,663
30,November,2012,Costa Coffee,Eating Out,1,662
1,December,2012,Rhino Sports salary,General,1700,2362
2,December,2012,Restaurant Gordon RamsayPortland Restaurant,Eating Out,52,2310
3,December,2012,South West Trains,Transport,27,2283
3,December,2012,Costa Coffee,Eating Out,1,2282
3,December,2012,ATM Cash Withdrawal,General,50,2232
4,December,2012,Caffe Nero,Eating Out,1,2231
4,December,2012,Pret A Manger,Eating Out,7,2224
5,December,2012,Wild Bean Cafe,Eating Out,2,2222
5,December,2012,Chicken Cottage,Eating Out,4,2218
5,December,2012,ATM Cash Withdrawal,General,20,2198
6,December,2012,Starbucks Coffee,Eating Out,2,2196
6,December,2012,Greggs,Eating Out,6,2190
7,December,2012,Cubit and West rent,Rent,660,1530
7,December,2012,Waitrose,Groceries,82,1448
7,December,2012,McDonalds,Eating Out,6,1442
10,December,2012,South West Trains,Transport,25,1417
10,December,2012,Caffe Nero,Eating Out,2,1415
11,December,2012,Starbucks Coffee,Eating Out,1,1414
12,December,2012,Starbucks Coffee,Eating Out,2,1412
12,December,2012,The West Cornwall Pasty Company,Eating Out,4,1408
13,December,2012,Wild Bean Cafe,Eating Out,2,1406
13,December,2012,Pret A Manger,Eating Out,6,1400
14,December,2012,Tescos,Groceries,64,1336
14,December,2012,Caffe Nero,Eating Out,2,1334
14,December,2012,McDonalds,Eating Out,5,1329
15,December,2012,BRGAS-Electricity,Bills,35,1294
15,December,2012,BRGAS-Gas,Bills,24,1270
16,December,2012,LBS Council Tax,Bills,50,1220
16,December,2012,ATM Cash Withdrawal,General,30,1190
17,December,2012,South West Trains,Transport,27,1163
17,December,2012,Costa Coffee,Eating Out,1,1162
18,December,2012,Wild Bean Cafe,Eating Out,1,1161
18,December,2012,Chicken Cottage,Eating Out,7,1154
19,December,2012,Wild Bean Cafe,Eating Out,2,1152
20,December,2012,VIRGIN MEDIA PYMTS,Bills,43,1109
20,December,2012,Caffe Nero,Eating Out,2,1107
20,December,2012,Greggs,Eating Out,8,1099
20,December,2012,ATM Cash Withdrawal,General,60,1039
21,December,2012,ASDA,Groceries,63,976
21,December,2012,Caffe Nero,Eating Out,1,975
21,December,2012,McDonalds,Eating Out,7,968
23,December,2012,Scott's Restaurant,Eating Out,50,918
24,December,2012,O2,Bills,37,881
24,December,2012,South West Trains,Transport,24,857
24,December,2012,Starbucks Coffee,Eating Out,1,856
24,December,2012,Pret A Manger,Eating Out,8,848
26,December,2012,Costa Coffee,Eating Out,1,847
26,December,2012,Chicken Cottage,Eating Out,7,840
28,December,2012,ASDA,Groceries,51,789
28,December,2012,Wild Bean Cafe,Eating Out,2,787
28,December,2012,The West Cornwall Pasty Company,Eating Out,7,780
28,December,2012,Dominos Pizza,Eating Out,36,744
31,December,2012,South West Trains,Transport,25,719
31,December,2012,Wild Bean Cafe,Eating Out,1,718
31,December,2012,Pret A Manger,Eating Out,6,712
1,January,2013,Rhino Sports salary,General,1700,2412
1,January,2013,Starbucks Coffee,Eating Out,2,2410
1,January,2013,The West Cornwall Pasty Company,Eating Out,5,2405
2,January,2013,The West Cornwall Pasty Company,Eating Out,7,2398
3,January,2013,Costa Coffee,Eating Out,1,2397
4,January,2013,Morrisons,Groceries,77,2320
4,January,2013,Caffe Nero,Eating Out,2,2318
4,January,2013,McDonalds,Eating Out,6,2312
5,January,2013,Restaurant Gordon RamsayPortland Restaurant,Eating Out,38,2274
7,January,2013,Cubit and West rent,Rent,660,1614
7,January,2013,South West Trains,Transport,35,1579
7,January,2013,Wild Bean Cafe,Eating Out,1,1578
7,January,2013,Greggs,Eating Out,8,1570
8,January,2013,Pret A Manger,Eating Out,4,1566
9,January,2013,Greggs,Eating Out,7,1559
10,January,2013,Starbucks Coffee,Eating Out,2,1557
10,January,2013,McDonalds,Eating Out,7,1550
11,January,2013,ASDA,Groceries,72,1478
11,January,2013,Caffe Nero,Eating Out,1,1477
11,January,2013,Pizza Express,Eating Out,26,1451
14,January,2013,South West Trains,Transport,27,1424
14,January,2013,The West Cornwall Pasty Company,Eating Out,4,1420
15,January,2013,BRGAS-Electricity,Bills,69,1351
15,January,2013,BRGAS-Gas,Bills,51,1300
15,January,2013,The West Cornwall Pasty Company,Eating Out,8,1292
16,January,2013,LBS Council Tax,Bills,50,1242
16,January,2013,Caffe Nero,Eating Out,1,1241
16,January,2013,Pret A Manger,Eating Out,5,1236
17,January,2013,Caffe Nero,Eating Out,1,1235
17,January,2013,Greggs,Eating Out,8,1227
18,January,2013,ASDA,Groceries,64,1163
18,January,2013,Wild Bean Cafe,Eating Out,2,1161
18,January,2013,Pret A Manger,Eating Out,4,1157
20,January,2013,VIRGIN MEDIA PYMTS,Bills,45,1112
21,January,2013,South West Trains,Transport,30,1082
21,January,2013,Costa Coffee,Eating Out,1,1081
21,January,2013,McDonalds,Eating Out,5,1076
22,January,2013,Starbucks Coffee,Eating Out,1,1075
22,January,2013,Pret A Manger,Eating Out,6,1069
23,January,2013,Caffe Nero,Eating Out,2,1067
23,January,2013,Subway,Eating Out,6,1061
24,January,2013,O2,Bills,33,1028
24,January,2013,Caffe Nero,Eating Out,2,1026
24,January,2013,McDonalds,Eating Out,8,1018
25,January,2013,Sainsburys,Groceries,57,961
25,January,2013,Costa Coffee,Eating Out,2,959
25,January,2013,The West Cornwall Pasty Company,Eating Out,6,953
25,January,2013,Pizza Express,Eating Out,51,902
28,January,2013,South West Trains,Transport,32,870
28,January,2013,Wild Bean Cafe,Eating Out,1,869
28,January,2013,McDonalds,Eating Out,8,861
29,January,2013,The West Cornwall Pasty Company,Eating Out,6,855
29,January,2013,ATM Cash Withdrawal,General,80,775
30,January,2013,Wild Bean Cafe,Eating Out,2,773
31,January,2013,Caffe Nero,Eating Out,1,772
31,January,2013,Greggs,Eating Out,4,768
1,February,2013,Rhino Sports salary,General,1700,2468
1,February,2013,ASDA,Groceries,53,2415
1,February,2013,Caffe Nero,Eating Out,1,2414
1,February,2013,Greggs,Eating Out,4,2410
1,February,2013,Restaurant Gordon RamsayPortland Restaurant,Eating Out,48,2362
4,February,2013,South West Trains,Transport,35,2327
4,February,2013,Chicken Cottage,Eating Out,6,2321
5,February,2013,Starbucks Coffee,Eating Out,2,2319
6,February,2013,Costa Coffee,Eating Out,2,2317
7,February,2013,Cubit and West rent,Rent,660,1657
7,February,2013,The West Cornwall Pasty Company,Eating Out,8,1649
8,February,2013,Morrisons,Groceries,51,1598
8,February,2013,Costa Coffee,Eating Out,1,1597
8,February,2013,Subway,Eating Out,4,1593
11,February,2013,South West Trains,Transport,28,1565
11,February,2013,Costa Coffee,Eating Out,2,1563
12,February,2013,Caffe Nero,Eating Out,2,1561
12,February,2013,McDonalds,Eating Out,5,1556
13,February,2013,Starbucks Coffee,Eating Out,2,1554
13,February,2013,Chicken Cottage,Eating Out,5,1549
14,February,2013,Starbucks Coffee,Eating Out,2,1547
15,February,2013,BRGAS-Electricity,Bills,30,1517
15,February,2013,BRGAS-Gas,Bills,43,1474
15,February,2013,Sainsburys,Groceries,63,1411
15,February,2013,Chicken Cottage,Eating Out,5,1406
16,February,2013,LBS Council Tax,Bills,50,1356
16,February,2013,Fabric Club,Eating Out,13,1343
16,February,2013,Fabric Club,Eating Out,16,1327
16,February,2013,Fabric Club,Eating Out,15,1312
18,February,2013,South West Trains,Transport,29,1283
18,February,2013,Wild Bean Cafe,Eating Out,2,1281
18,February,2013,Greggs,Eating Out,7,1274
18,February,2013,ATM Cash Withdrawal,General,50,1224
19,February,2013,Starbucks Coffee,Eating Out,2,1222
19,February,2013,Pret A Manger,Eating Out,8,1214
20,February,2013,VIRGIN MEDIA PYMTS,Bills,44,1170
20,February,2013,Costa Coffee,Eating Out,2,1168
21,February,2013,Starbucks Coffee,Eating Out,2,1166
21,February,2013,Subway,Eating Out,8,1158
22,February,2013,ASDA,Groceries,42,1116
22,February,2013,Wild Bean Cafe,Eating Out,2,1114
24,February,2013,O2,Bills,38,1076
24,February,2013,Anglo restaurant,Eating Out,56,1020
25,February,2013,South West Trains,Transport,34,986
25,February,2013,Wild Bean Cafe,Eating Out,2,984
25,February,2013,McDonalds,Eating Out,4,980
26,February,2013,Wild Bean Cafe,Eating Out,2,978
27,February,2013,Wild Bean Cafe,Eating Out,2,976
28,February,2013,Greggs,Eating Out,5,971
1,March,2013,Rhino Sports salary,General,1700,2671
1,March,2013,Morrisons,Groceries,55,2616
1,March,2013,Starbucks Coffee,Eating Out,2,2614
1,March,2013,Chicken Cottage,Eating Out,5,2609
2,March,2013,Anglo restaurant,Eating Out,39,2570
3,March,2013,Scott's Restaurant,Eating Out,52,2518
4,March,2013,South West Trains,Transport,32,2486
4,March,2013,Starbucks Coffee,Eating Out,2,2484
5,March,2013,Wild Bean Cafe,Eating Out,2,2482
5,March,2013,Chicken Cottage,Eating Out,7,2475
6,March,2013,Costa Coffee,Eating Out,2,2473
6,March,2013,Pret A Manger,Eating Out,7,2466
7,March,2013,Cubit and West rent,Rent,660,1806
7,March,2013,Costa Coffee,Eating Out,2,1804
7,March,2013,Subway,Eating Out,5,1799
8,March,2013,Waitrose,Groceries,82,1717
8,March,2013,Wild Bean Cafe,Eating Out,2,1715
11,March,2013,South West Trains,Transport,35,1680
11,March,2013,Costa Coffee,Eating Out,1,1679
11,March,2013,Subway,Eating Out,7,1672
12,March,2013,Wild Bean Cafe,Eating Out,2,1670
12,March,2013,Pret A Manger,Eating Out,5,1665
13,March,2013,Costa Coffee,Eating Out,2,1663
14,March,2013,Costa Coffee,Eating Out,2,1661
15,March,2013,BRGAS-Electricity,Bills,40,1621
15,March,2013,BRGAS-Gas,Bills,29,1592
15,March,2013,Waitrose,Groceries,48,1544
15,March,2013,Wild Bean Cafe,Eating Out,1,1543
15,March,2013,The West Cornwall Pasty Company,Eating Out,7,1536
16,March,2013,LBS Council Tax,Bills,50,1486
18,March,2013,South West Trains,Transport,37,1449
18,March,2013,Costa Coffee,Eating Out,2,1447
18,March,2013,McDonalds,Eating Out,6,1441
19,March,2013,Starbucks Coffee,Eating Out,2,1439
19,March,2013,Chicken Cottage,Eating Out,6,1433
20,March,2013,VIRGIN MEDIA PYMTS,Bills,46,1387
20,March,2013,Caffe Nero,Eating Out,1,1386
20,March,2013,McDonalds,Eating Out,5,1381
21,March,2013,Caffe Nero,Eating Out,2,1379
21,March,2013,Chicken Cottage,Eating Out,8,1371
22,March,2013,Sainsburys,Groceries,86,1285
22,March,2013,Wild Bean Cafe,Eating Out,1,1284
22,March,2013,Dominos Pizza,Eating Out,47,1237
24,March,2013,O2,Bills,34,1203
25,March,2013,South West Trains,Transport,29,1174
25,March,2013,Starbucks Coffee,Eating Out,2,1172
25,March,2013,McDonalds,Eating Out,6,1166
26,March,2013,Caffe Nero,Eating Out,1,1165
26,March,2013,The West Cornwall Pasty Company,Eating Out,8,1157
27,March,2013,Costa Coffee,Eating Out,2,1155
27,March,2013,Chicken Cottage,Eating Out,8,1147
28,March,2013,The West Cornwall Pasty Company,Eating Out,8,1139
29,March,2013,ASDA,Groceries,78,1061
29,March,2013,Caffe Nero,Eating Out,1,1060
30,March,2013,Dominos Pizza,Eating Out,38,1022
30,March,2013,ATM Cash Withdrawal,General,10,1012
1,April,2013,Rhino Sports salary,General,1700,2712
1,April,2013,South West Trains,Transport,28,2684
1,April,2013,Wild Bean Cafe,Eating Out,2,2682
1,April,2013,Pret A Manger,Eating Out,5,2677
2,April,2013,Costa Coffee,Eating Out,2,2675
2,April,2013,The West Cornwall Pasty Company,Eating Out,6,2669
3,April,2013,Starbucks Coffee,Eating Out,1,2668
3,April,2013,The West Cornwall Pasty Company,Eating Out,5,2663
4,April,2013,Costa Coffee,Eating Out,1,2662
4,April,2013,The West Cornwall Pasty Company,Eating Out,5,2657
5,April,2013,ASDA,Groceries,82,2575
5,April,2013,Costa Coffee,Eating Out,2,2573
5,April,2013,The West Cornwall Pasty Company,Eating Out,6,2567
7,April,2013,Cubit and West rent,Rent,660,1907
8,April,2013,South West Trains,Transport,36,1871
8,April,2013,Caffe Nero,Eating Out,1,1870
8,April,2013,Subway,Eating Out,6,1864
9,April,2013,ATM Cash Withdrawal,General,90,1774
10,April,2013,Caffe Nero,Eating Out,2,1772
10,April,2013,The West Cornwall Pasty Company,Eating Out,6,1766
11,April,2013,Starbucks Coffee,Eating Out,2,1764
12,April,2013,Tescos,Groceries,53,1711
12,April,2013,Caffe Nero,Eating Out,2,1709
12,April,2013,Subway,Eating Out,4,1705
13,April,2013,Scott's Restaurant,Eating Out,26,1679
15,April,2013,BRGAS-Electricity,Bills,39,1640
15,April,2013,BRGAS-Gas,Bills,40,1600
15,April,2013,South West Trains,Transport,29,1571
15,April,2013,Starbucks Coffee,Eating Out,2,1569
16,April,2013,LBS Council Tax,Bills,50,1519
16,April,2013,Wild Bean Cafe,Eating Out,2,1517
16,April,2013,The West Cornwall Pasty Company,Eating Out,8,1509
17,April,2013,Starbucks Coffee,Eating Out,1,1508
17,April,2013,McDonalds,Eating Out,6,1502
18,April,2013,Subway,Eating Out,6,1496
19,April,2013,Sainsburys,Groceries,50,1446
19,April,2013,Costa Coffee,Eating Out,2,1444
19,April,2013,Greggs,Eating Out,7,1437
20,April,2013,VIRGIN MEDIA PYMTS,Bills,40,1397
22,April,2013,South West Trains,Transport,25,1372
22,April,2013,Costa Coffee,Eating Out,2,1370
22,April,2013,McDonalds,Eating Out,4,1366
23,April,2013,Costa Coffee,Eating Out,1,1365
23,April,2013,Greggs,Eating Out,8,1357
23,April,2013,ATM Cash Withdrawal,General,60,1297
24,April,2013,O2,Bills,33,1264
24,April,2013,Starbucks Coffee,Eating Out,1,1263
25,April,2013,Wild Bean Cafe,Eating Out,2,1261
25,April,2013,McDonalds,Eating Out,7,1254
25,April,2013,ATM Cash Withdrawal,General,90,1164
26,April,2013,ASDA,Groceries,56,1108
26,April,2013,Wild Bean Cafe,Eating Out,1,1107
26,April,2013,Greggs,Eating Out,7,1100
26,April,2013,The Grand Pub,Eating Out,13,1087
26,April,2013,The Grand Pub,Eating Out,10,1077
26,April,2013,The Grand Pub,Eating Out,15,1062
26,April,2013,The Grand Pub,Eating Out,10,1052
29,April,2013,South West Trains,Transport,26,1026
29,April,2013,Starbucks Coffee,Eating Out,1,1025
29,April,2013,McDonalds,Eating Out,5,1020
30,April,2013,Caffe Nero,Eating Out,1,1019
30,April,2013,Subway,Eating Out,5,1014
1,May,2013,Rhino Sports salary,General,1700,2714
1,May,2013,Starbucks Coffee,Eating Out,2,2712
1,May,2013,McDonalds,Eating Out,8,2704
2,May,2013,Costa Coffee,Eating Out,2,2702
2,May,2013,Greggs,Eating Out,8,2694
3,May,2013,Morrisons,Groceries,67,2627
3,May,2013,The West Cornwall Pasty Company,Eating Out,6,2621
4,May,2013,Dominos Pizza,Eating Out,36,2585
6,May,2013,South West Trains,Transport,25,2560
6,May,2013,Chicken Cottage,Eating Out,6,2554
7,May,2013,Cubit and West rent,Rent,660,1894
7,May,2013,Wild Bean Cafe,Eating Out,1,1893
7,May,2013,Pret A Manger,Eating Out,5,1888
8,May,2013,Wild Bean Cafe,Eating Out,2,1886
8,May,2013,McDonalds,Eating Out,7,1879
9,May,2013,Costa Coffee,Eating Out,2,1877
9,May,2013,Subway,Eating Out,8,1869
9,May,2013,ATM Cash Withdrawal,General,10,1859
10,May,2013,Tescos,Groceries,83,1776
10,May,2013,Greggs,Eating Out,8,1768
13,May,2013,South West Trains,Transport,34,1734
13,May,2013,Caffe Nero,Eating Out,2,1732
13,May,2013,Greggs,Eating Out,4,1728
14,May,2013,Wild Bean Cafe,Eating Out,2,1726
14,May,2013,Pret A Manger,Eating Out,8,1718
15,May,2013,BRGAS-Electricity,Bills,22,1696
15,May,2013,BRGAS-Gas,Bills,44,1652
15,May,2013,Costa Coffee,Eating Out,2,1650
15,May,2013,McDonalds,Eating Out,7,1643
16,May,2013,LBS Council Tax,Bills,50,1593
17,May,2013,Sainsburys,Groceries,52,1541
17,May,2013,Starbucks Coffee,Eating Out,2,1539
17,May,2013,Pizza Express,Eating Out,55,1484
20,May,2013,VIRGIN MEDIA PYMTS,Bills,46,1438
20,May,2013,South West Trains,Transport,32,1406
20,May,2013,McDonalds,Eating Out,5,1401
21,May,2013,Wild Bean Cafe,Eating Out,1,1400
21,May,2013,Greggs,Eating Out,6,1394
22,May,2013,Costa Coffee,Eating Out,2,1392
22,May,2013,Pret A Manger,Eating Out,8,1384
23,May,2013,Costa Coffee,Eating Out,2,1382
23,May,2013,Subway,Eating Out,8,1374
24,May,2013,O2,Bills,38,1336
24,May,2013,Tescos,Groceries,47,1289
24,May,2013,Wild Bean Cafe,Eating Out,2,1287
24,May,2013,Pret A Manger,Eating Out,7,1280
26,May,2013,Scott's Restaurant,Eating Out,35,1245
27,May,2013,South West Trains,Transport,37,1208
27,May,2013,Wild Bean Cafe,Eating Out,2,1206
27,May,2013,Chicken Cottage,Eating Out,8,1198
28,May,2013,McDonalds,Eating Out,7,1191
28,May,2013,ATM Cash Withdrawal,General,70,1121
29,May,2013,Starbucks Coffee,Eating Out,2,1119
30,May,2013,Costa Coffee,Eating Out,2,1117
30,May,2013,Pret A Manger,Eating Out,6,1111
31,May,2013,Morrisons,Groceries,88,1023
31,May,2013,Caffe Nero,Eating Out,2,1021
31,May,2013,McDonalds,Eating Out,4,1017
1,June,2013,Rhino Sports salary,General,1700,2717
3,June,2013,South West Trains,Transport,38,2679
3,June,2013,Caffe Nero,Eating Out,2,2677
3,June,2013,Greggs,Eating Out,7,2670
4,June,2013,Starbucks Coffee,Eating Out,2,2668
4,June,2013,Chicken Cottage,Eating Out,8,2660
5,June,2013,Starbucks Coffee,Eating Out,2,2658
5,June,2013,McDonalds,Eating Out,5,2653
6,June,2013,Caffe Nero,Eating Out,1,2652
6,June,2013,Greggs,Eating Out,6,2646
7,June,2013,Cubit and West rent,Rent,660,1986
7,June,2013,ASDA,Groceries,86,1900
7,June,2013,Starbucks Coffee,Eating Out,2,1898
7,June,2013,ATM Cash Withdrawal,General,20,1878
10,June,2013,South West Trains,Transport,26,1852
10,June,2013,Caffe Nero,Eating Out,2,1850
10,June,2013,The West Cornwall Pasty Company,Eating Out,6,1844
11,June,2013,Caffe Nero,Eating Out,1,1843
12,June,2013,Costa Coffee,Eating Out,2,1841
12,June,2013,Subway,Eating Out,5,1836
13,June,2013,Costa Coffee,Eating Out,2,1834
14,June,2013,Sainsburys,Groceries,46,1788
14,June,2013,Caffe Nero,Eating Out,1,1787
14,June,2013,McDonalds,Eating Out,4,1783
15,June,2013,BRGAS-Electricity,Bills,42,1741
15,June,2013,BRGAS-Gas,Bills,24,1717
16,June,2013,LBS Council Tax,Bills,50,1667
17,June,2013,South West Trains,Transport,27,1640
17,June,2013,Wild Bean Cafe,Eating Out,2,1638
17,June,2013,Subway,Eating Out,4,1634
18,June,2013,Wild Bean Cafe,Eating Out,2,1632
20,June,2013,VIRGIN MEDIA PYMTS,Bills,59,1573
21,June,2013,Waitrose,Groceries,58,1515
21,June,2013,Wild Bean Cafe,Eating Out,1,1514
24,June,2013,O2,Bills,31,1483
24,June,2013,South West Trains,Transport,25,1458
24,June,2013,Subway,Eating Out,5,1453
25,June,2013,Wild Bean Cafe,Eating Out,1,1452
26,June,2013,Costa Coffee,Eating Out,2,1450
26,June,2013,Subway,Eating Out,8,1442
27,June,2013,Caffe Nero,Eating Out,2,1440
28,June,2013,Tescos,Groceries,89,1351
28,June,2013,Costa Coffee,Eating Out,2,1349
28,June,2013,Subway,Eating Out,4,1345
28,June,2013,Ministry of Sound ClubXOYO Club,Eating Out,13,1332
28,June,2013,Ministry of Sound ClubXOYO Club,Eating Out,6,1326
28,June,2013,Ministry of Sound ClubXOYO Club,Eating Out,12,1314
1,July,2013,Rhino Sports salary,General,1700,3014
1,July,2013,South West Trains,Transport,31,2983
1,July,2013,Pret A Manger,Eating Out,6,2977
2,July,2013,Starbucks Coffee,Eating Out,2,2975
3,July,2013,Wild Bean Cafe,Eating Out,2,2973
3,July,2013,McDonalds,Eating Out,4,2969
4,July,2013,Costa Coffee,Eating Out,2,2967
4,July,2013,The West Cornwall Pasty Company,Eating Out,4,2963
5,July,2013,Morrisons,Groceries,43,2920
5,July,2013,Wild Bean Cafe,Eating Out,1,2919
5,July,2013,The West Cornwall Pasty Company,Eating Out,8,2911
6,July,2013,Pizza Express,Eating Out,39,2872
7,July,2013,Cubit and West rent,Rent,660,2212
8,July,2013,South West Trains,Transport,32,2180
8,July,2013,Starbucks Coffee,Eating Out,2,2178
8,July,2013,McDonalds,Eating Out,7,2171
9,July,2013,Starbucks Coffee,Eating Out,1,2170
9,July,2013,McDonalds,Eating Out,7,2163
10,July,2013,Caffe Nero,Eating Out,2,2161
11,July,2013,Starbucks Coffee,Eating Out,2,2159
11,July,2013,Greggs,Eating Out,6,2153
12,July,2013,Waitrose,Groceries,45,2108
12,July,2013,Costa Coffee,Eating Out,2,2106
15,July,2013,BRGAS-Electricity,Bills,25,2081
15,July,2013,BRGAS-Gas,Bills,22,2059
15,July,2013,South West Trains,Transport,24,2035
15,July,2013,Costa Coffee,Eating Out,1,2034
15,July,2013,ATM Cash Withdrawal,General,40,1994
16,July,2013,LBS Council Tax,Bills,50,1944
16,July,2013,Wild Bean Cafe,Eating Out,1,1943
16,July,2013,The West Cornwall Pasty Company,Eating Out,6,1937
17,July,2013,Starbucks Coffee,Eating Out,2,1935
18,July,2013,Starbucks Coffee,Eating Out,2,1933
18,July,2013,The West Cornwall Pasty Company,Eating Out,5,1928
19,July,2013,Tescos,Groceries,66,1862
19,July,2013,Subway,Eating Out,7,1855
19,July,2013,Dominos Pizza,Eating Out,54,1801
20,July,2013,VIRGIN MEDIA PYMTS,Bills,39,1762
21,July,2013,ATM Cash Withdrawal,General,30,1732
22,July,2013,South West Trains,Transport,24,1708
22,July,2013,Wild Bean Cafe,Eating Out,2,1706
22,July,2013,Subway,Eating Out,7,1699
23,July,2013,Caffe Nero,Eating Out,1,1698
23,July,2013,The West Cornwall Pasty Company,Eating Out,5,1693
24,July,2013,O2,Bills,31,1662
24,July,2013,Starbucks Coffee,Eating Out,2,1660
24,July,2013,Subway,Eating Out,7,1653
25,July,2013,Starbucks Coffee,Eating Out,2,1651
25,July,2013,Chicken Cottage,Eating Out,8,1643
26,July,2013,ASDA,Groceries,89,1554
26,July,2013,Wild Bean Cafe,Eating Out,2,1552
26,July,2013,Pret A Manger,Eating Out,5,1547
26,July,2013,Scott's Restaurant,Eating Out,53,1494
28,July,2013,Dominos Pizza,Eating Out,40,1454
28,July,2013,ATM Cash Withdrawal,General,90,1364
29,July,2013,South West Trains,Transport,30,1334
29,July,2013,Caffe Nero,Eating Out,2,1332
29,July,2013,Greggs,Eating Out,5,1327
29,July,2013,ATM Cash Withdrawal,General,90,1237
30,July,2013,Starbucks Coffee,Eating Out,2,1235
30,July,2013,McDonalds,Eating Out,5,1230
31,July,2013,Starbucks Coffee,Eating Out,2,1228
31,July,2013,Chicken Cottage,Eating Out,5,1223
1,August,2013,Rhino Sports salary,General,1700,2923
1,August,2013,Wild Bean Cafe,Eating Out,2,2921
2,August,2013,Waitrose,Groceries,78,2843
2,August,2013,Costa Coffee,Eating Out,2,2841
5,August,2013,South West Trains,Transport,28,2813
5,August,2013,Caffe Nero,Eating Out,1,2812
6,August,2013,Caffe Nero,Eating Out,1,2811
6,August,2013,The West Cornwall Pasty Company,Eating Out,6,2805
7,August,2013,Cubit and West rent,Rent,660,2145
7,August,2013,ATM Cash Withdrawal,General,70,2075
8,August,2013,Costa Coffee,Eating Out,2,2073
8,August,2013,McDonalds,Eating Out,6,2067
9,August,2013,Tescos,Groceries,46,2021
9,August,2013,Costa Coffee,Eating Out,2,2019
11,August,2013,ATM Cash Withdrawal,General,50,1969
12,August,2013,South West Trains,Transport,32,1937
12,August,2013,Starbucks Coffee,Eating Out,1,1936
12,August,2013,The West Cornwall Pasty Company,Eating Out,8,1928
13,August,2013,Chicken Cottage,Eating Out,8,1920
14,August,2013,Starbucks Coffee,Eating Out,1,1919
15,August,2013,BRGAS-Electricity,Bills,44,1875
15,August,2013,BRGAS-Gas,Bills,38,1837
15,August,2013,Greggs,Eating Out,8,1829
16,August,2013,LBS Council Tax,Bills,50,1779
16,August,2013,ASDA,Groceries,69,1710
16,August,2013,Costa Coffee,Eating Out,2,1708
16,August,2013,Pret A Manger,Eating Out,7,1701
17,August,2013,Anglo restaurant,Eating Out,46,1655
19,August,2013,South West Trains,Transport,25,1630
19,August,2013,Costa Coffee,Eating Out,1,1629
20,August,2013,VIRGIN MEDIA PYMTS,Bills,51,1578
20,August,2013,Chicken Cottage,Eating Out,7,1571
21,August,2013,Chicken Cottage,Eating Out,5,1566
22,August,2013,The West Cornwall Pasty Company,Eating Out,6,1560
22,August,2013,ATM Cash Withdrawal,General,20,1540
23,August,2013,Morrisons,Groceries,86,1454
23,August,2013,Starbucks Coffee,Eating Out,2,1452
23,August,2013,McDonalds,Eating Out,4,1448
24,August,2013,O2,Bills,37,1411
25,August,2013,Pizza Express,Eating Out,45,1366
26,August,2013,South West Trains,Transport,35,1331
26,August,2013,Caffe Nero,Eating Out,1,1330
27,August,2013,Caffe Nero,Eating Out,1,1329
27,August,2013,ATM Cash Withdrawal,General,70,1259
28,August,2013,Costa Coffee,Eating Out,2,1257
28,August,2013,Pret A Manger,Eating Out,5,1252
29,August,2013,Wild Bean Cafe,Eating Out,2,1250
29,August,2013,Subway,Eating Out,8,1242
30,August,2013,Sainsburys,Groceries,45,1197
30,August,2013,Costa Coffee,Eating Out,1,1196
30,August,2013,McDonalds,Eating Out,7,1189
30,August,2013,Scott's Restaurant,Eating Out,36,1153
1,September,2013,Rhino Sports salary,General,1700,2853
2,September,2013,South West Trains,Transport,33,2820
2,September,2013,Caffe Nero,Eating Out,2,2818
2,September,2013,The West Cornwall Pasty Company,Eating Out,6,2812
3,September,2013,Caffe Nero,Eating Out,2,2810
3,September,2013,Chicken Cottage,Eating Out,5,2805
4,September,2013,Costa Coffee,Eating Out,2,2803
4,September,2013,Subway,Eating Out,8,2795
5,September,2013,Starbucks Coffee,Eating Out,2,2793
5,September,2013,Greggs,Eating Out,7,2786
6,September,2013,ASDA,Groceries,70,2716
6,September,2013,Costa Coffee,Eating Out,2,2714
6,September,2013,The West Cornwall Pasty Company,Eating Out,7,2707
6,September,2013,Fabric Club,Eating Out,13,2694
6,September,2013,Fabric Club,Eating Out,11,2683
7,September,2013,Cubit and West rent,Rent,660,2023
8,September,2013,ATM Cash Withdrawal,General,30,1993
9,September,2013,South West Trains,Transport,35,1958
9,September,2013,Wild Bean Cafe,Eating Out,2,1956
9,September,2013,The West Cornwall Pasty Company,Eating Out,7,1949
12,September,2013,Costa Coffee,Eating Out,1,1948
12,September,2013,McDonalds,Eating Out,7,1941
13,September,2013,Sainsburys,Groceries,82,1859
13,September,2013,Wild Bean Cafe,Eating Out,2,1857
13,September,2013,Chicken Cottage,Eating Out,7,1850
15,September,2013,BRGAS-Electricity,Bills,27,1823
15,September,2013,BRGAS-Gas,Bills,37,1786
16,September,2013,LBS Council Tax,Bills,50,1736
16,September,2013,South West Trains,Transport,26,1710
16,September,2013,Starbucks Coffee,Eating Out,1,1709
16,September,2013,The West Cornwall Pasty Company,Eating Out,7,1702
17,September,2013,The West Cornwall Pasty Company,Eating Out,6,1696
18,September,2013,Starbucks Coffee,Eating Out,2,1694
18,September,2013,Subway,Eating Out,8,1686
19,September,2013,Caffe Nero,Eating Out,2,1684
20,September,2013,VIRGIN MEDIA PYMTS,Bills,42,1642
20,September,2013,ASDA,Groceries,55,1587
20,September,2013,Caffe Nero,Eating Out,2,1585
20,September,2013,McDonalds,Eating Out,5,1580
20,September,2013,ATM Cash Withdrawal,General,60,1520
23,September,2013,South West Trains,Transport,36,1484
23,September,2013,Starbucks Coffee,Eating Out,1,1483
23,September,2013,Greggs,Eating Out,8,1475
24,September,2013,O2,Bills,38,1437
24,September,2013,Costa Coffee,Eating Out,1,1436
25,September,2013,Starbucks Coffee,Eating Out,2,1434
26,September,2013,Chicken Cottage,Eating Out,5,1429
27,September,2013,Morrisons,Groceries,54,1375
27,September,2013,Greggs,Eating Out,6,1369
30,September,2013,South West Trains,Transport,28,1341
30,September,2013,Starbucks Coffee,Eating Out,1,1340
1,October,2013,Rhino Sports salary,General,1700,3040
1,October,2013,Subway,Eating Out,5,3035
1,October,2013,ATM Cash Withdrawal,General,20,3015
2,October,2013,Starbucks Coffee,Eating Out,2,3013
2,October,2013,McDonalds,Eating Out,8,3005
3,October,2013,Caffe Nero,Eating Out,1,3004
3,October,2013,The West Cornwall Pasty Company,Eating Out,4,3000
4,October,2013,Morrisons,Groceries,49,2951
4,October,2013,Starbucks Coffee,Eating Out,2,2949
5,October,2013,Pizza Express,Eating Out,30,2919
6,October,2013,Dominos Pizza,Eating Out,26,2893
7,October,2013,Cubit and West rent,Rent,660,2233
7,October,2013,South West Trains,Transport,32,2201
7,October,2013,Wild Bean Cafe,Eating Out,1,2200
8,October,2013,Costa Coffee,Eating Out,1,2199
8,October,2013,Chicken Cottage,Eating Out,8,2191
10,October,2013,Wild Bean Cafe,Eating Out,1,2190
11,October,2013,Sainsburys,Groceries,49,2141
11,October,2013,Wild Bean Cafe,Eating Out,1,2140
11,October,2013,Subway,Eating Out,6,2134
12,October,2013,Dominos Pizza,Eating Out,34,2100
14,October,2013,South West Trains,Transport,25,2075
14,October,2013,Caffe Nero,Eating Out,2,2073
14,October,2013,Subway,Eating Out,4,2069
15,October,2013,BRGAS-Electricity,Bills,32,2037
15,October,2013,BRGAS-Gas,Bills,30,2007
15,October,2013,The West Cornwall Pasty Company,Eating Out,8,1999
16,October,2013,LBS Council Tax,Bills,50,1949
16,October,2013,Caffe Nero,Eating Out,1,1948
16,October,2013,McDonalds,Eating Out,7,1941
17,October,2013,Caffe Nero,Eating Out,2,1939
17,October,2013,McDonalds,Eating Out,8,1931
18,October,2013,Morrisons,Groceries,76,1855
20,October,2013,VIRGIN MEDIA PYMTS,Bills,55,1800
21,October,2013,South West Trains,Transport,32,1768
21,October,2013,Wild Bean Cafe,Eating Out,1,1767
21,October,2013,Chicken Cottage,Eating Out,7,1760
22,October,2013,Starbucks Coffee,Eating Out,2,1758
24,October,2013,O2,Bills,36,1722
24,October,2013,Starbucks Coffee,Eating Out,1,1721
24,October,2013,Subway,Eating Out,5,1716
25,October,2013,ASDA,Groceries,89,1627
25,October,2013,Caffe Nero,Eating Out,2,1625
25,October,2013,Subway,Eating Out,5,1620
25,October,2013,Anglo restaurant,Eating Out,24,1596
25,October,2013,ATM Cash Withdrawal,General,10,1586
26,October,2013,Dominos Pizza,Eating Out,51,1535
28,October,2013,South West Trains,Transport,36,1499
28,October,2013,The West Cornwall Pasty Company,Eating Out,8,1491
29,October,2013,Caffe Nero,Eating Out,2,1489
29,October,2013,Chicken Cottage,Eating Out,8,1481
30,October,2013,Wild Bean Cafe,Eating Out,2,1479
31,October,2013,Costa Coffee,Eating Out,1,1478
31,October,2013,Greggs,Eating Out,7,1471
1,November,2013,Rhino Sports salary,General,1700,3171
1,November,2013,Waitrose,Groceries,78,3093
1,November,2013,Chicken Cottage,Eating Out,6,3087
3,November,2013,ATM Cash Withdrawal,General,60,3027
4,November,2013,South West Trains,Transport,29,2998
4,November,2013,Starbucks Coffee,Eating Out,1,2997
4,November,2013,Subway,Eating Out,6,2991
6,November,2013,Costa Coffee,Eating Out,2,2989
6,November,2013,Subway,Eating Out,7,2982
7,November,2013,Cubit and West rent,Rent,660,2322
8,November,2013,Waitrose,Groceries,69,2253
8,November,2013,Starbucks Coffee,Eating Out,1,2252
11,November,2013,South West Trains,Transport,27,2225
11,November,2013,McDonalds,Eating Out,7,2218
12,November,2013,Costa Coffee,Eating Out,2,2216
13,November,2013,The West Cornwall Pasty Company,Eating Out,5,2211
14,November,2013,Wild Bean Cafe,Eating Out,2,2209
15,November,2013,BRGAS-Electricity,Bills,50,2159
15,November,2013,BRGAS-Gas,Bills,52,2107
15,November,2013,ASDA,Groceries,50,2057
15,November,2013,Caffe Nero,Eating Out,2,2055
15,November,2013,ATM Cash Withdrawal,General,90,1965
16,November,2013,LBS Council Tax,Bills,50,1915
18,November,2013,South West Trains,Transport,29,1886
18,November,2013,Caffe Nero,Eating Out,2,1884
18,November,2013,Pret A Manger,Eating Out,8,1876
19,November,2013,Starbucks Coffee,Eating Out,2,1874
19,November,2013,Greggs,Eating Out,4,1870
20,November,2013,VIRGIN MEDIA PYMTS,Bills,50,1820
20,November,2013,Starbucks Coffee,Eating Out,1,1819
20,November,2013,Greggs,Eating Out,7,1812
21,November,2013,The West Cornwall Pasty Company,Eating Out,6,1806
22,November,2013,ASDA,Groceries,56,1750
22,November,2013,Wild Bean Cafe,Eating Out,2,1748
22,November,2013,Greggs,Eating Out,6,1742
23,November,2013,ATM Cash Withdrawal,General,70,1672
24,November,2013,O2,Bills,38,1634
25,November,2013,South West Trains,Transport,36,1598
25,November,2013,Caffe Nero,Eating Out,1,1597
26,November,2013,Caffe Nero,Eating Out,2,1595
27,November,2013,Starbucks Coffee,Eating Out,1,1594
27,November,2013,Subway,Eating Out,6,1588
28,November,2013,Starbucks Coffee,Eating Out,2,1586
28,November,2013,Greggs,Eating Out,5,1581
29,November,2013,Tescos,Groceries,76,1505
29,November,2013,Costa Coffee,Eating Out,1,1504
1,December,2013,Rhino Sports salary,General,1700,3204
2,December,2013,South West Trains,Transport,38,3166
2,December,2013,Costa Coffee,Eating Out,2,3164
2,December,2013,McDonalds,Eating Out,5,3159
3,December,2013,Costa Coffee,Eating Out,2,3157
3,December,2013,Pret A Manger,Eating Out,8,3149
4,December,2013,Wild Bean Cafe,Eating Out,1,3148
4,December,2013,Subway,Eating Out,8,3140
5,December,2013,Caffe Nero,Eating Out,2,3138
5,December,2013,The West Cornwall Pasty Company,Eating Out,5,3133
6,December,2013,Morrisons,Groceries,64,3069
6,December,2013,Wild Bean Cafe,Eating Out,2,3067
6,December,2013,Greggs,Eating Out,6,3061
7,December,2013,Cubit and West rent,Rent,660,2401
7,December,2013,Dominos Pizza,Eating Out,33,2368
9,December,2013,South West Trains,Transport,32,2336
9,December,2013,Starbucks Coffee,Eating Out,2,2334
9,December,2013,Subway,Eating Out,6,2328
10,December,2013,Wild Bean Cafe,Eating Out,2,2326
10,December,2013,Chicken Cottage,Eating Out,6,2320
12,December,2013,Caffe Nero,Eating Out,2,2318
12,December,2013,Subway,Eating Out,7,2311
13,December,2013,ASDA,Groceries,87,2224
13,December,2013,Wild Bean Cafe,Eating Out,2,2222
13,December,2013,Anglo restaurant,Eating Out,46,2176
14,December,2013,ATM Cash Withdrawal,General,90,2086
15,December,2013,BRGAS-Electricity,Bills,31,2055
15,December,2013,BRGAS-Gas,Bills,26,2029
15,December,2013,Dominos Pizza,Eating Out,25,2004
16,December,2013,LBS Council Tax,Bills,50,1954
16,December,2013,South West Trains,Transport,34,1920
16,December,2013,Costa Coffee,Eating Out,2,1918
16,December,2013,McDonalds,Eating Out,8,1910
17,December,2013,Costa Coffee,Eating Out,2,1908
17,December,2013,Subway,Eating Out,4,1904
18,December,2013,Costa Coffee,Eating Out,1,1903
18,December,2013,Pret A Manger,Eating Out,4,1899
19,December,2013,McDonalds,Eating Out,6,1893
20,December,2013,VIRGIN MEDIA PYMTS,Bills,34,1859
20,December,2013,Tescos,Groceries,70,1789
20,December,2013,Costa Coffee,Eating Out,1,1788
20,December,2013,McDonalds,Eating Out,8,1780
20,December,2013,Pizza Express,Eating Out,25,1755
23,December,2013,South West Trains,Transport,31,1724
23,December,2013,ATM Cash Withdrawal,General,80,1644
24,December,2013,O2,Bills,30,1614
24,December,2013,Starbucks Coffee,Eating Out,2,1612
24,December,2013,Pret A Manger,Eating Out,6,1606
25,December,2013,Wild Bean Cafe,Eating Out,2,1604
25,December,2013,Greggs,Eating Out,4,1600
25,December,2013,ATM Cash Withdrawal,General,60,1540
26,December,2013,McDonalds,Eating Out,7,1533
27,December,2013,Tescos,Groceries,65,1468
27,December,2013,Costa Coffee,Eating Out,2,1466
28,December,2013,Pizza Express,Eating Out,44,1422
30,December,2013,South West Trains,Transport,34,1388
30,December,2013,Costa Coffee,Eating Out,2,1386
30,December,2013,Greggs,Eating Out,7,1379
31,December,2013,Wild Bean Cafe,Eating Out,1,1378
1,January,2014,Rhino Sports salary,General,1700,3078
1,January,2014,Starbucks Coffee,Eating Out,1,3077
1,January,2014,Greggs,Eating Out,5,3072
2,January,2014,Greggs,Eating Out,7,3065
3,January,2014,Tescos,Groceries,79,2986
3,January,2014,Chicken Cottage,Eating Out,7,2979
3,January,2014,Dominos Pizza,Eating Out,56,2923
4,January,2014,Pizza Express,Eating Out,54,2869
5,January,2014,Restaurant Gordon RamsayPortland Restaurant,Eating Out,32,2837
6,January,2014,South West Trains,Transport,38,2799
6,January,2014,Costa Coffee,Eating Out,2,2797
7,January,2014,Cubit and West rent,Rent,660,2137
8,January,2014,Costa Coffee,Eating Out,2,2135
8,January,2014,Subway,Eating Out,7,2128
9,January,2014,Caffe Nero,Eating Out,1,2127
10,January,2014,Sainsburys,Groceries,62,2065
10,January,2014,Costa Coffee,Eating Out,2,2063
13,January,2014,South West Trains,Transport,38,2025
13,January,2014,Caffe Nero,Eating Out,2,2023
14,January,2014,Caffe Nero,Eating Out,2,2021
14,January,2014,The West Cornwall Pasty Company,Eating Out,6,2015
15,January,2014,BRGAS-Electricity,Bills,52,1963
15,January,2014,BRGAS-Gas,Bills,45,1918
15,January,2014,Costa Coffee,Eating Out,1,1917
15,January,2014,Chicken Cottage,Eating Out,5,1912
16,January,2014,LBS Council Tax,Bills,50,1862
16,January,2014,Costa Coffee,Eating Out,1,1861
17,January,2014,Tescos,Groceries,72,1789
17,January,2014,Starbucks Coffee,Eating Out,2,1787
19,January,2014,ATM Cash Withdrawal,General,20,1767
20,January,2014,VIRGIN MEDIA PYMTS,Bills,29,1738
20,January,2014,South West Trains,Transport,32,1706
20,January,2014,Caffe Nero,Eating Out,2,1704
20,January,2014,McDonalds,Eating Out,6,1698
22,January,2014,Chicken Cottage,Eating Out,6,1692
23,January,2014,Wild Bean Cafe,Eating Out,1,1691
24,January,2014,O2,Bills,32,1659
24,January,2014,Tescos,Groceries,71,1588
24,January,2014,Starbucks Coffee,Eating Out,2,1586
24,January,2014,Greggs,Eating Out,8,1578
25,January,2014,Scott's Restaurant,Eating Out,45,1533
27,January,2014,South West Trains,Transport,30,1503
27,January,2014,Costa Coffee,Eating Out,2,1501
27,January,2014,Subway,Eating Out,4,1497
28,January,2014,Wild Bean Cafe,Eating Out,2,1495
29,January,2014,Starbucks Coffee,Eating Out,2,1493
29,January,2014,Chicken Cottage,Eating Out,7,1486
30,January,2014,Costa Coffee,Eating Out,2,1484
30,January,2014,Subway,Eating Out,7,1477
31,January,2014,Sainsburys,Groceries,52,1425
31,January,2014,Starbucks Coffee,Eating Out,2,1423
1,February,2014,Rhino Sports salary,General,1700,3123
2,February,2014,Restaurant Gordon RamsayPortland Restaurant,Eating Out,36,3087
3,February,2014,South West Trains,Transport,29,3058
3,February,2014,Caffe Nero,Eating Out,1,3057
4,February,2014,Pret A Manger,Eating Out,5,3052
5,February,2014,Caffe Nero,Eating Out,1,3051
6,February,2014,Costa Coffee,Eating Out,1,3050
6,February,2014,McDonalds,Eating Out,8,3042
7,February,2014,Cubit and West rent,Rent,660,2382
7,February,2014,ASDA,Groceries,61,2321
7,February,2014,Starbucks Coffee,Eating Out,2,2319
10,February,2014,South West Trains,Transport,24,2295
10,February,2014,Pret A Manger,Eating Out,4,2291
11,February,2014,The West Cornwall Pasty Company,Eating Out,5,2286
12,February,2014,Caffe Nero,Eating Out,1,2285
12,February,2014,McDonalds,Eating Out,8,2277
13,February,2014,Costa Coffee,Eating Out,2,2275
13,February,2014,Greggs,Eating Out,5,2270
14,February,2014,Waitrose,Groceries,81,2189
14,February,2014,Starbucks Coffee,Eating Out,2,2187
14,February,2014,Pret A Manger,Eating Out,7,2180
15,February,2014,BRGAS-Electricity,Bills,32,2148
15,February,2014,BRGAS-Gas,Bills,22,2126
16,February,2014,LBS Council Tax,Bills,50,2076
17,February,2014,South West Trains,Transport,38,2038
17,February,2014,Costa Coffee,Eating Out,2,2036
17,February,2014,McDonalds,Eating Out,7,2029
17,February,2014,ATM Cash Withdrawal,General,40,1989
18,February,2014,Costa Coffee,Eating Out,1,1988
18,February,2014,Greggs,Eating Out,7,1981
19,February,2014,Wild Bean Cafe,Eating Out,2,1979
19,February,2014,Pret A Manger,Eating Out,5,1974
20,February,2014,VIRGIN MEDIA PYMTS,Bills,41,1933
20,February,2014,Costa Coffee,Eating Out,2,1931
20,February,2014,Greggs,Eating Out,6,1925
21,February,2014,Waitrose,Groceries,60,1865
24,February,2014,O2,Bills,35,1830
24,February,2014,South West Trains,Transport,38,1792
24,February,2014,Caffe Nero,Eating Out,2,1790
25,February,2014,Chicken Cottage,Eating Out,8,1782
25,February,2014,ATM Cash Withdrawal,General,20,1762
26,February,2014,Starbucks Coffee,Eating Out,1,1761
26,February,2014,McDonalds,Eating Out,8,1753
26,February,2014,ATM Cash Withdrawal,General,40,1713
27,February,2014,Wild Bean Cafe,Eating Out,2,1711
27,February,2014,Pret A Manger,Eating Out,8,1703
28,February,2014,Waitrose,Groceries,62,1641
28,February,2014,Wild Bean Cafe,Eating Out,1,1640
28,February,2014,Greggs,Eating Out,6,1634
28,February,2014,The Grand Pub,Eating Out,8,1626
28,February,2014,The Grand Pub,Eating Out,13,1613
28,February,2014,The Grand Pub,Eating Out,9,1604
28,February,2014,The Grand Pub,Eating Out,5,1599
28,February,2014,Pizza Express,Eating Out,26,1573
1,March,2014,Rhino Sports salary,General,1700,3273
3,March,2014,South West Trains,Transport,31,3242
3,March,2014,McDonalds,Eating Out,5,3237
4,March,2014,Starbucks Coffee,Eating Out,2,3235
4,March,2014,The West Cornwall Pasty Company,Eating Out,4,3231
6,March,2014,The West Cornwall Pasty Company,Eating Out,7,3224
7,March,2014,Cubit and West rent,Rent,660,2564
7,March,2014,ASDA,Groceries,45,2519
7,March,2014,Costa Coffee,Eating Out,1,2518
7,March,2014,The West Cornwall Pasty Company,Eating Out,4,2514
7,March,2014,The Grand Pub,Eating Out,7,2507
7,March,2014,The Grand Pub,Eating Out,15,2492
7,March,2014,The Grand Pub,Eating Out,16,2476
7,March,2014,Dominos Pizza,Eating Out,27,2449
7,March,2014,ATM Cash Withdrawal,General,90,2359
9,March,2014,Restaurant Gordon RamsayPortland Restaurant,Eating Out,54,2305
9,March,2014,ATM Cash Withdrawal,General,40,2265
10,March,2014,South West Trains,Transport,29,2236
10,March,2014,Starbucks Coffee,Eating Out,1,2235
10,March,2014,Pret A Manger,Eating Out,7,2228
11,March,2014,The West Cornwall Pasty Company,Eating Out,4,2224
12,March,2014,Costa Coffee,Eating Out,1,2223
12,March,2014,McDonalds,Eating Out,7,2216
13,March,2014,Pret A Manger,Eating Out,5,2211
14,March,2014,Sainsburys,Groceries,89,2122
14,March,2014,Subway,Eating Out,5,2117
14,March,2014,Anglo restaurant,Eating Out,55,2062
15,March,2014,BRGAS-Electricity,Bills,39,2023
15,March,2014,BRGAS-Gas,Bills,44,1979
16,March,2014,LBS Council Tax,Bills,50,1929
17,March,2014,South West Trains,Transport,24,1905
19,March,2014,Wild Bean Cafe,Eating Out,2,1903
19,March,2014,The West Cornwall Pasty Company,Eating Out,5,1898
20,March,2014,VIRGIN MEDIA PYMTS,Bills,45,1853
20,March,2014,Starbucks Coffee,Eating Out,2,1851
20,March,2014,Pret A Manger,Eating Out,5,1846
21,March,2014,Tescos,Groceries,62,1784
21,March,2014,Costa Coffee,Eating Out,2,1782
24,March,2014,O2,Bills,38,1744
24,March,2014,South West Trains,Transport,30,1714
24,March,2014,Costa Coffee,Eating Out,2,1712
24,March,2014,Subway,Eating Out,5,1707
25,March,2014,Starbucks Coffee,Eating Out,1,1706
25,March,2014,The West Cornwall Pasty Company,Eating Out,7,1699
27,March,2014,Wild Bean Cafe,Eating Out,2,1697
27,March,2014,The West Cornwall Pasty Company,Eating Out,7,1690
28,March,2014,ASDA,Groceries,63,1627
28,March,2014,Caffe Nero,Eating Out,1,1626
28,March,2014,Restaurant Gordon RamsayPortland Restaurant,Eating Out,37,1589
31,March,2014,South West Trains,Transport,25,1564
31,March,2014,Costa Coffee,Eating Out,2,1562
31,March,2014,Chicken Cottage,Eating Out,4,1558
1,April,2014,Rhino Sports salary,General,1700,3258
1,April,2014,Wild Bean Cafe,Eating Out,2,3256
2,April,2014,Costa Coffee,Eating Out,1,3255
2,April,2014,The West Cornwall Pasty Company,Eating Out,5,3250
3,April,2014,Caffe Nero,Eating Out,2,3248
3,April,2014,Pret A Manger,Eating Out,8,3240
4,April,2014,Waitrose,Groceries,49,3191
4,April,2014,Caffe Nero,Eating Out,1,3190
4,April,2014,Greggs,Eating Out,6,3184
7,April,2014,Cubit and West rent,Rent,660,2524
7,April,2014,South West Trains,Transport,35,2489
7,April,2014,Caffe Nero,Eating Out,1,2488
7,April,2014,The West Cornwall Pasty Company,Eating Out,7,2481
8,April,2014,Starbucks Coffee,Eating Out,2,2479
9,April,2014,Costa Coffee,Eating Out,2,2477
10,April,2014,Caffe Nero,Eating Out,1,2476
10,April,2014,Greggs,Eating Out,8,2468
11,April,2014,ASDA,Groceries,71,2397
11,April,2014,Starbucks Coffee,Eating Out,2,2395
14,April,2014,South West Trains,Transport,35,2360
14,April,2014,Costa Coffee,Eating Out,2,2358
14,April,2014,Subway,Eating Out,5,2353
15,April,2014,BRGAS-Electricity,Bills,24,2329
15,April,2014,BRGAS-Gas,Bills,23,2306
16,April,2014,LBS Council Tax,Bills,50,2256
16,April,2014,Costa Coffee,Eating Out,2,2254
16,April,2014,Greggs,Eating Out,8,2246
17,April,2014,Wild Bean Cafe,Eating Out,1,2245
17,April,2014,McDonalds,Eating Out,6,2239
18,April,2014,Morrisons,Groceries,89,2150
18,April,2014,Subway,Eating Out,8,2142
20,April,2014,VIRGIN MEDIA PYMTS,Bills,49,2093
21,April,2014,South West Trains,Transport,34,2059
21,April,2014,Pret A Manger,Eating Out,6,2053
22,April,2014,Caffe Nero,Eating Out,2,2051
22,April,2014,Subway,Eating Out,8,2043
23,April,2014,Wild Bean Cafe,Eating Out,1,2042
24,April,2014,O2,Bills,30,2012
24,April,2014,Caffe Nero,Eating Out,1,2011
24,April,2014,McDonalds,Eating Out,4,2007
25,April,2014,Tescos,Groceries,52,1955
25,April,2014,Caffe Nero,Eating Out,2,1953
25,April,2014,Anglo restaurant,Eating Out,45,1908
25,April,2014,ATM Cash Withdrawal,General,70,1838
28,April,2014,South West Trains,Transport,37,1801
28,April,2014,Wild Bean Cafe,Eating Out,2,1799
28,April,2014,Chicken Cottage,Eating Out,5,1794
28,April,2014,ATM Cash Withdrawal,General,90,1704
29,April,2014,Caffe Nero,Eating Out,2,1702
30,April,2014,Subway,Eating Out,6,1696
1,May,2014,Rhino Sports salary,General,1700,3396
1,May,2014,Starbucks Coffee,Eating Out,2,3394
2,May,2014,Morrisons,Groceries,74,3320
2,May,2014,Costa Coffee,Eating Out,1,3319
5,May,2014,South West Trains,Transport,27,3292
5,May,2014,Starbucks Coffee,Eating Out,2,3290
6,May,2014,Wild Bean Cafe,Eating Out,1,3289
7,May,2014,Cubit and West rent,Rent,660,2629
7,May,2014,Wild Bean Cafe,Eating Out,1,2628
8,May,2014,Caffe Nero,Eating Out,1,2627
9,May,2014,Waitrose,Groceries,68,2559
9,May,2014,Caffe Nero,Eating Out,2,2557
9,May,2014,Pret A Manger,Eating Out,5,2552
12,May,2014,South West Trains,Transport,34,2518
12,May,2014,Caffe Nero,Eating Out,2,2516
12,May,2014,McDonalds,Eating Out,4,2512
13,May,2014,Costa Coffee,Eating Out,2,2510
14,May,2014,Wild Bean Cafe,Eating Out,2,2508
14,May,2014,Greggs,Eating Out,8,2500
15,May,2014,BRGAS-Electricity,Bills,24,2476
15,May,2014,BRGAS-Gas,Bills,41,2435
15,May,2014,Costa Coffee,Eating Out,2,2433
15,May,2014,Subway,Eating Out,8,2425
16,May,2014,LBS Council Tax,Bills,50,2375
16,May,2014,Morrisons,Groceries,73,2302
16,May,2014,McDonalds,Eating Out,8,2294
16,May,2014,Pizza Express,Eating Out,50,2244
17,May,2014,Restaurant Gordon RamsayPortland Restaurant,Eating Out,34,2210
19,May,2014,South West Trains,Transport,30,2180
19,May,2014,Starbucks Coffee,Eating Out,1,2179
19,May,2014,McDonalds,Eating Out,6,2173
19,May,2014,ATM Cash Withdrawal,General,40,2133
20,May,2014,VIRGIN MEDIA PYMTS,Bills,51,2082
20,May,2014,Costa Coffee,Eating Out,2,2080
21,May,2014,Caffe Nero,Eating Out,2,2078
21,May,2014,Chicken Cottage,Eating Out,8,2070
22,May,2014,Wild Bean Cafe,Eating Out,1,2069
22,May,2014,Chicken Cottage,Eating Out,8,2061
23,May,2014,ASDA,Groceries,64,1997
23,May,2014,Costa Coffee,Eating Out,2,1995
24,May,2014,O2,Bills,36,1959
25,May,2014,Anglo restaurant,Eating Out,48,1911
26,May,2014,South West Trains,Transport,31,1880
26,May,2014,Caffe Nero,Eating Out,2,1878
26,May,2014,Subway,Eating Out,7,1871
27,May,2014,Wild Bean Cafe,Eating Out,2,1869
27,May,2014,The West Cornwall Pasty Company,Eating Out,6,1863
28,May,2014,Caffe Nero,Eating Out,2,1861
29,May,2014,Starbucks Coffee,Eating Out,2,1859
29,May,2014,McDonalds,Eating Out,5,1854
30,May,2014,Waitrose,Groceries,80,1774
30,May,2014,Chicken Cottage,Eating Out,7,1767
30,May,2014,Dominos Pizza,Eating Out,55,1712
1,June,2014,Rhino Sports salary,General,1700,3412
2,June,2014,South West Trains,Transport,34,3378
2,June,2014,Starbucks Coffee,Eating Out,2,3376
2,June,2014,Subway,Eating Out,7,3369
2,June,2014,ATM Cash Withdrawal,General,30,3339
3,June,2014,Costa Coffee,Eating Out,1,3338
3,June,2014,Chicken Cottage,Eating Out,7,3331
4,June,2014,Costa Coffee,Eating Out,2,3329
4,June,2014,McDonalds,Eating Out,8,3321
5,June,2014,Costa Coffee,Eating Out,2,3319
5,June,2014,McDonalds,Eating Out,8,3311
6,June,2014,Sainsburys,Groceries,88,3223
6,June,2014,Caffe Nero,Eating Out,1,3222
7,June,2014,Cubit and West rent,Rent,660,2562
7,June,2014,Anglo restaurant,Eating Out,54,2508
9,June,2014,South West Trains,Transport,38,2470
9,June,2014,Starbucks Coffee,Eating Out,2,2468
10,June,2014,Caffe Nero,Eating Out,1,2467
10,June,2014,Subway,Eating Out,6,2461
11,June,2014,Costa Coffee,Eating Out,2,2459
11,June,2014,Chicken Cottage,Eating Out,6,2453
12,June,2014,Caffe Nero,Eating Out,2,2451
13,June,2014,Waitrose,Groceries,77,2374
13,June,2014,Starbucks Coffee,Eating Out,1,2373
14,June,2014,The Grand Pub,Eating Out,15,2358
14,June,2014,The Grand Pub,Eating Out,10,2348
14,June,2014,The Grand Pub,Eating Out,5,2343
14,June,2014,The Grand Pub,Eating Out,9,2334
14,June,2014,The Grand Pub,Eating Out,15,2319
14,June,2014,The Grand Pub,Eating Out,8,2311
15,June,2014,BRGAS-Electricity,Bills,24,2287
15,June,2014,BRGAS-Gas,Bills,27,2260
16,June,2014,LBS Council Tax,Bills,50,2210
16,June,2014,South West Trains,Transport,26,2184
16,June,2014,Pret A Manger,Eating Out,4,2180
17,June,2014,Wild Bean Cafe,Eating Out,2,2178
17,June,2014,The West Cornwall Pasty Company,Eating Out,7,2171
18,June,2014,The West Cornwall Pasty Company,Eating Out,6,2165
19,June,2014,Costa Coffee,Eating Out,2,2163
19,June,2014,McDonalds,Eating Out,4,2159
20,June,2014,VIRGIN MEDIA PYMTS,Bills,50,2109
20,June,2014,Waitrose,Groceries,55,2054
20,June,2014,Wild Bean Cafe,Eating Out,1,2053
20,June,2014,The West Cornwall Pasty Company,Eating Out,8,2045
23,June,2014,South West Trains,Transport,34,2011
23,June,2014,Wild Bean Cafe,Eating Out,1,2010
23,June,2014,McDonalds,Eating Out,8,2002
24,June,2014,O2,Bills,38,1964
24,June,2014,Starbucks Coffee,Eating Out,1,1963
24,June,2014,Subway,Eating Out,7,1956
24,June,2014,ATM Cash Withdrawal,General,10,1946
25,June,2014,Costa Coffee,Eating Out,2,1944
25,June,2014,McDonalds,Eating Out,8,1936
26,June,2014,Costa Coffee,Eating Out,2,1934
27,June,2014,Tescos,Groceries,73,1861
27,June,2014,Wild Bean Cafe,Eating Out,2,1859
27,June,2014,Pret A Manger,Eating Out,7,1852
30,June,2014,South West Trains,Transport,29,1823
30,June,2014,The West Cornwall Pasty Company,Eating Out,8,1815
1,July,2014,Rhino Sports salary,General,1700,3515
1,July,2014,Costa Coffee,Eating Out,2,3513
2,July,2014,Starbucks Coffee,Eating Out,1,3512
2,July,2014,Pret A Manger,Eating Out,7,3505
3,July,2014,Caffe Nero,Eating Out,1,3504
3,July,2014,McDonalds,Eating Out,5,3499
4,July,2014,Tescos,Groceries,76,3423
4,July,2014,The West Cornwall Pasty Company,Eating Out,4,3419
4,July,2014,The Grand Pub,Eating Out,12,3407
4,July,2014,The Grand Pub,Eating Out,11,3396
4,July,2014,The Grand Pub,Eating Out,9,3387
5,July,2014,ATM Cash Withdrawal,General,80,3307
6,July,2014,ATM Cash Withdrawal,General,70,3237
7,July,2014,Cubit and West rent,Rent,660,2577
7,July,2014,South West Trains,Transport,35,2542
7,July,2014,Costa Coffee,Eating Out,1,2541
7,July,2014,Greggs,Eating Out,8,2533
8,July,2014,Caffe Nero,Eating Out,2,2531
8,July,2014,Chicken Cottage,Eating Out,6,2525
9,July,2014,McDonalds,Eating Out,4,2521
10,July,2014,Caffe Nero,Eating Out,2,2519
11,July,2014,ASDA,Groceries,73,2446
11,July,2014,Wild Bean Cafe,Eating Out,2,2444
11,July,2014,McDonalds,Eating Out,4,2440
14,July,2014,South West Trains,Transport,29,2411
14,July,2014,Costa Coffee,Eating Out,2,2409
14,July,2014,Greggs,Eating Out,6,2403
15,July,2014,BRGAS-Electricity,Bills,31,2372
15,July,2014,BRGAS-Gas,Bills,35,2337
15,July,2014,Costa Coffee,Eating Out,2,2335
16,July,2014,LBS Council Tax,Bills,50,2285
16,July,2014,Starbucks Coffee,Eating Out,2,2283
17,July,2014,McDonalds,Eating Out,4,2279
18,July,2014,Waitrose,Groceries,44,2235
18,July,2014,Costa Coffee,Eating Out,2,2233
19,July,2014,ATM Cash Withdrawal,General,80,2153
20,July,2014,VIRGIN MEDIA PYMTS,Bills,38,2115
21,July,2014,South West Trains,Transport,28,2087
21,July,2014,Costa Coffee,Eating Out,1,2086
23,July,2014,Wild Bean Cafe,Eating Out,2,2084
23,July,2014,Pret A Manger,Eating Out,7,2077
24,July,2014,O2,Bills,30,2047
24,July,2014,Costa Coffee,Eating Out,2,2045
24,July,2014,Greggs,Eating Out,4,2041
25,July,2014,Sainsburys,Groceries,73,1968
25,July,2014,Caffe Nero,Eating Out,2,1966
28,July,2014,South West Trains,Transport,27,1939
28,July,2014,Costa Coffee,Eating Out,2,1937
29,July,2014,Pret A Manger,Eating Out,7,1930
31,July,2014,Caffe Nero,Eating Out,1,1929
31,July,2014,Subway,Eating Out,6,1923
1,August,2014,Rhino Sports salary,General,1700,3623
1,August,2014,Waitrose,Groceries,45,3578
1,August,2014,Costa Coffee,Eating Out,2,3576
1,August,2014,Subway,Eating Out,5,3571
4,August,2014,South West Trains,Transport,31,3540
4,August,2014,Starbucks Coffee,Eating Out,2,3538
5,August,2014,Caffe Nero,Eating Out,1,3537
6,August,2014,Wild Bean Cafe,Eating Out,2,3535
6,August,2014,Pret A Manger,Eating Out,6,3529
6,August,2014,ATM Cash Withdrawal,General,50,3479
7,August,2014,Cubit and West rent,Rent,660,2819
7,August,2014,Starbucks Coffee,Eating Out,2,2817
7,August,2014,Pret A Manger,Eating Out,7,2810
8,August,2014,Sainsburys,Groceries,80,2730
8,August,2014,Starbucks Coffee,Eating Out,1,2729
8,August,2014,McDonalds,Eating Out,5,2724
11,August,2014,South West Trains,Transport,30,2694
11,August,2014,Subway,Eating Out,4,2690
12,August,2014,Wild Bean Cafe,Eating Out,1,2689
12,August,2014,McDonalds,Eating Out,8,2681
13,August,2014,Starbucks Coffee,Eating Out,2,2679
13,August,2014,Greggs,Eating Out,5,2674
14,August,2014,Costa Coffee,Eating Out,2,2672
14,August,2014,The West Cornwall Pasty Company,Eating Out,4,2668
15,August,2014,BRGAS-Electricity,Bills,40,2628
15,August,2014,BRGAS-Gas,Bills,30,2598
15,August,2014,Waitrose,Groceries,84,2514
15,August,2014,Costa Coffee,Eating Out,1,2513
15,August,2014,Chicken Cottage,Eating Out,6,2507
16,August,2014,LBS Council Tax,Bills,50,2457
18,August,2014,South West Trains,Transport,25,2432
18,August,2014,Starbucks Coffee,Eating Out,2,2430
18,August,2014,Pret A Manger,Eating Out,4,2426
19,August,2014,Costa Coffee,Eating Out,2,2424
19,August,2014,The West Cornwall Pasty Company,Eating Out,4,2420
20,August,2014,VIRGIN MEDIA PYMTS,Bills,28,2392
20,August,2014,Costa Coffee,Eating Out,2,2390
20,August,2014,Subway,Eating Out,5,2385
21,August,2014,Starbucks Coffee,Eating Out,1,2384
21,August,2014,Subway,Eating Out,8,2376
21,August,2014,ATM Cash Withdrawal,General,70,2306
22,August,2014,Waitrose,Groceries,44,2262
22,August,2014,Wild Bean Cafe,Eating Out,1,2261
22,August,2014,Greggs,Eating Out,7,2254
23,August,2014,ATM Cash Withdrawal,General,40,2214
24,August,2014,O2,Bills,38,2176
25,August,2014,South West Trains,Transport,37,2139
25,August,2014,Costa Coffee,Eating Out,1,2138
25,August,2014,McDonalds,Eating Out,8,2130
26,August,2014,Starbucks Coffee,Eating Out,2,2128
26,August,2014,Pret A Manger,Eating Out,4,2124
27,August,2014,Starbucks Coffee,Eating Out,2,2122
27,August,2014,Chicken Cottage,Eating Out,4,2118
28,August,2014,Costa Coffee,Eating Out,1,2117
29,August,2014,Morrisons,Groceries,79,2038
29,August,2014,Starbucks Coffee,Eating Out,2,2036
30,August,2014,Restaurant Gordon RamsayPortland Restaurant,Eating Out,57,1979
1,September,2014,Rhino Sports salary,General,1700,3679
1,September,2014,South West Trains,Transport,38,3641
1,September,2014,Caffe Nero,Eating Out,2,3639
1,September,2014,Greggs,Eating Out,7,3632
2,September,2014,Starbucks Coffee,Eating Out,1,3631
2,September,2014,Greggs,Eating Out,6,3625
3,September,2014,McDonalds,Eating Out,5,3620
4,September,2014,Costa Coffee,Eating Out,2,3618
4,September,2014,McDonalds,Eating Out,5,3613
5,September,2014,Morrisons,Groceries,48,3565
5,September,2014,Wild Bean Cafe,Eating Out,1,3564
5,September,2014,The West Cornwall Pasty Company,Eating Out,8,3556
7,September,2014,Cubit and West rent,Rent,660,2896
8,September,2014,South West Trains,Transport,30,2866
8,September,2014,Wild Bean Cafe,Eating Out,2,2864
9,September,2014,Wild Bean Cafe,Eating Out,1,2863
10,September,2014,Subway,Eating Out,6,2857
11,September,2014,Costa Coffee,Eating Out,2,2855
11,September,2014,Chicken Cottage,Eating Out,8,2847
12,September,2014,Tescos,Groceries,82,2765
12,September,2014,Wild Bean Cafe,Eating Out,2,2763
12,September,2014,Pret A Manger,Eating Out,4,2759
12,September,2014,Dominos Pizza,Eating Out,28,2731
14,September,2014,Anglo restaurant,Eating Out,35,2696
15,September,2014,BRGAS-Electricity,Bills,27,2669
15,September,2014,BRGAS-Gas,Bills,27,2642
15,September,2014,South West Trains,Transport,36,2606
15,September,2014,Costa Coffee,Eating Out,2,2604
15,September,2014,McDonalds,Eating Out,5,2599
16,September,2014,LBS Council Tax,Bills,50,2549
16,September,2014,Caffe Nero,Eating Out,2,2547
16,September,2014,Subway,Eating Out,8,2539
17,September,2014,Costa Coffee,Eating Out,2,2537
17,September,2014,Pret A Manger,Eating Out,4,2533
19,September,2014,ASDA,Groceries,73,2460
19,September,2014,Wild Bean Cafe,Eating Out,2,2458
19,September,2014,The West Cornwall Pasty Company,Eating Out,6,2452
20,September,2014,VIRGIN MEDIA PYMTS,Bills,31,2421
22,September,2014,South West Trains,Transport,34,2387
22,September,2014,Caffe Nero,Eating Out,1,2386
23,September,2014,Wild Bean Cafe,Eating Out,2,2384
23,September,2014,Chicken Cottage,Eating Out,4,2380
24,September,2014,O2,Bills,37,2343
24,September,2014,Caffe Nero,Eating Out,1,2342
24,September,2014,The West Cornwall Pasty Company,Eating Out,7,2335
25,September,2014,Wild Bean Cafe,Eating Out,1,2334
25,September,2014,Greggs,Eating Out,7,2327
26,September,2014,Sainsburys,Groceries,45,2282
26,September,2014,Wild Bean Cafe,Eating Out,2,2280
28,September,2014,Pizza Express,Eating Out,32,2248
29,September,2014,South West Trains,Transport,24,2224
29,September,2014,Costa Coffee,Eating Out,2,2222
29,September,2014,The West Cornwall Pasty Company,Eating Out,7,2215
30,September,2014,Caffe Nero,Eating Out,1,2214
1,October,2014,Rhino Sports salary,General,1700,3914
1,October,2014,Subway,Eating Out,5,3909
2,October,2014,Starbucks Coffee,Eating Out,2,3907
2,October,2014,Pret A Manger,Eating Out,4,3903
3,October,2014,Sainsburys,Groceries,44,3859
3,October,2014,Wild Bean Cafe,Eating Out,2,3857
3,October,2014,The West Cornwall Pasty Company,Eating Out,4,3853
5,October,2014,Pizza Express,Eating Out,50,3803
6,October,2014,South West Trains,Transport,29,3774
6,October,2014,Wild Bean Cafe,Eating Out,2,3772
7,October,2014,Cubit and West rent,Rent,660,3112
7,October,2014,Chicken Cottage,Eating Out,5,3107
8,October,2014,Costa Coffee,Eating Out,1,3106
8,October,2014,McDonalds,Eating Out,4,3102
9,October,2014,Starbucks Coffee,Eating Out,2,3100
9,October,2014,Pret A Manger,Eating Out,8,3092
10,October,2014,Tescos,Groceries,68,3024
10,October,2014,Caffe Nero,Eating Out,2,3022
10,October,2014,Subway,Eating Out,8,3014
10,October,2014,Scott's Restaurant,Eating Out,43,2971
13,October,2014,South West Trains,Transport,35,2936
13,October,2014,Caffe Nero,Eating Out,1,2935
14,October,2014,Starbucks Coffee,Eating Out,1,2934
14,October,2014,Chicken Cottage,Eating Out,6,2928
15,October,2014,BRGAS-Electricity,Bills,43,2885
15,October,2014,BRGAS-Gas,Bills,35,2850
15,October,2014,Caffe Nero,Eating Out,2,2848
15,October,2014,Greggs,Eating Out,8,2840
16,October,2014,LBS Council Tax,Bills,50,2790
16,October,2014,Caffe Nero,Eating Out,2,2788
16,October,2014,Chicken Cottage,Eating Out,8,2780
16,October,2014,ATM Cash Withdrawal,General,70,2710
17,October,2014,Morrisons,Groceries,74,2636
17,October,2014,Caffe Nero,Eating Out,2,2634
17,October,2014,Pret A Manger,Eating Out,8,2626
17,October,2014,Dominos Pizza,Eating Out,37,2589
20,October,2014,VIRGIN MEDIA PYMTS,Bills,53,2536
20,October,2014,South West Trains,Transport,35,2501
20,October,2014,Wild Bean Cafe,Eating Out,1,2500
20,October,2014,Greggs,Eating Out,7,2493
21,October,2014,Costa Coffee,Eating Out,2,2491
21,October,2014,Chicken Cottage,Eating Out,7,2484
22,October,2014,Subway,Eating Out,5,2479
23,October,2014,Wild Bean Cafe,Eating Out,1,2478
23,October,2014,Chicken Cottage,Eating Out,7,2471
24,October,2014,O2,Bills,31,2440
24,October,2014,Waitrose,Groceries,67,2373
24,October,2014,Caffe Nero,Eating Out,1,2372
24,October,2014,McDonalds,Eating Out,8,2364
26,October,2014,ATM Cash Withdrawal,General,20,2344
27,October,2014,South West Trains,Transport,38,2306
27,October,2014,Caffe Nero,Eating Out,2,2304
27,October,2014,ATM Cash Withdrawal,General,70,2234
28,October,2014,The West Cornwall Pasty Company,Eating Out,4,2230
29,October,2014,Starbucks Coffee,Eating Out,2,2228
31,October,2014,Waitrose,Groceries,81,2147
1,November,2014,Rhino Sports salary,General,1700,3847
1,November,2014,ATM Cash Withdrawal,General,30,3817
3,November,2014,South West Trains,Transport,37,3780
3,November,2014,Greggs,Eating Out,4,3776
3,November,2014,ATM Cash Withdrawal,General,60,3716
4,November,2014,Starbucks Coffee,Eating Out,1,3715
5,November,2014,Caffe Nero,Eating Out,2,3713
5,November,2014,ATM Cash Withdrawal,General,50,3663
6,November,2014,McDonalds,Eating Out,6,3657
7,November,2014,Cubit and West rent,Rent,660,2997
7,November,2014,ASDA,Groceries,81,2916
7,November,2014,Caffe Nero,Eating Out,2,2914
10,November,2014,South West Trains,Transport,37,2877
10,November,2014,Wild Bean Cafe,Eating Out,2,2875
10,November,2014,The West Cornwall Pasty Company,Eating Out,7,2868
11,November,2014,Wild Bean Cafe,Eating Out,2,2866
11,November,2014,Subway,Eating Out,8,2858
13,November,2014,Starbucks Coffee,Eating Out,1,2857
13,November,2014,The West Cornwall Pasty Company,Eating Out,8,2849
14,November,2014,Sainsburys,Groceries,61,2788
14,November,2014,Starbucks Coffee,Eating Out,1,2787
14,November,2014,Restaurant Gordon RamsayPortland Restaurant,Eating Out,43,2744
15,November,2014,BRGAS-Electricity,Bills,44,2700
15,November,2014,BRGAS-Gas,Bills,64,2636
15,November,2014,Pizza Express,Eating Out,49,2587
16,November,2014,LBS Council Tax,Bills,50,2537
17,November,2014,South West Trains,Transport,30,2507
17,November,2014,Caffe Nero,Eating Out,2,2505
18,November,2014,Caffe Nero,Eating Out,2,2503
18,November,2014,Subway,Eating Out,7,2496
19,November,2014,Costa Coffee,Eating Out,2,2494
20,November,2014,VIRGIN MEDIA PYMTS,Bills,31,2463
20,November,2014,Caffe Nero,Eating Out,1,2462
20,November,2014,Subway,Eating Out,5,2457
21,November,2014,Tescos,Groceries,65,2392
21,November,2014,Wild Bean Cafe,Eating Out,1,2391
21,November,2014,The West Cornwall Pasty Company,Eating Out,6,2385
24,November,2014,O2,Bills,30,2355
24,November,2014,South West Trains,Transport,25,2330
24,November,2014,The West Cornwall Pasty Company,Eating Out,7,2323
25,November,2014,ATM Cash Withdrawal,General,40,2283
26,November,2014,Caffe Nero,Eating Out,1,2282
27,November,2014,Caffe Nero,Eating Out,1,2281
27,November,2014,Greggs,Eating Out,5,2276
28,November,2014,ASDA,Groceries,84,2192
29,November,2014,Anglo restaurant,Eating Out,43,2149
1,December,2014,Rhino Sports salary,General,1700,3849
1,December,2014,South West Trains,Transport,30,3819
1,December,2014,Wild Bean Cafe,Eating Out,1,3818
1,December,2014,Subway,Eating Out,8,3810
3,December,2014,Wild Bean Cafe,Eating Out,1,3809
3,December,2014,The West Cornwall Pasty Company,Eating Out,5,3804
4,December,2014,Chicken Cottage,Eating Out,6,3798
4,December,2014,ATM Cash Withdrawal,General,60,3738
5,December,2014,Waitrose,Groceries,52,3686
5,December,2014,Costa Coffee,Eating Out,1,3685
5,December,2014,Subway,Eating Out,8,3677
6,December,2014,Dominos Pizza,Eating Out,37,3640
7,December,2014,Cubit and West rent,Rent,660,2980
8,December,2014,South West Trains,Transport,33,2947
8,December,2014,Costa Coffee,Eating Out,1,2946
8,December,2014,Subway,Eating Out,5,2941
9,December,2014,Starbucks Coffee,Eating Out,1,2940
10,December,2014,Caffe Nero,Eating Out,1,2939
11,December,2014,Wild Bean Cafe,Eating Out,2,2937
11,December,2014,Subway,Eating Out,7,2930
12,December,2014,Sainsburys,Groceries,72,2858
12,December,2014,Costa Coffee,Eating Out,1,2857
12,December,2014,Chicken Cottage,Eating Out,4,2853
12,December,2014,ATM Cash Withdrawal,General,60,2793
15,December,2014,BRGAS-Electricity,Bills,43,2750
15,December,2014,BRGAS-Gas,Bills,41,2709
15,December,2014,South West Trains,Transport,31,2678
15,December,2014,Costa Coffee,Eating Out,2,2676
15,December,2014,Pret A Manger,Eating Out,8,2668
16,December,2014,LBS Council Tax,Bills,50,2618
16,December,2014,Costa Coffee,Eating Out,2,2616
16,December,2014,Subway,Eating Out,8,2608
17,December,2014,Starbucks Coffee,Eating Out,1,2607
18,December,2014,Wild Bean Cafe,Eating Out,1,2606
19,December,2014,Tescos,Groceries,83,2523
19,December,2014,Costa Coffee,Eating Out,2,2521
20,December,2014,VIRGIN MEDIA PYMTS,Bills,37,2484
20,December,2014,Dominos Pizza,Eating Out,25,2459
21,December,2014,Dominos Pizza,Eating Out,36,2423
22,December,2014,South West Trains,Transport,35,2388
22,December,2014,Caffe Nero,Eating Out,2,2386
23,December,2014,Costa Coffee,Eating Out,1,2385
23,December,2014,Pret A Manger,Eating Out,8,2377
24,December,2014,O2,Bills,30,2347
24,December,2014,Caffe Nero,Eating Out,2,2345
24,December,2014,Greggs,Eating Out,7,2338
25,December,2014,Starbucks Coffee,Eating Out,2,2336
26,December,2014,Waitrose,Groceries,56,2280
26,December,2014,Wild Bean Cafe,Eating Out,2,2278
26,December,2014,Ministry of Sound ClubXOYO Club,Eating Out,12,2266
26,December,2014,ATM Cash Withdrawal,General,40,2226
29,December,2014,South West Trains,Transport,33,2193
29,December,2014,Costa Coffee,Eating Out,2,2191
29,December,2014,McDonalds,Eating Out,6,2185
30,December,2014,Costa Coffee,Eating Out,2,2183
30,December,2014,Pret A Manger,Eating Out,4,2179
31,December,2014,McDonalds,Eating Out,5,2174
1,January,2015,Rhino Sports salary,General,1700,3874
1,January,2015,Costa Coffee,Eating Out,2,3872
2,January,2015,Morrisons,Groceries,43,3829
2,January,2015,Pret A Manger,Eating Out,6,3823
3,January,2015,Pizza Express,Eating Out,48,3775
4,January,2015,Dominos Pizza,Eating Out,43,3732
4,January,2015,ATM Cash Withdrawal,General,60,3672
5,January,2015,South West Trains,Transport,34,3638
5,January,2015,Pret A Manger,Eating Out,7,3631
6,January,2015,Wild Bean Cafe,Eating Out,1,3630
6,January,2015,Subway,Eating Out,7,3623
7,January,2015,Cubit and West rent,Rent,660,2963
7,January,2015,Greggs,Eating Out,6,2957
8,January,2015,Wild Bean Cafe,Eating Out,2,2955
9,January,2015,Sainsburys,Groceries,87,2868
9,January,2015,Wild Bean Cafe,Eating Out,2,2866
9,January,2015,Subway,Eating Out,6,2860
12,January,2015,South West Trains,Transport,34,2826
12,January,2015,McDonalds,Eating Out,6,2820
13,January,2015,Caffe Nero,Eating Out,1,2819
13,January,2015,The West Cornwall Pasty Company,Eating Out,7,2812
13,January,2015,ATM Cash Withdrawal,General,10,2802
14,January,2015,Wild Bean Cafe,Eating Out,2,2800
14,January,2015,Pret A Manger,Eating Out,5,2795
15,January,2015,BRGAS-Electricity,Bills,46,2749
15,January,2015,BRGAS-Gas,Bills,36,2713
15,January,2015,Costa Coffee,Eating Out,1,2712
16,January,2015,LBS Council Tax,Bills,50,2662
16,January,2015,Morrisons,Groceries,57,2605
16,January,2015,Wild Bean Cafe,Eating Out,2,2603
16,January,2015,Anglo restaurant,Eating Out,27,2576
19,January,2015,South West Trains,Transport,29,2547
19,January,2015,Starbucks Coffee,Eating Out,2,2545
19,January,2015,McDonalds,Eating Out,5,2540
20,January,2015,VIRGIN MEDIA PYMTS,Bills,36,2504
20,January,2015,Starbucks Coffee,Eating Out,2,2502
20,January,2015,The West Cornwall Pasty Company,Eating Out,6,2496
21,January,2015,Costa Coffee,Eating Out,2,2494
21,January,2015,Chicken Cottage,Eating Out,6,2488
22,January,2015,Starbucks Coffee,Eating Out,1,2487
22,January,2015,Subway,Eating Out,7,2480
23,January,2015,Morrisons,Groceries,59,2421
23,January,2015,Wild Bean Cafe,Eating Out,2,2419
24,January,2015,O2,Bills,33,2386
24,January,2015,ATM Cash Withdrawal,General,20,2366
26,January,2015,South West Trains,Transport,24,2342
27,January,2015,The West Cornwall Pasty Company,Eating Out,6,2336
28,January,2015,Starbucks Coffee,Eating Out,2,2334
28,January,2015,Subway,Eating Out,4,2330
29,January,2015,Caffe Nero,Eating Out,2,2328
30,January,2015,Waitrose,Groceries,53,2275
30,January,2015,Costa Coffee,Eating Out,1,2274
30,January,2015,McDonalds,Eating Out,7,2267
30,January,2015,Anglo restaurant,Eating Out,30,2237
1,February,2015,Rhino Sports salary,General,1700,3937
2,February,2015,South West Trains,Transport,36,3901
2,February,2015,Caffe Nero,Eating Out,2,3899
2,February,2015,Pret A Manger,Eating Out,4,3895
2,February,2015,ATM Cash Withdrawal,General,20,3875
3,February,2015,Wild Bean Cafe,Eating Out,1,3874
3,February,2015,The West Cornwall Pasty Company,Eating Out,5,3869
4,February,2015,Starbucks Coffee,Eating Out,2,3867
4,February,2015,McDonalds,Eating Out,5,3862
5,February,2015,Starbucks Coffee,Eating Out,2,3860
6,February,2015,ASDA,Groceries,80,3780
6,February,2015,McDonalds,Eating Out,7,3773
7,February,2015,Cubit and West rent,Rent,660,3113
8,February,2015,Restaurant Gordon RamsayPortland Restaurant,Eating Out,48,3065
9,February,2015,South West Trains,Transport,28,3037
9,February,2015,Costa Coffee,Eating Out,1,3036
9,February,2015,McDonalds,Eating Out,8,3028
10,February,2015,Starbucks Coffee,Eating Out,2,3026
11,February,2015,Caffe Nero,Eating Out,2,3024
12,February,2015,Caffe Nero,Eating Out,1,3023
13,February,2015,Waitrose,Groceries,46,2977
13,February,2015,Costa Coffee,Eating Out,2,2975
13,February,2015,Chicken Cottage,Eating Out,7,2968
14,February,2015,ATM Cash Withdrawal,General,50,2918
15,February,2015,BRGAS-Electricity,Bills,33,2885
15,February,2015,BRGAS-Gas,Bills,38,2847
16,February,2015,LBS Council Tax,Bills,50,2797
16,February,2015,South West Trains,Transport,25,2772
16,February,2015,Caffe Nero,Eating Out,2,2770
16,February,2015,Chicken Cottage,Eating Out,5,2765
17,February,2015,Wild Bean Cafe,Eating Out,1,2764
18,February,2015,Costa Coffee,Eating Out,2,2762
18,February,2015,ATM Cash Withdrawal,General,70,2692
19,February,2015,Starbucks Coffee,Eating Out,2,2690
19,February,2015,Greggs,Eating Out,4,2686
20,February,2015,VIRGIN MEDIA PYMTS,Bills,54,2632
20,February,2015,ASDA,Groceries,65,2567
20,February,2015,The West Cornwall Pasty Company,Eating Out,5,2562
20,February,2015,Dominos Pizza,Eating Out,38,2524
23,February,2015,South West Trains,Transport,29,2495
23,February,2015,Starbucks Coffee,Eating Out,1,2494
23,February,2015,Greggs,Eating Out,5,2489
24,February,2015,O2,Bills,31,2458
24,February,2015,Caffe Nero,Eating Out,2,2456
24,February,2015,Pret A Manger,Eating Out,8,2448
25,February,2015,Chicken Cottage,Eating Out,5,2443
26,February,2015,Caffe Nero,Eating Out,2,2441
26,February,2015,Subway,Eating Out,5,2436
27,February,2015,Tescos,Groceries,49,2387
27,February,2015,Caffe Nero,Eating Out,2,2385
28,February,2015,Pizza Express,Eating Out,34,2351
1,March,2015,Rhino Sports salary,General,1700,4051
2,March,2015,South West Trains,Transport,24,4027
2,March,2015,Wild Bean Cafe,Eating Out,2,4025
2,March,2015,Subway,Eating Out,8,4017
3,March,2015,Costa Coffee,Eating Out,1,4016
3,March,2015,The West Cornwall Pasty Company,Eating Out,7,4009
4,March,2015,Wild Bean Cafe,Eating Out,2,4007
4,March,2015,The West Cornwall Pasty Company,Eating Out,7,4000
5,March,2015,Starbucks Coffee,Eating Out,1,3999
5,March,2015,Greggs,Eating Out,5,3994
5,March,2015,ATM Cash Withdrawal,General,10,3984
6,March,2015,Waitrose,Groceries,42,3942
6,March,2015,Greggs,Eating Out,5,3937
7,March,2015,Cubit and West rent,Rent,660,3277
7,March,2015,Restaurant Gordon RamsayPortland Restaurant,Eating Out,32,3245
9,March,2015,South West Trains,Transport,24,3221
9,March,2015,Caffe Nero,Eating Out,1,3220
9,March,2015,Greggs,Eating Out,5,3215
11,March,2015,Subway,Eating Out,4,3211
11,March,2015,ATM Cash Withdrawal,General,80,3131
12,March,2015,Chicken Cottage,Eating Out,5,3126
13,March,2015,Sainsburys,Groceries,46,3080
13,March,2015,Starbucks Coffee,Eating Out,2,3078
13,March,2015,Chicken Cottage,Eating Out,8,3070
13,March,2015,ATM Cash Withdrawal,General,50,3020
14,March,2015,Pizza Express,Eating Out,30,2990
15,March,2015,BRGAS-Electricity,Bills,42,2948
15,March,2015,BRGAS-Gas,Bills,22,2926
15,March,2015,Scott's Restaurant,Eating Out,30,2896
16,March,2015,LBS Council Tax,Bills,50,2846
16,March,2015,South West Trains,Transport,33,2813
16,March,2015,Starbucks Coffee,Eating Out,1,2812
16,March,2015,Pret A Manger,Eating Out,4,2808
17,March,2015,Caffe Nero,Eating Out,2,2806
17,March,2015,Subway,Eating Out,6,2800
17,March,2015,ATM Cash Withdrawal,General,50,2750
18,March,2015,Wild Bean Cafe,Eating Out,2,2748
19,March,2015,Wild Bean Cafe,Eating Out,2,2746
20,March,2015,VIRGIN MEDIA PYMTS,Bills,55,2691
20,March,2015,Morrisons,Groceries,46,2645
20,March,2015,Wild Bean Cafe,Eating Out,1,2644
20,March,2015,Greggs,Eating Out,7,2637
20,March,2015,Pizza Express,Eating Out,55,2582
21,March,2015,ATM Cash Withdrawal,General,30,2552
23,March,2015,South West Trains,Transport,26,2526
23,March,2015,Starbucks Coffee,Eating Out,2,2524
23,March,2015,The West Cornwall Pasty Company,Eating Out,8,2516
24,March,2015,O2,Bills,32,2484
24,March,2015,Wild Bean Cafe,Eating Out,2,2482
24,March,2015,Pret A Manger,Eating Out,7,2475
25,March,2015,Caffe Nero,Eating Out,2,2473
25,March,2015,Pret A Manger,Eating Out,7,2466
26,March,2015,Greggs,Eating Out,8,2458
27,March,2015,ASDA,Groceries,76,2382
27,March,2015,Starbucks Coffee,Eating Out,2,2380
28,March,2015,Restaurant Gordon RamsayPortland Restaurant,Eating Out,38,2342
28,March,2015,ATM Cash Withdrawal,General,70,2272
30,March,2015,South West Trains,Transport,37,2235
30,March,2015,Wild Bean Cafe,Eating Out,2,2233
31,March,2015,Costa Coffee,Eating Out,2,2231
31,March,2015,Chicken Cottage,Eating Out,7,2224
1,April,2015,Rhino Sports salary,General,1700,3924
1,April,2015,Caffe Nero,Eating Out,2,3922
2,April,2015,Caffe Nero,Eating Out,1,3921
2,April,2015,Pret A Manger,Eating Out,6,3915
3,April,2015,Sainsburys,Groceries,83,3832
3,April,2015,Starbucks Coffee,Eating Out,2,3830
3,April,2015,Subway,Eating Out,4,3826
6,April,2015,South West Trains,Transport,33,3793
6,April,2015,Wild Bean Cafe,Eating Out,2,3791
6,April,2015,The West Cornwall Pasty Company,Eating Out,7,3784
7,April,2015,Cubit and West rent,Rent,660,3124
7,April,2015,Costa Coffee,Eating Out,2,3122
7,April,2015,Greggs,Eating Out,4,3118
7,April,2015,ATM Cash Withdrawal,General,60,3058
8,April,2015,Costa Coffee,Eating Out,2,3056
9,April,2015,Caffe Nero,Eating Out,1,3055
9,April,2015,Greggs,Eating Out,6,3049
10,April,2015,Tescos,Groceries,58,2991
10,April,2015,Wild Bean Cafe,Eating Out,2,2989
10,April,2015,McDonalds,Eating Out,5,2984
13,April,2015,South West Trains,Transport,32,2952
13,April,2015,Costa Coffee,Eating Out,1,2951
15,April,2015,BRGAS-Electricity,Bills,41,2910
15,April,2015,BRGAS-Gas,Bills,40,2870
15,April,2015,Chicken Cottage,Eating Out,7,2863
16,April,2015,LBS Council Tax,Bills,50,2813
16,April,2015,Greggs,Eating Out,5,2808
17,April,2015,Morrisons,Groceries,88,2720
17,April,2015,Wild Bean Cafe,Eating Out,2,2718
17,April,2015,Subway,Eating Out,8,2710
18,April,2015,Anglo restaurant,Eating Out,47,2663
20,April,2015,VIRGIN MEDIA PYMTS,Bills,35,2628
20,April,2015,South West Trains,Transport,35,2593
20,April,2015,Pret A Manger,Eating Out,4,2589
21,April,2015,Caffe Nero,Eating Out,1,2588
22,April,2015,Chicken Cottage,Eating Out,6,2582
23,April,2015,Starbucks Coffee,Eating Out,1,2581
23,April,2015,Pret A Manger,Eating Out,8,2573
24,April,2015,O2,Bills,31,2542
24,April,2015,ASDA,Groceries,51,2491
24,April,2015,Caffe Nero,Eating Out,1,2490
27,April,2015,South West Trains,Transport,27,2463
27,April,2015,Starbucks Coffee,Eating Out,2,2461
27,April,2015,Pret A Manger,Eating Out,6,2455
28,April,2015,Costa Coffee,Eating Out,2,2453
29,April,2015,The West Cornwall Pasty Company,Eating Out,5,2448
30,April,2015,Wild Bean Cafe,Eating Out,1,2447
1,May,2015,Rhino Sports salary,General,1700,4147
1,May,2015,Morrisons,Groceries,60,4087
1,May,2015,Costa Coffee,Eating Out,2,4085
1,May,2015,McDonalds,Eating Out,6,4079
1,May,2015,ATM Cash Withdrawal,General,50,4029
4,May,2015,South West Trains,Transport,36,3993
4,May,2015,Costa Coffee,Eating Out,1,3992
4,May,2015,Subway,Eating Out,4,3988
5,May,2015,Greggs,Eating Out,6,3982
6,May,2015,McDonalds,Eating Out,5,3977
7,May,2015,Cubit and West rent,Rent,660,3317
7,May,2015,Wild Bean Cafe,Eating Out,2,3315
7,May,2015,The West Cornwall Pasty Company,Eating Out,6,3309
8,May,2015,Morrisons,Groceries,65,3244
8,May,2015,The West Cornwall Pasty Company,Eating Out,7,3237
9,May,2015,Pizza Express,Eating Out,51,3186
11,May,2015,South West Trains,Transport,32,3154
11,May,2015,Subway,Eating Out,6,3148
12,May,2015,Wild Bean Cafe,Eating Out,2,3146
12,May,2015,Pret A Manger,Eating Out,5,3141
13,May,2015,Starbucks Coffee,Eating Out,1,3140
15,May,2015,BRGAS-Electricity,Bills,38,3102
15,May,2015,BRGAS-Gas,Bills,27,3075
15,May,2015,Morrisons,Groceries,45,3030
15,May,2015,McDonalds,Eating Out,5,3025
16,May,2015,LBS Council Tax,Bills,50,2975
18,May,2015,South West Trains,Transport,33,2942
18,May,2015,ATM Cash Withdrawal,General,50,2892
19,May,2015,Starbucks Coffee,Eating Out,1,2891
20,May,2015,VIRGIN MEDIA PYMTS,Bills,56,2835
20,May,2015,Wild Bean Cafe,Eating Out,1,2834
20,May,2015,Chicken Cottage,Eating Out,7,2827
21,May,2015,Wild Bean Cafe,Eating Out,2,2825
21,May,2015,The West Cornwall Pasty Company,Eating Out,7,2818
22,May,2015,ASDA,Groceries,49,2769
22,May,2015,Chicken Cottage,Eating Out,6,2763
24,May,2015,O2,Bills,37,2726
24,May,2015,Scott's Restaurant,Eating Out,53,2673
25,May,2015,South West Trains,Transport,27,2646
27,May,2015,Costa Coffee,Eating Out,2,2644
27,May,2015,Subway,Eating Out,6,2638
28,May,2015,Costa Coffee,Eating Out,1,2637
28,May,2015,McDonalds,Eating Out,6,2631
29,May,2015,Sainsburys,Groceries,66,2565
29,May,2015,Caffe Nero,Eating Out,2,2563
29,May,2015,The West Cornwall Pasty Company,Eating Out,7,2556
31,May,2015,Restaurant Gordon RamsayPortland Restaurant,Eating Out,56,2500
1,June,2015,Rhino Sports salary,General,1700,4200
1,June,2015,South West Trains,Transport,31,4169
1,June,2015,Starbucks Coffee,Eating Out,2,4167
1,June,2015,The West Cornwall Pasty Company,Eating Out,7,4160
2,June,2015,Caffe Nero,Eating Out,2,4158
2,June,2015,Pret A Manger,Eating Out,8,4150
3,June,2015,Greggs,Eating Out,4,4146
4,June,2015,Caffe Nero,Eating Out,2,4144
5,June,2015,ASDA,Groceries,56,4088
5,June,2015,Starbucks Coffee,Eating Out,1,4087
5,June,2015,McDonalds,Eating Out,7,4080
5,June,2015,ATM Cash Withdrawal,General,10,4070
6,June,2015,Dominos Pizza,Eating Out,50,4020
7,June,2015,Cubit and West rent,Rent,660,3360
7,June,2015,ATM Cash Withdrawal,General,90,3270
8,June,2015,South West Trains,Transport,33,3237
8,June,2015,Starbucks Coffee,Eating Out,2,3235
8,June,2015,The West Cornwall Pasty Company,Eating Out,4,3231
8,June,2015,ATM Cash Withdrawal,General,30,3201
10,June,2015,Wild Bean Cafe,Eating Out,2,3199
11,June,2015,The West Cornwall Pasty Company,Eating Out,8,3191
12,June,2015,ASDA,Groceries,58,3133
12,June,2015,Costa Coffee,Eating Out,1,3132
14,June,2015,ATM Cash Withdrawal,General,70,3062
15,June,2015,BRGAS-Electricity,Bills,36,3026
15,June,2015,BRGAS-Gas,Bills,42,2984
15,June,2015,South West Trains,Transport,35,2949
15,June,2015,Caffe Nero,Eating Out,2,2947
15,June,2015,Pret A Manger,Eating Out,4,2943
15,June,2015,ATM Cash Withdrawal,General,90,2853
16,June,2015,LBS Council Tax,Bills,50,2803
16,June,2015,Caffe Nero,Eating Out,1,2802
16,June,2015,McDonalds,Eating Out,4,2798
17,June,2015,Costa Coffee,Eating Out,1,2797
17,June,2015,Chicken Cottage,Eating Out,6,2791
18,June,2015,Costa Coffee,Eating Out,2,2789
18,June,2015,Subway,Eating Out,8,2781
19,June,2015,Tescos,Groceries,65,2716
19,June,2015,Starbucks Coffee,Eating Out,1,2715
19,June,2015,Chicken Cottage,Eating Out,8,2707
20,June,2015,VIRGIN MEDIA PYMTS,Bills,41,2666
22,June,2015,South West Trains,Transport,26,2640
22,June,2015,Costa Coffee,Eating Out,2,2638
22,June,2015,Pret A Manger,Eating Out,7,2631
22,June,2015,ATM Cash Withdrawal,General,20,2611
23,June,2015,Wild Bean Cafe,Eating Out,2,2609
23,June,2015,Chicken Cottage,Eating Out,4,2605
24,June,2015,O2,Bills,34,2571
24,June,2015,Wild Bean Cafe,Eating Out,2,2569
24,June,2015,Pret A Manger,Eating Out,5,2564
25,June,2015,Wild Bean Cafe,Eating Out,2,2562
26,June,2015,ASDA,Groceries,75,2487
26,June,2015,Costa Coffee,Eating Out,2,2485
26,June,2015,Chicken Cottage,Eating Out,5,2480
29,June,2015,South West Trains,Transport,34,2446
29,June,2015,Greggs,Eating Out,7,2439
30,June,2015,Caffe Nero,Eating Out,2,2437
30,June,2015,Subway,Eating Out,5,2432
1,July,2015,Rhino Sports salary,General,1700,4132
1,July,2015,Costa Coffee,Eating Out,2,4130
2,July,2015,Wild Bean Cafe,Eating Out,1,4129
2,July,2015,Chicken Cottage,Eating Out,8,4121
3,July,2015,Tescos,Groceries,61,4060
3,July,2015,Wild Bean Cafe,Eating Out,2,4058
6,July,2015,South West Trains,Transport,28,4030
6,July,2015,Costa Coffee,Eating Out,2,4028
7,July,2015,Cubit and West rent,Rent,660,3368
7,July,2015,Wild Bean Cafe,Eating Out,1,3367
7,July,2015,Chicken Cottage,Eating Out,4,3363
8,July,2015,Starbucks Coffee,Eating Out,2,3361
8,July,2015,ATM Cash Withdrawal,General,60,3301
9,July,2015,Caffe Nero,Eating Out,1,3300
9,July,2015,Pret A Manger,Eating Out,4,3296
10,July,2015,ASDA,Groceries,51,3245
10,July,2015,Subway,Eating Out,5,3240
10,July,2015,Scott's Restaurant,Eating Out,45,3195
10,July,2015,ATM Cash Withdrawal,General,20,3175
13,July,2015,South West Trains,Transport,32,3143
13,July,2015,Caffe Nero,Eating Out,1,3142
13,July,2015,Greggs,Eating Out,5,3137
15,July,2015,BRGAS-Electricity,Bills,44,3093
15,July,2015,BRGAS-Gas,Bills,39,3054
15,July,2015,McDonalds,Eating Out,5,3049
16,July,2015,LBS Council Tax,Bills,50,2999
16,July,2015,Costa Coffee,Eating Out,2,2997
16,July,2015,McDonalds,Eating Out,6,2991
17,July,2015,Tescos,Groceries,57,2934
17,July,2015,Caffe Nero,Eating Out,1,2933
17,July,2015,Subway,Eating Out,4,2929
17,July,2015,Restaurant Gordon RamsayPortland Restaurant,Eating Out,56,2873
18,July,2015,Restaurant Gordon RamsayPortland Restaurant,Eating Out,34,2839
19,July,2015,Restaurant Gordon RamsayPortland Restaurant,Eating Out,26,2813
20,July,2015,VIRGIN MEDIA PYMTS,Bills,50,2763
20,July,2015,South West Trains,Transport,33,2730
20,July,2015,Caffe Nero,Eating Out,1,2729
20,July,2015,Chicken Cottage,Eating Out,6,2723
21,July,2015,Caffe Nero,Eating Out,1,2722
23,July,2015,Caffe Nero,Eating Out,1,2721
23,July,2015,Greggs,Eating Out,5,2716
24,July,2015,O2,Bills,30,2686
24,July,2015,Sainsburys,Groceries,58,2628
24,July,2015,Costa Coffee,Eating Out,2,2626
24,July,2015,ATM Cash Withdrawal,General,20,2606
27,July,2015,South West Trains,Transport,34,2572
27,July,2015,Starbucks Coffee,Eating Out,2,2570
28,July,2015,Caffe Nero,Eating Out,1,2569
28,July,2015,Pret A Manger,Eating Out,8,2561
30,July,2015,Starbucks Coffee,Eating Out,1,2560
30,July,2015,McDonalds,Eating Out,4,2556
31,July,2015,ASDA,Groceries,70,2486
1,August,2015,Rhino Sports salary,General,1700,4186
3,August,2015,South West Trains,Transport,28,4158
3,August,2015,Costa Coffee,Eating Out,1,4157
3,August,2015,The West Cornwall Pasty Company,Eating Out,8,4149
5,August,2015,Costa Coffee,Eating Out,2,4147
5,August,2015,McDonalds,Eating Out,6,4141
6,August,2015,Costa Coffee,Eating Out,2,4139
7,August,2015,Cubit and West rent,Rent,660,3479
7,August,2015,ASDA,Groceries,88,3391
7,August,2015,Costa Coffee,Eating Out,1,3390
7,August,2015,Chicken Cottage,Eating Out,6,3384
7,August,2015,Restaurant Gordon RamsayPortland Restaurant,Eating Out,46,3338
9,August,2015,Scott's Restaurant,Eating Out,33,3305
10,August,2015,South West Trains,Transport,36,3269
10,August,2015,Wild Bean Cafe,Eating Out,2,3267
10,August,2015,Subway,Eating Out,5,3262
11,August,2015,Caffe Nero,Eating Out,2,3260
11,August,2015,Chicken Cottage,Eating Out,7,3253
12,August,2015,Wild Bean Cafe,Eating Out,1,3252
12,August,2015,Greggs,Eating Out,8,3244
13,August,2015,Wild Bean Cafe,Eating Out,1,3243
13,August,2015,Chicken Cottage,Eating Out,7,3236
14,August,2015,Morrisons,Groceries,89,3147
15,August,2015,BRGAS-Electricity,Bills,33,3114
15,August,2015,BRGAS-Gas,Bills,23,3091
15,August,2015,Anglo restaurant,Eating Out,27,3064
16,August,2015,LBS Council Tax,Bills,50,3014
17,August,2015,South West Trains,Transport,32,2982
17,August,2015,Starbucks Coffee,Eating Out,1,2981
18,August,2015,Costa Coffee,Eating Out,2,2979
18,August,2015,Subway,Eating Out,6,2973
19,August,2015,Caffe Nero,Eating Out,1,2972
19,August,2015,Pret A Manger,Eating Out,7,2965
20,August,2015,VIRGIN MEDIA PYMTS,Bills,39,2926
20,August,2015,Costa Coffee,Eating Out,1,2925
21,August,2015,Waitrose,Groceries,46,2879
21,August,2015,Chicken Cottage,Eating Out,6,2873
21,August,2015,The Grand Pub,Eating Out,7,2866
21,August,2015,ATM Cash Withdrawal,General,80,2786
24,August,2015,O2,Bills,38,2748
24,August,2015,South West Trains,Transport,29,2719
24,August,2015,Caffe Nero,Eating Out,2,2717
24,August,2015,Subway,Eating Out,4,2713
25,August,2015,Costa Coffee,Eating Out,2,2711
25,August,2015,McDonalds,Eating Out,4,2707
26,August,2015,Starbucks Coffee,Eating Out,2,2705
26,August,2015,McDonalds,Eating Out,7,2698
27,August,2015,ATM Cash Withdrawal,General,60,2638
28,August,2015,Sainsburys,Groceries,47,2591
28,August,2015,Chicken Cottage,Eating Out,6,2585
30,August,2015,Anglo restaurant,Eating Out,47,2538
31,August,2015,South West Trains,Transport,35,2503
31,August,2015,Subway,Eating Out,6,2497
1,September,2015,Rhino Sports salary,General,1700,4197
1,September,2015,Caffe Nero,Eating Out,1,4196
1,September,2015,Chicken Cottage,Eating Out,4,4192
1,September,2015,ATM Cash Withdrawal,General,90,4102
2,September,2015,Starbucks Coffee,Eating Out,1,4101
2,September,2015,McDonalds,Eating Out,4,4097
3,September,2015,Caffe Nero,Eating Out,1,4096
3,September,2015,Subway,Eating Out,8,4088
4,September,2015,Sainsburys,Groceries,77,4011
4,September,2015,Chicken Cottage,Eating Out,4,4007
6,September,2015,ATM Cash Withdrawal,General,40,3967
7,September,2015,Cubit and West rent,Rent,660,3307
7,September,2015,South West Trains,Transport,27,3280
7,September,2015,ATM Cash Withdrawal,General,70,3210
9,September,2015,Wild Bean Cafe,Eating Out,1,3209
9,September,2015,Chicken Cottage,Eating Out,8,3201
10,September,2015,Caffe Nero,Eating Out,1,3200
10,September,2015,The West Cornwall Pasty Company,Eating Out,7,3193
11,September,2015,Sainsburys,Groceries,48,3145
11,September,2015,Chicken Cottage,Eating Out,8,3137
11,September,2015,ATM Cash Withdrawal,General,90,3047
14,September,2015,South West Trains,Transport,30,3017
14,September,2015,Wild Bean Cafe,Eating Out,2,3015
14,September,2015,McDonalds,Eating Out,4,3011
15,September,2015,BRGAS-Electricity,Bills,40,2971
15,September,2015,BRGAS-Gas,Bills,33,2938
15,September,2015,Costa Coffee,Eating Out,2,2936
15,September,2015,Chicken Cottage,Eating Out,5,2931
16,September,2015,LBS Council Tax,Bills,50,2881
17,September,2015,Wild Bean Cafe,Eating Out,2,2879
17,September,2015,Chicken Cottage,Eating Out,5,2874
18,September,2015,Tescos,Groceries,59,2815
18,September,2015,Costa Coffee,Eating Out,1,2814
18,September,2015,McDonalds,Eating Out,6,2808
18,September,2015,Dominos Pizza,Eating Out,28,2780
18,September,2015,ATM Cash Withdrawal,General,30,2750
19,September,2015,ATM Cash Withdrawal,General,60,2690
20,September,2015,VIRGIN MEDIA PYMTS,Bills,40,2650
20,September,2015,Dominos Pizza,Eating Out,53,2597
20,September,2015,ATM Cash Withdrawal,General,80,2517
21,September,2015,South West Trains,Transport,38,2479
21,September,2015,Costa Coffee,Eating Out,2,2477
22,September,2015,Subway,Eating Out,4,2473
23,September,2015,Starbucks Coffee,Eating Out,2,2471
23,September,2015,Pret A Manger,Eating Out,7,2464
23,September,2015,ATM Cash Withdrawal,General,30,2434
24,September,2015,O2,Bills,32,2402
24,September,2015,Subway,Eating Out,6,2396
25,September,2015,ASDA,Groceries,81,2315
25,September,2015,Starbucks Coffee,Eating Out,2,2313
25,September,2015,Greggs,Eating Out,5,2308
26,September,2015,ATM Cash Withdrawal,General,40,2268
27,September,2015,ATM Cash Withdrawal,General,70,2198
28,September,2015,South West Trains,Transport,25,2173
29,September,2015,Wild Bean Cafe,Eating Out,2,2171
29,September,2015,The West Cornwall Pasty Company,Eating Out,6,2165
30,September,2015,Wild Bean Cafe,Eating Out,2,2163
1,October,2015,Rhino Sports salary,General,1700,3863
1,October,2015,Wild Bean Cafe,Eating Out,1,3862
1,October,2015,The West Cornwall Pasty Company,Eating Out,6,3856
2,October,2015,Morrisons,Groceries,82,3774
2,October,2015,Starbucks Coffee,Eating Out,2,3772
2,October,2015,McDonalds,Eating Out,4,3768
5,October,2015,South West Trains,Transport,38,3730
5,October,2015,Costa Coffee,Eating Out,2,3728
5,October,2015,Pret A Manger,Eating Out,6,3722
6,October,2015,Costa Coffee,Eating Out,1,3721
6,October,2015,Greggs,Eating Out,6,3715
7,October,2015,Cubit and West rent,Rent,660,3055
7,October,2015,Caffe Nero,Eating Out,1,3054
7,October,2015,Greggs,Eating Out,4,3050
8,October,2015,Costa Coffee,Eating Out,1,3049
8,October,2015,Subway,Eating Out,7,3042
9,October,2015,ASDA,Groceries,82,2960
9,October,2015,Costa Coffee,Eating Out,1,2959
11,October,2015,Anglo restaurant,Eating Out,55,2904
11,October,2015,ATM Cash Withdrawal,General,10,2894
12,October,2015,South West Trains,Transport,27,2867
12,October,2015,The West Cornwall Pasty Company,Eating Out,6,2861
13,October,2015,Caffe Nero,Eating Out,2,2859
13,October,2015,Subway,Eating Out,4,2855
14,October,2015,Starbucks Coffee,Eating Out,1,2854
14,October,2015,Pret A Manger,Eating Out,6,2848
15,October,2015,BRGAS-Electricity,Bills,26,2822
15,October,2015,BRGAS-Gas,Bills,40,2782
15,October,2015,Caffe Nero,Eating Out,1,2781
15,October,2015,Chicken Cottage,Eating Out,5,2776
16,October,2015,LBS Council Tax,Bills,50,2726
16,October,2015,Sainsburys,Groceries,83,2643
16,October,2015,Chicken Cottage,Eating Out,4,2639
16,October,2015,Heaven Club,Eating Out,12,2627
16,October,2015,Heaven Club,Eating Out,14,2613
16,October,2015,Heaven Club,Eating Out,14,2599
16,October,2015,Heaven Club,Eating Out,15,2584
19,October,2015,South West Trains,Transport,33,2551
19,October,2015,Wild Bean Cafe,Eating Out,2,2549
19,October,2015,The West Cornwall Pasty Company,Eating Out,8,2541
20,October,2015,VIRGIN MEDIA PYMTS,Bills,48,2493
20,October,2015,Caffe Nero,Eating Out,2,2491
21,October,2015,The West Cornwall Pasty Company,Eating Out,8,2483
22,October,2015,Starbucks Coffee,Eating Out,1,2482
22,October,2015,The West Cornwall Pasty Company,Eating Out,4,2478
23,October,2015,ASDA,Groceries,88,2390
23,October,2015,Wild Bean Cafe,Eating Out,1,2389
23,October,2015,Greggs,Eating Out,5,2384
23,October,2015,ATM Cash Withdrawal,General,80,2304
24,October,2015,O2,Bills,35,2269
25,October,2015,ATM Cash Withdrawal,General,30,2239
26,October,2015,South West Trains,Transport,28,2211
26,October,2015,Starbucks Coffee,Eating Out,2,2209
26,October,2015,Greggs,Eating Out,5,2204
27,October,2015,Greggs,Eating Out,4,2200
29,October,2015,McDonalds,Eating Out,7,2193
30,October,2015,Morrisons,Groceries,89,2104
30,October,2015,Caffe Nero,Eating Out,2,2102
1,November,2015,Rhino Sports salary,General,1700,3802
1,November,2015,Anglo restaurant,Eating Out,33,3769
2,November,2015,South West Trains,Transport,34,3735
2,November,2015,Starbucks Coffee,Eating Out,2,3733
2,November,2015,Chicken Cottage,Eating Out,7,3726
3,November,2015,Wild Bean Cafe,Eating Out,1,3725
3,November,2015,ATM Cash Withdrawal,General,30,3695
4,November,2015,Starbucks Coffee,Eating Out,1,3694
4,November,2015,Pret A Manger,Eating Out,5,3689
4,November,2015,ATM Cash Withdrawal,General,90,3599
5,November,2015,Costa Coffee,Eating Out,2,3597
5,November,2015,Chicken Cottage,Eating Out,6,3591
6,November,2015,Waitrose,Groceries,52,3539
6,November,2015,Starbucks Coffee,Eating Out,2,3537
6,November,2015,McDonalds,Eating Out,7,3530
7,November,2015,Cubit and West rent,Rent,660,2870
9,November,2015,South West Trains,Transport,26,2844
9,November,2015,Wild Bean Cafe,Eating Out,1,2843
9,November,2015,Greggs,Eating Out,6,2837
10,November,2015,Wild Bean Cafe,Eating Out,2,2835
11,November,2015,The West Cornwall Pasty Company,Eating Out,5,2830
13,November,2015,ASDA,Groceries,69,2761
13,November,2015,Wild Bean Cafe,Eating Out,1,2760
13,November,2015,Pret A Manger,Eating Out,6,2754
15,November,2015,BRGAS-Electricity,Bills,60,2694
15,November,2015,BRGAS-Gas,Bills,49,2645
16,November,2015,LBS Council Tax,Bills,50,2595
16,November,2015,South West Trains,Transport,33,2562
16,November,2015,Costa Coffee,Eating Out,2,2560
16,November,2015,Pret A Manger,Eating Out,8,2552
17,November,2015,Wild Bean Cafe,Eating Out,1,2551
17,November,2015,Chicken Cottage,Eating Out,5,2546
18,November,2015,Starbucks Coffee,Eating Out,2,2544
18,November,2015,McDonalds,Eating Out,7,2537
19,November,2015,Caffe Nero,Eating Out,2,2535
19,November,2015,Pret A Manger,Eating Out,5,2530
20,November,2015,VIRGIN MEDIA PYMTS,Bills,53,2477
20,November,2015,Sainsburys,Groceries,79,2398
20,November,2015,Wild Bean Cafe,Eating Out,2,2396
20,November,2015,Greggs,Eating Out,7,2389
22,November,2015,Scott's Restaurant,Eating Out,51,2338
23,November,2015,South West Trains,Transport,36,2302
23,November,2015,Caffe Nero,Eating Out,2,2300
23,November,2015,McDonalds,Eating Out,8,2292
24,November,2015,O2,Bills,36,2256
25,November,2015,Costa Coffee,Eating Out,1,2255
26,November,2015,Costa Coffee,Eating Out,2,2253
26,November,2015,Subway,Eating Out,7,2246
27,November,2015,Waitrose,Groceries,56,2190
27,November,2015,Wild Bean Cafe,Eating Out,2,2188
27,November,2015,Subway,Eating Out,7,2181
30,November,2015,South West Trains,Transport,31,2150
30,November,2015,Costa Coffee,Eating Out,1,2149
1,December,2015,Rhino Sports salary,General,1700,3849
1,December,2015,Wild Bean Cafe,Eating Out,1,3848
1,December,2015,Subway,Eating Out,4,3844
2,December,2015,Wild Bean Cafe,Eating Out,1,3843
2,December,2015,Pret A Manger,Eating Out,4,3839
3,December,2015,Starbucks Coffee,Eating Out,1,3838
4,December,2015,Tescos,Groceries,42,3796
4,December,2015,Wild Bean Cafe,Eating Out,2,3794
4,December,2015,Scott's Restaurant,Eating Out,57,3737
6,December,2015,ATM Cash Withdrawal,General,40,3697
7,December,2015,Cubit and West rent,Rent,660,3037
7,December,2015,South West Trains,Transport,30,3007
7,December,2015,Wild Bean Cafe,Eating Out,2,3005
7,December,2015,The West Cornwall Pasty Company,Eating Out,6,2999
7,December,2015,ATM Cash Withdrawal,General,80,2919
9,December,2015,Costa Coffee,Eating Out,2,2917
9,December,2015,Subway,Eating Out,8,2909
10,December,2015,Wild Bean Cafe,Eating Out,2,2907
10,December,2015,McDonalds,Eating Out,5,2902
11,December,2015,ASDA,Groceries,54,2848
11,December,2015,Starbucks Coffee,Eating Out,1,2847
11,December,2015,McDonalds,Eating Out,8,2839
14,December,2015,South West Trains,Transport,36,2803
14,December,2015,Pret A Manger,Eating Out,6,2797
15,December,2015,BRGAS-Electricity,Bills,29,2768
15,December,2015,BRGAS-Gas,Bills,41,2727
15,December,2015,Greggs,Eating Out,4,2723
16,December,2015,LBS Council Tax,Bills,50,2673
16,December,2015,Wild Bean Cafe,Eating Out,1,2672
16,December,2015,Chicken Cottage,Eating Out,8,2664
17,December,2015,Greggs,Eating Out,4,2660
18,December,2015,Sainsburys,Groceries,56,2604
18,December,2015,Wild Bean Cafe,Eating Out,2,2602
18,December,2015,Chicken Cottage,Eating Out,6,2596
20,December,2015,VIRGIN MEDIA PYMTS,Bills,34,2562
21,December,2015,South West Trains,Transport,32,2530
21,December,2015,Caffe Nero,Eating Out,1,2529
21,December,2015,Pret A Manger,Eating Out,5,2524
22,December,2015,Chicken Cottage,Eating Out,8,2516
23,December,2015,Wild Bean Cafe,Eating Out,2,2514
24,December,2015,O2,Bills,34,2480
24,December,2015,Caffe Nero,Eating Out,2,2478
24,December,2015,Pret A Manger,Eating Out,6,2472
25,December,2015,Waitrose,Groceries,68,2404
25,December,2015,Costa Coffee,Eating Out,1,2403
27,December,2015,ATM Cash Withdrawal,General,40,2363
28,December,2015,South West Trains,Transport,29,2334
28,December,2015,Starbucks Coffee,Eating Out,2,2332
28,December,2015,The West Cornwall Pasty Company,Eating Out,5,2327
29,December,2015,McDonalds,Eating Out,7,2320
29,December,2015,ATM Cash Withdrawal,General,30,2290
30,December,2015,Caffe Nero,Eating Out,2,2288
30,December,2015,Subway,Eating Out,5,2283
31,December,2015,Costa Coffee,Eating Out,2,2281
31,December,2015,Chicken Cottage,Eating Out,6,2275
1,January,2016,Rhino Sports salary,General,1700,3975
1,January,2016,Morrisons,Groceries,49,3926
1,January,2016,Starbucks Coffee,Eating Out,2,3924
1,January,2016,The West Cornwall Pasty Company,Eating Out,5,3919
4,January,2016,South West Trains,Transport,29,3890
4,January,2016,Caffe Nero,Eating Out,2,3888
4,January,2016,Chicken Cottage,Eating Out,7,3881
5,January,2016,Caffe Nero,Eating Out,2,3879
6,January,2016,Costa Coffee,Eating Out,1,3878
6,January,2016,The West Cornwall Pasty Company,Eating Out,8,3870
7,January,2016,Cubit and West rent,Rent,660,3210
7,January,2016,Wild Bean Cafe,Eating Out,1,3209
7,January,2016,Subway,Eating Out,7,3202
8,January,2016,Morrisons,Groceries,50,3152
8,January,2016,Wild Bean Cafe,Eating Out,2,3150
11,January,2016,South West Trains,Transport,24,3126
11,January,2016,McDonalds,Eating Out,5,3121
12,January,2016,Starbucks Coffee,Eating Out,2,3119
12,January,2016,Greggs,Eating Out,4,3115
13,January,2016,Wild Bean Cafe,Eating Out,2,3113
13,January,2016,Greggs,Eating Out,5,3108
14,January,2016,The West Cornwall Pasty Company,Eating Out,8,3100
15,January,2016,BRGAS-Electricity,Bills,57,3043
15,January,2016,BRGAS-Gas,Bills,61,2982
15,January,2016,Morrisons,Groceries,84,2898
16,January,2016,LBS Council Tax,Bills,50,2848
18,January,2016,South West Trains,Transport,27,2821
18,January,2016,Costa Coffee,Eating Out,1,2820
19,January,2016,Caffe Nero,Eating Out,2,2818
19,January,2016,The West Cornwall Pasty Company,Eating Out,8,2810
20,January,2016,VIRGIN MEDIA PYMTS,Bills,46,2764
20,January,2016,Starbucks Coffee,Eating Out,2,2762
21,January,2016,Caffe Nero,Eating Out,1,2761
22,January,2016,Tescos,Groceries,75,2686
22,January,2016,Caffe Nero,Eating Out,2,2684
22,January,2016,Greggs,Eating Out,7,2677
23,January,2016,Restaurant Gordon RamsayPortland Restaurant,Eating Out,47,2630
24,January,2016,O2,Bills,32,2598
24,January,2016,Pizza Express,Eating Out,46,2552
25,January,2016,South West Trains,Transport,24,2528
25,January,2016,Starbucks Coffee,Eating Out,2,2526
25,January,2016,Subway,Eating Out,7,2519
26,January,2016,Costa Coffee,Eating Out,2,2517
27,January,2016,Chicken Cottage,Eating Out,8,2509
28,January,2016,Caffe Nero,Eating Out,1,2508
28,January,2016,McDonalds,Eating Out,8,2500
29,January,2016,ASDA,Groceries,45,2455
29,January,2016,Ministry of Sound ClubXOYO Club,Eating Out,15,2440
29,January,2016,Anglo restaurant,Eating Out,37,2403
30,January,2016,Restaurant Gordon RamsayPortland Restaurant,Eating Out,44,2359
1,February,2016,Rhino Sports salary,General,1700,4059
1,February,2016,South West Trains,Transport,24,4035
1,February,2016,Costa Coffee,Eating Out,2,4033
1,February,2016,Pret A Manger,Eating Out,5,4028
2,February,2016,Costa Coffee,Eating Out,1,4027
3,February,2016,Costa Coffee,Eating Out,1,4026
3,February,2016,Chicken Cottage,Eating Out,6,4020
4,February,2016,Wild Bean Cafe,Eating Out,2,4018
4,February,2016,Chicken Cottage,Eating Out,8,4010
4,February,2016,ATM Cash Withdrawal,General,50,3960
5,February,2016,Sainsburys,Groceries,46,3914
7,February,2016,Cubit and West rent,Rent,660,3254
8,February,2016,South West Trains,Transport,37,3217
8,February,2016,Starbucks Coffee,Eating Out,1,3216
9,February,2016,Caffe Nero,Eating Out,2,3214
9,February,2016,Pret A Manger,Eating Out,8,3206
10,February,2016,Starbucks Coffee,Eating Out,2,3204
10,February,2016,The West Cornwall Pasty Company,Eating Out,6,3198
11,February,2016,Starbucks Coffee,Eating Out,1,3197
12,February,2016,Waitrose,Groceries,51,3146
15,February,2016,BRGAS-Electricity,Bills,31,3115
15,February,2016,BRGAS-Gas,Bills,21,3094
15,February,2016,South West Trains,Transport,26,3068
15,February,2016,Caffe Nero,Eating Out,1,3067
15,February,2016,Chicken Cottage,Eating Out,5,3062
16,February,2016,LBS Council Tax,Bills,50,3012
16,February,2016,Starbucks Coffee,Eating Out,2,3010
17,February,2016,Costa Coffee,Eating Out,1,3009
17,February,2016,The West Cornwall Pasty Company,Eating Out,8,3001
18,February,2016,Starbucks Coffee,Eating Out,2,2999
18,February,2016,McDonalds,Eating Out,8,2991
19,February,2016,Morrisons,Groceries,45,2946
19,February,2016,Wild Bean Cafe,Eating Out,2,2944
19,February,2016,Pret A Manger,Eating Out,8,2936
20,February,2016,VIRGIN MEDIA PYMTS,Bills,28,2908
21,February,2016,ATM Cash Withdrawal,General,50,2858
22,February,2016,South West Trains,Transport,35,2823
22,February,2016,Costa Coffee,Eating Out,2,2821
23,February,2016,Caffe Nero,Eating Out,1,2820
23,February,2016,Subway,Eating Out,7,2813
24,February,2016,O2,Bills,35,2778
24,February,2016,Wild Bean Cafe,Eating Out,2,2776
24,February,2016,The West Cornwall Pasty Company,Eating Out,6,2770
25,February,2016,Caffe Nero,Eating Out,2,2768
25,February,2016,Pret A Manger,Eating Out,7,2761
26,February,2016,Tescos,Groceries,75,2686
26,February,2016,Subway,Eating Out,7,2679
29,February,2016,South West Trains,Transport,29,2650
29,February,2016,Costa Coffee,Eating Out,2,2648
29,February,2016,Chicken Cottage,Eating Out,4,2644
29,February,2016,ATM Cash Withdrawal,General,50,2594
1,March,2016,Rhino Sports salary,General,1700,4294
1,March,2016,Caffe Nero,Eating Out,2,4292
1,March,2016,Chicken Cottage,Eating Out,5,4287
3,March,2016,Starbucks Coffee,Eating Out,2,4285
3,March,2016,The West Cornwall Pasty Company,Eating Out,6,4279
4,March,2016,ASDA,Groceries,50,4229
4,March,2016,Starbucks Coffee,Eating Out,2,4227
7,March,2016,Cubit and West rent,Rent,660,3567
7,March,2016,South West Trains,Transport,34,3533
7,March,2016,Starbucks Coffee,Eating Out,1,3532
7,March,2016,Chicken Cottage,Eating Out,8,3524
8,March,2016,Starbucks Coffee,Eating Out,1,3523
8,March,2016,Subway,Eating Out,8,3515
9,March,2016,ATM Cash Withdrawal,General,60,3455
10,March,2016,Caffe Nero,Eating Out,1,3454
10,March,2016,McDonalds,Eating Out,6,3448
11,March,2016,ASDA,Groceries,66,3382
11,March,2016,Caffe Nero,Eating Out,2,3380
14,March,2016,South West Trains,Transport,24,3356
14,March,2016,Starbucks Coffee,Eating Out,1,3355
14,March,2016,Subway,Eating Out,4,3351
15,March,2016,BRGAS-Electricity,Bills,40,3311
15,March,2016,BRGAS-Gas,Bills,23,3288
15,March,2016,Starbucks Coffee,Eating Out,2,3286
15,March,2016,Greggs,Eating Out,7,3279
16,March,2016,LBS Council Tax,Bills,50,3229
16,March,2016,Caffe Nero,Eating Out,2,3227
17,March,2016,Wild Bean Cafe,Eating Out,1,3226
17,March,2016,Greggs,Eating Out,5,3221
17,March,2016,ATM Cash Withdrawal,General,30,3191
18,March,2016,ASDA,Groceries,81,3110
18,March,2016,Caffe Nero,Eating Out,2,3108
20,March,2016,VIRGIN MEDIA PYMTS,Bills,56,3052
21,March,2016,South West Trains,Transport,37,3015
21,March,2016,Chicken Cottage,Eating Out,5,3010
22,March,2016,Caffe Nero,Eating Out,2,3008
23,March,2016,Caffe Nero,Eating Out,1,3007
24,March,2016,O2,Bills,38,2969
24,March,2016,Caffe Nero,Eating Out,2,2967
25,March,2016,Morrisons,Groceries,48,2919
25,March,2016,Costa Coffee,Eating Out,1,2918
25,March,2016,The West Cornwall Pasty Company,Eating Out,7,2911
27,March,2016,Restaurant Gordon RamsayPortland Restaurant,Eating Out,53,2858
28,March,2016,South West Trains,Transport,31,2827
28,March,2016,McDonalds,Eating Out,8,2819
29,March,2016,Starbucks Coffee,Eating Out,1,2818
29,March,2016,McDonalds,Eating Out,7,2811
30,March,2016,Caffe Nero,Eating Out,1,2810
30,March,2016,McDonalds,Eating Out,7,2803
30,March,2016,ATM Cash Withdrawal,General,10,2793
31,March,2016,Costa Coffee,Eating Out,2,2791
31,March,2016,Chicken Cottage,Eating Out,8,2783
1,April,2016,Rhino Sports salary,General,1700,4483
1,April,2016,Morrisons,Groceries,71,4412
1,April,2016,Starbucks Coffee,Eating Out,1,4411
1,April,2016,Pret A Manger,Eating Out,7,4404
2,April,2016,ATM Cash Withdrawal,General,80,4324
4,April,2016,South West Trains,Transport,24,4300
4,April,2016,Wild Bean Cafe,Eating Out,2,4298
5,April,2016,Costa Coffee,Eating Out,2,4296
5,April,2016,The West Cornwall Pasty Company,Eating Out,7,4289
6,April,2016,Starbucks Coffee,Eating Out,2,4287
6,April,2016,Chicken Cottage,Eating Out,7,4280
7,April,2016,Cubit and West rent,Rent,660,3620
8,April,2016,Sainsburys,Groceries,62,3558
8,April,2016,Costa Coffee,Eating Out,2,3556
8,April,2016,ATM Cash Withdrawal,General,70,3486
11,April,2016,South West Trains,Transport,36,3450
11,April,2016,Starbucks Coffee,Eating Out,2,3448
11,April,2016,Subway,Eating Out,8,3440
12,April,2016,Starbucks Coffee,Eating Out,2,3438
12,April,2016,Chicken Cottage,Eating Out,4,3434
13,April,2016,McDonalds,Eating Out,5,3429
14,April,2016,Wild Bean Cafe,Eating Out,1,3428
15,April,2016,BRGAS-Electricity,Bills,26,3402
15,April,2016,BRGAS-Gas,Bills,24,3378
15,April,2016,Waitrose,Groceries,85,3293
15,April,2016,Caffe Nero,Eating Out,2,3291
15,April,2016,The West Cornwall Pasty Company,Eating Out,8,3283
16,April,2016,LBS Council Tax,Bills,50,3233
18,April,2016,South West Trains,Transport,28,3205
18,April,2016,Caffe Nero,Eating Out,1,3204
19,April,2016,McDonalds,Eating Out,7,3197
20,April,2016,VIRGIN MEDIA PYMTS,Bills,39,3158
20,April,2016,Starbucks Coffee,Eating Out,2,3156
20,April,2016,ATM Cash Withdrawal,General,20,3136
22,April,2016,Morrisons,Groceries,82,3054
22,April,2016,Wild Bean Cafe,Eating Out,1,3053
22,April,2016,The West Cornwall Pasty Company,Eating Out,4,3049
24,April,2016,O2,Bills,34,3015
25,April,2016,South West Trains,Transport,35,2980
26,April,2016,Costa Coffee,Eating Out,1,2979
26,April,2016,Greggs,Eating Out,4,2975
27,April,2016,Starbucks Coffee,Eating Out,2,2973
27,April,2016,Subway,Eating Out,6,2967
27,April,2016,ATM Cash Withdrawal,General,80,2887
28,April,2016,Costa Coffee,Eating Out,1,2886
28,April,2016,Chicken Cottage,Eating Out,5,2881
29,April,2016,ASDA,Groceries,84,2797
29,April,2016,Caffe Nero,Eating Out,1,2796
1,May,2016,Rhino Sports salary,General,1700,4496
2,May,2016,South West Trains,Transport,30,4466
2,May,2016,Starbucks Coffee,Eating Out,2,4464
2,May,2016,Chicken Cottage,Eating Out,6,4458
3,May,2016,Starbucks Coffee,Eating Out,1,4457
3,May,2016,McDonalds,Eating Out,7,4450
4,May,2016,Pret A Manger,Eating Out,8,4442
5,May,2016,Caffe Nero,Eating Out,1,4441
5,May,2016,McDonalds,Eating Out,8,4433
6,May,2016,Tescos,Groceries,80,4353
6,May,2016,Wild Bean Cafe,Eating Out,2,4351
6,May,2016,The West Cornwall Pasty Company,Eating Out,5,4346
7,May,2016,Cubit and West rent,Rent,660,3686
7,May,2016,Pizza Express,Eating Out,34,3652
9,May,2016,South West Trains,Transport,26,3626
9,May,2016,Caffe Nero,Eating Out,2,3624
10,May,2016,Costa Coffee,Eating Out,1,3623
10,May,2016,The West Cornwall Pasty Company,Eating Out,4,3619
11,May,2016,Wild Bean Cafe,Eating Out,2,3617
11,May,2016,Subway,Eating Out,6,3611
13,May,2016,Sainsburys,Groceries,45,3566
13,May,2016,Caffe Nero,Eating Out,1,3565
15,May,2016,BRGAS-Electricity,Bills,24,3541
15,May,2016,BRGAS-Gas,Bills,24,3517
16,May,2016,LBS Council Tax,Bills,50,3467
16,May,2016,South West Trains,Transport,38,3429
16,May,2016,Starbucks Coffee,Eating Out,2,3427
16,May,2016,Greggs,Eating Out,8,3419
17,May,2016,Caffe Nero,Eating Out,2,3417
17,May,2016,Greggs,Eating Out,6,3411
18,May,2016,Costa Coffee,Eating Out,1,3410
19,May,2016,Costa Coffee,Eating Out,1,3409
19,May,2016,Subway,Eating Out,5,3404
20,May,2016,VIRGIN MEDIA PYMTS,Bills,50,3354
20,May,2016,Tescos,Groceries,78,3276
20,May,2016,Anglo restaurant,Eating Out,46,3230
23,May,2016,South West Trains,Transport,34,3196
23,May,2016,Costa Coffee,Eating Out,1,3195
23,May,2016,McDonalds,Eating Out,4,3191
23,May,2016,ATM Cash Withdrawal,General,70,3121
24,May,2016,O2,Bills,31,3090
24,May,2016,Costa Coffee,Eating Out,1,3089
24,May,2016,McDonalds,Eating Out,6,3083
25,May,2016,Caffe Nero,Eating Out,2,3081
25,May,2016,Chicken Cottage,Eating Out,8,3073
26,May,2016,Starbucks Coffee,Eating Out,1,3072
26,May,2016,Greggs,Eating Out,6,3066
27,May,2016,Waitrose,Groceries,65,3001
27,May,2016,Wild Bean Cafe,Eating Out,2,2999
27,May,2016,The West Cornwall Pasty Company,Eating Out,4,2995
27,May,2016,Dominos Pizza,Eating Out,51,2944
30,May,2016,South West Trains,Transport,37,2907
30,May,2016,Caffe Nero,Eating Out,2,2905
31,May,2016,Wild Bean Cafe,Eating Out,2,2903
31,May,2016,Subway,Eating Out,5,2898
1,June,2016,Rhino Sports salary,General,1700,4598
1,June,2016,Caffe Nero,Eating Out,2,4596
2,June,2016,Starbucks Coffee,Eating Out,1,4595
2,June,2016,McDonalds,Eating Out,5,4590
3,June,2016,Waitrose,Groceries,89,4501
3,June,2016,Starbucks Coffee,Eating Out,2,4499
3,June,2016,Greggs,Eating Out,4,4495
4,June,2016,Anglo restaurant,Eating Out,25,4470
6,June,2016,South West Trains,Transport,37,4433
6,June,2016,Wild Bean Cafe,Eating Out,1,4432
7,June,2016,Cubit and West rent,Rent,660,3772
7,June,2016,Costa Coffee,Eating Out,2,3770
7,June,2016,Chicken Cottage,Eating Out,7,3763
8,June,2016,Starbucks Coffee,Eating Out,2,3761
9,June,2016,Wild Bean Cafe,Eating Out,2,3759
9,June,2016,Greggs,Eating Out,5,3754
10,June,2016,Waitrose,Groceries,78,3676
10,June,2016,Costa Coffee,Eating Out,1,3675
13,June,2016,South West Trains,Transport,31,3644
13,June,2016,Costa Coffee,Eating Out,1,3643
13,June,2016,The West Cornwall Pasty Company,Eating Out,5,3638
14,June,2016,Caffe Nero,Eating Out,2,3636
15,June,2016,BRGAS-Electricity,Bills,28,3608
15,June,2016,BRGAS-Gas,Bills,25,3583
15,June,2016,Starbucks Coffee,Eating Out,2,3581
16,June,2016,LBS Council Tax,Bills,50,3531
16,June,2016,Costa Coffee,Eating Out,2,3529
16,June,2016,Greggs,Eating Out,8,3521
17,June,2016,Waitrose,Groceries,62,3459
17,June,2016,Wild Bean Cafe,Eating Out,2,3457
17,June,2016,Ministry of Sound ClubXOYO Club,Eating Out,7,3450
17,June,2016,Ministry of Sound ClubXOYO Club,Eating Out,11,3439
17,June,2016,Ministry of Sound ClubXOYO Club,Eating Out,13,3426
17,June,2016,Ministry of Sound ClubXOYO Club,Eating Out,10,3416
17,June,2016,Ministry of Sound ClubXOYO Club,Eating Out,12,3404
17,June,2016,Ministry of Sound ClubXOYO Club,Eating Out,5,3399
20,June,2016,VIRGIN MEDIA PYMTS,Bills,54,3345
20,June,2016,South West Trains,Transport,37,3308
20,June,2016,Wild Bean Cafe,Eating Out,2,3306
20,June,2016,Pret A Manger,Eating Out,8,3298
20,June,2016,ATM Cash Withdrawal,General,30,3268
21,June,2016,Starbucks Coffee,Eating Out,2,3266
21,June,2016,Pret A Manger,Eating Out,8,3258
22,June,2016,Starbucks Coffee,Eating Out,1,3257
22,June,2016,Pret A Manger,Eating Out,4,3253
23,June,2016,Starbucks Coffee,Eating Out,2,3251
24,June,2016,O2,Bills,30,3221
24,June,2016,Morrisons,Groceries,87,3134
24,June,2016,Starbucks Coffee,Eating Out,2,3132
24,June,2016,Pret A Manger,Eating Out,6,3126
24,June,2016,Scott's Restaurant,Eating Out,55,3071
26,June,2016,Pizza Express,Eating Out,29,3042
27,June,2016,South West Trains,Transport,37,3005
27,June,2016,Caffe Nero,Eating Out,1,3004
27,June,2016,Greggs,Eating Out,4,3000
28,June,2016,Caffe Nero,Eating Out,2,2998
28,June,2016,Chicken Cottage,Eating Out,6,2992
29,June,2016,Greggs,Eating Out,4,2988
30,June,2016,Costa Coffee,Eating Out,1,2987
30,June,2016,Pret A Manger,Eating Out,6,2981
1,July,2016,Rhino Sports salary,General,1700,4681
1,July,2016,Tescos,Groceries,59,4622
1,July,2016,Caffe Nero,Eating Out,2,4620
2,July,2016,ATM Cash Withdrawal,General,40,4580
4,July,2016,South West Trains,Transport,29,4551
4,July,2016,Starbucks Coffee,Eating Out,1,4550
4,July,2016,Subway,Eating Out,7,4543
5,July,2016,Costa Coffee,Eating Out,2,4541
5,July,2016,McDonalds,Eating Out,8,4533
7,July,2016,Cubit and West rent,Rent,660,3873
7,July,2016,Chicken Cottage,Eating Out,8,3865
8,July,2016,ASDA,Groceries,59,3806
11,July,2016,South West Trains,Transport,28,3778
11,July,2016,Caffe Nero,Eating Out,2,3776
12,July,2016,Pret A Manger,Eating Out,5,3771
13,July,2016,Costa Coffee,Eating Out,2,3769
13,July,2016,Subway,Eating Out,6,3763
14,July,2016,Caffe Nero,Eating Out,2,3761
14,July,2016,Greggs,Eating Out,8,3753
15,July,2016,BRGAS-Electricity,Bills,36,3717
15,July,2016,BRGAS-Gas,Bills,23,3694
15,July,2016,Waitrose,Groceries,66,3628
15,July,2016,Caffe Nero,Eating Out,1,3627
15,July,2016,Pizza Express,Eating Out,50,3577
16,July,2016,LBS Council Tax,Bills,50,3527
18,July,2016,South West Trains,Transport,34,3493
19,July,2016,Costa Coffee,Eating Out,2,3491
20,July,2016,VIRGIN MEDIA PYMTS,Bills,44,3447
20,July,2016,Wild Bean Cafe,Eating Out,1,3446
20,July,2016,Greggs,Eating Out,5,3441
21,July,2016,Caffe Nero,Eating Out,2,3439
21,July,2016,The West Cornwall Pasty Company,Eating Out,6,3433
22,July,2016,Waitrose,Groceries,80,3353
22,July,2016,Wild Bean Cafe,Eating Out,1,3352
24,July,2016,O2,Bills,37,3315
24,July,2016,Pizza Express,Eating Out,57,3258
25,July,2016,South West Trains,Transport,26,3232
25,July,2016,Caffe Nero,Eating Out,1,3231
25,July,2016,McDonalds,Eating Out,7,3224
26,July,2016,Costa Coffee,Eating Out,2,3222
27,July,2016,Starbucks Coffee,Eating Out,1,3221
28,July,2016,Starbucks Coffee,Eating Out,2,3219
28,July,2016,Subway,Eating Out,4,3215
29,July,2016,Morrisons,Groceries,68,3147
29,July,2016,Starbucks Coffee,Eating Out,1,3146
29,July,2016,The West Cornwall Pasty Company,Eating Out,5,3141
29,July,2016,Anglo restaurant,Eating Out,32,3109
1,August,2016,Rhino Sports salary,General,1700,4809
1,August,2016,South West Trains,Transport,34,4775
1,August,2016,Subway,Eating Out,8,4767
1,August,2016,ATM Cash Withdrawal,General,80,4687
2,August,2016,Costa Coffee,Eating Out,2,4685
2,August,2016,Chicken Cottage,Eating Out,6,4679
3,August,2016,ATM Cash Withdrawal,General,90,4589
4,August,2016,Costa Coffee,Eating Out,1,4588
5,August,2016,Sainsburys,Groceries,81,4507
5,August,2016,Costa Coffee,Eating Out,1,4506
5,August,2016,Chicken Cottage,Eating Out,7,4499
5,August,2016,Anglo restaurant,Eating Out,36,4463
6,August,2016,ATM Cash Withdrawal,General,80,4383
7,August,2016,Cubit and West rent,Rent,660,3723
8,August,2016,South West Trains,Transport,37,3686
8,August,2016,Costa Coffee,Eating Out,2,3684
8,August,2016,Pret A Manger,Eating Out,5,3679
9,August,2016,Caffe Nero,Eating Out,1,3678
9,August,2016,The West Cornwall Pasty Company,Eating Out,6,3672
10,August,2016,Costa Coffee,Eating Out,2,3670
10,August,2016,ATM Cash Withdrawal,General,90,3580
12,August,2016,Waitrose,Groceries,53,3527
12,August,2016,Costa Coffee,Eating Out,2,3525
12,August,2016,McDonalds,Eating Out,5,3520
14,August,2016,Scott's Restaurant,Eating Out,34,3486
15,August,2016,BRGAS-Electricity,Bills,43,3443
15,August,2016,BRGAS-Gas,Bills,36,3407
15,August,2016,South West Trains,Transport,34,3373
15,August,2016,Pret A Manger,Eating Out,4,3369
15,August,2016,ATM Cash Withdrawal,General,10,3359
16,August,2016,LBS Council Tax,Bills,50,3309
16,August,2016,Wild Bean Cafe,Eating Out,2,3307
17,August,2016,Costa Coffee,Eating Out,2,3305
17,August,2016,Chicken Cottage,Eating Out,7,3298
18,August,2016,Costa Coffee,Eating Out,1,3297
18,August,2016,Chicken Cottage,Eating Out,4,3293
19,August,2016,Sainsburys,Groceries,57,3236
19,August,2016,Starbucks Coffee,Eating Out,1,3235
19,August,2016,McDonalds,Eating Out,8,3227
20,August,2016,VIRGIN MEDIA PYMTS,Bills,46,3181
22,August,2016,South West Trains,Transport,24,3157
22,August,2016,Starbucks Coffee,Eating Out,2,3155
22,August,2016,McDonalds,Eating Out,5,3150
23,August,2016,The West Cornwall Pasty Company,Eating Out,4,3146
24,August,2016,O2,Bills,35,3111
24,August,2016,Costa Coffee,Eating Out,1,3110
24,August,2016,ATM Cash Withdrawal,General,40,3070
25,August,2016,Starbucks Coffee,Eating Out,1,3069
25,August,2016,Greggs,Eating Out,5,3064
26,August,2016,Tescos,Groceries,77,2987
26,August,2016,Starbucks Coffee,Eating Out,1,2986
27,August,2016,Dominos Pizza,Eating Out,45,2941
29,August,2016,South West Trains,Transport,28,2913
29,August,2016,Caffe Nero,Eating Out,1,2912
29,August,2016,Chicken Cottage,Eating Out,4,2908
30,August,2016,Costa Coffee,Eating Out,1,2907
30,August,2016,ATM Cash Withdrawal,General,30,2877
31,August,2016,Starbucks Coffee,Eating Out,1,2876
31,August,2016,The West Cornwall Pasty Company,Eating Out,4,2872
1,September,2016,Rhino Sports salary,General,1700,4572
1,September,2016,Starbucks Coffee,Eating Out,2,4570
1,September,2016,Pret A Manger,Eating Out,4,4566
2,September,2016,Waitrose,Groceries,55,4511
2,September,2016,Caffe Nero,Eating Out,2,4509
2,September,2016,McDonalds,Eating Out,4,4505
5,September,2016,South West Trains,Transport,32,4473
5,September,2016,Wild Bean Cafe,Eating Out,2,4471
5,September,2016,Subway,Eating Out,8,4463
6,September,2016,Starbucks Coffee,Eating Out,2,4461
7,September,2016,Cubit and West rent,Rent,660,3801
7,September,2016,Caffe Nero,Eating Out,2,3799
8,September,2016,Subway,Eating Out,4,3795
9,September,2016,Morrisons,Groceries,74,3721
9,September,2016,Wild Bean Cafe,Eating Out,2,3719
9,September,2016,McDonalds,Eating Out,4,3715
12,September,2016,South West Trains,Transport,27,3688
12,September,2016,Costa Coffee,Eating Out,2,3686
12,September,2016,Subway,Eating Out,6,3680
13,September,2016,Pret A Manger,Eating Out,4,3676
13,September,2016,ATM Cash Withdrawal,General,10,3666
14,September,2016,Wild Bean Cafe,Eating Out,1,3665
15,September,2016,BRGAS-Electricity,Bills,26,3639
15,September,2016,BRGAS-Gas,Bills,32,3607
15,September,2016,Wild Bean Cafe,Eating Out,2,3605
15,September,2016,Greggs,Eating Out,8,3597
15,September,2016,ATM Cash Withdrawal,General,20,3577
16,September,2016,LBS Council Tax,Bills,50,3527
16,September,2016,Tescos,Groceries,54,3473
16,September,2016,Costa Coffee,Eating Out,2,3471
18,September,2016,Dominos Pizza,Eating Out,50,3421
19,September,2016,South West Trains,Transport,27,3394
19,September,2016,Wild Bean Cafe,Eating Out,2,3392
19,September,2016,Greggs,Eating Out,7,3385
20,September,2016,VIRGIN MEDIA PYMTS,Bills,46,3339
20,September,2016,Costa Coffee,Eating Out,1,3338
20,September,2016,Subway,Eating Out,4,3334
21,September,2016,Costa Coffee,Eating Out,2,3332
22,September,2016,Caffe Nero,Eating Out,2,3330
23,September,2016,Waitrose,Groceries,79,3251
23,September,2016,Wild Bean Cafe,Eating Out,1,3250
23,September,2016,McDonalds,Eating Out,4,3246
24,September,2016,O2,Bills,36,3210
26,September,2016,South West Trains,Transport,34,3176
26,September,2016,Caffe Nero,Eating Out,2,3174
27,September,2016,Costa Coffee,Eating Out,1,3173
27,September,2016,The West Cornwall Pasty Company,Eating Out,5,3168
28,September,2016,Pret A Manger,Eating Out,5,3163
29,September,2016,Starbucks Coffee,Eating Out,1,3162
29,September,2016,ATM Cash Withdrawal,General,20,3142
30,September,2016,Waitrose,Groceries,59,3083
30,September,2016,Subway,Eating Out,7,3076
30,September,2016,Scott's Restaurant,Eating Out,49,3027
1,October,2016,Rhino Sports salary,General,1700,4727
1,October,2016,Dominos Pizza,Eating Out,48,4679
2,October,2016,Scott's Restaurant,Eating Out,44,4635
3,October,2016,South West Trains,Transport,38,4597
3,October,2016,Caffe Nero,Eating Out,2,4595
3,October,2016,Subway,Eating Out,6,4589
4,October,2016,Starbucks Coffee,Eating Out,2,4587
4,October,2016,Subway,Eating Out,4,4583
4,October,2016,ATM Cash Withdrawal,General,50,4533
5,October,2016,Wild Bean Cafe,Eating Out,2,4531
6,October,2016,Chicken Cottage,Eating Out,6,4525
7,October,2016,Cubit and West rent,Rent,660,3865
7,October,2016,Tescos,Groceries,73,3792
7,October,2016,Wild Bean Cafe,Eating Out,2,3790
7,October,2016,ATM Cash Withdrawal,General,10,3780
10,October,2016,South West Trains,Transport,36,3744
10,October,2016,Subway,Eating Out,7,3737
11,October,2016,Wild Bean Cafe,Eating Out,2,3735
11,October,2016,The West Cornwall Pasty Company,Eating Out,7,3728
12,October,2016,Subway,Eating Out,8,3720
14,October,2016,Waitrose,Groceries,59,3661
14,October,2016,Wild Bean Cafe,Eating Out,1,3660
15,October,2016,BRGAS-Electricity,Bills,32,3628
15,October,2016,BRGAS-Gas,Bills,39,3589
15,October,2016,Restaurant Gordon RamsayPortland Restaurant,Eating Out,47,3542
16,October,2016,LBS Council Tax,Bills,50,3492
17,October,2016,South West Trains,Transport,28,3464
17,October,2016,Wild Bean Cafe,Eating Out,1,3463
18,October,2016,Caffe Nero,Eating Out,1,3462
18,October,2016,Greggs,Eating Out,5,3457
19,October,2016,Costa Coffee,Eating Out,1,3456
20,October,2016,VIRGIN MEDIA PYMTS,Bills,47,3409
20,October,2016,Starbucks Coffee,Eating Out,2,3407
20,October,2016,Subway,Eating Out,4,3403
21,October,2016,ASDA,Groceries,82,3321
21,October,2016,Caffe Nero,Eating Out,1,3320
21,October,2016,Pret A Manger,Eating Out,4,3316
24,October,2016,O2,Bills,30,3286
24,October,2016,South West Trains,Transport,37,3249
24,October,2016,Costa Coffee,Eating Out,1,3248
24,October,2016,The West Cornwall Pasty Company,Eating Out,7,3241
24,October,2016,ATM Cash Withdrawal,General,80,3161
25,October,2016,Starbucks Coffee,Eating Out,2,3159
25,October,2016,ATM Cash Withdrawal,General,60,3099
27,October,2016,Wild Bean Cafe,Eating Out,1,3098
27,October,2016,Greggs,Eating Out,4,3094
28,October,2016,Tescos,Groceries,66,3028
28,October,2016,Greggs,Eating Out,4,3024
30,October,2016,Pizza Express,Eating Out,52,2972
31,October,2016,South West Trains,Transport,33,2939
31,October,2016,Wild Bean Cafe,Eating Out,1,2938
31,October,2016,The West Cornwall Pasty Company,Eating Out,5,2933
1,November,2016,Rhino Sports salary,General,1700,4633
1,November,2016,Caffe Nero,Eating Out,2,4631
1,November,2016,McDonalds,Eating Out,4,4627
2,November,2016,Caffe Nero,Eating Out,2,4625
2,November,2016,McDonalds,Eating Out,7,4618
3,November,2016,Costa Coffee,Eating Out,1,4617
4,November,2016,Morrisons,Groceries,89,4528
4,November,2016,Starbucks Coffee,Eating Out,2,4526
4,November,2016,Greggs,Eating Out,6,4520
5,November,2016,The Grand Pub,Eating Out,12,4508
5,November,2016,The Grand Pub,Eating Out,13,4495
5,November,2016,The Grand Pub,Eating Out,12,4483
5,November,2016,The Grand Pub,Eating Out,16,4467
5,November,2016,Pizza Express,Eating Out,32,4435
7,November,2016,Cubit and West rent,Rent,660,3775
7,November,2016,South West Trains,Transport,27,3748
7,November,2016,Caffe Nero,Eating Out,1,3747
7,November,2016,Pret A Manger,Eating Out,5,3742
8,November,2016,McDonalds,Eating Out,4,3738
9,November,2016,Costa Coffee,Eating Out,1,3737
9,November,2016,The West Cornwall Pasty Company,Eating Out,8,3729
10,November,2016,Caffe Nero,Eating Out,2,3727
10,November,2016,Greggs,Eating Out,8,3719
11,November,2016,Sainsburys,Groceries,59,3660
11,November,2016,Wild Bean Cafe,Eating Out,1,3659
11,November,2016,Dominos Pizza,Eating Out,47,3612
13,November,2016,ATM Cash Withdrawal,General,30,3582
14,November,2016,South West Trains,Transport,38,3544
15,November,2016,BRGAS-Electricity,Bills,36,3508
15,November,2016,BRGAS-Gas,Bills,75,3433
15,November,2016,Wild Bean Cafe,Eating Out,2,3431
16,November,2016,LBS Council Tax,Bills,50,3381
16,November,2016,Costa Coffee,Eating Out,2,3379
16,November,2016,Pret A Manger,Eating Out,4,3375
17,November,2016,Starbucks Coffee,Eating Out,2,3373
17,November,2016,Greggs,Eating Out,8,3365
18,November,2016,Sainsburys,Groceries,83,3282
18,November,2016,Greggs,Eating Out,5,3277
18,November,2016,Restaurant Gordon RamsayPortland Restaurant,Eating Out,54,3223
20,November,2016,VIRGIN MEDIA PYMTS,Bills,38,3185
20,November,2016,Pizza Express,Eating Out,46,3139
21,November,2016,South West Trains,Transport,34,3105
21,November,2016,Wild Bean Cafe,Eating Out,2,3103
21,November,2016,Pret A Manger,Eating Out,8,3095
22,November,2016,Wild Bean Cafe,Eating Out,2,3093
23,November,2016,Wild Bean Cafe,Eating Out,2,3091
23,November,2016,Subway,Eating Out,8,3083
24,November,2016,O2,Bills,33,3050
24,November,2016,Subway,Eating Out,7,3043
25,November,2016,Sainsburys,Groceries,79,2964
25,November,2016,Costa Coffee,Eating Out,2,2962
25,November,2016,Greggs,Eating Out,8,2954
28,November,2016,South West Trains,Transport,30,2924
28,November,2016,Caffe Nero,Eating Out,2,2922
29,November,2016,Caffe Nero,Eating Out,1,2921
29,November,2016,ATM Cash Withdrawal,General,90,2831
30,November,2016,Wild Bean Cafe,Eating Out,2,2829
1,December,2016,Rhino Sports salary,General,1700,4529
2,December,2016,ASDA,Groceries,47,4482
2,December,2016,Pret A Manger,Eating Out,6,4476
2,December,2016,Anglo restaurant,Eating Out,27,4449
3,December,2016,Anglo restaurant,Eating Out,28,4421
4,December,2016,Scott's Restaurant,Eating Out,28,4393
5,December,2016,South West Trains,Transport,31,4362
5,December,2016,Caffe Nero,Eating Out,2,4360
5,December,2016,Pret A Manger,Eating Out,5,4355
6,December,2016,Caffe Nero,Eating Out,2,4353
6,December,2016,Pret A Manger,Eating Out,4,4349
7,December,2016,Cubit and West rent,Rent,660,3689
7,December,2016,Wild Bean Cafe,Eating Out,1,3688
7,December,2016,ATM Cash Withdrawal,General,90,3598
8,December,2016,Caffe Nero,Eating Out,2,3596
8,December,2016,Subway,Eating Out,5,3591
9,December,2016,Morrisons,Groceries,89,3502
9,December,2016,Wild Bean Cafe,Eating Out,2,3500
9,December,2016,Chicken Cottage,Eating Out,5,3495
11,December,2016,Scott's Restaurant,Eating Out,51,3444
12,December,2016,South West Trains,Transport,26,3418
12,December,2016,Starbucks Coffee,Eating Out,2,3416
13,December,2016,McDonalds,Eating Out,5,3411
14,December,2016,Caffe Nero,Eating Out,1,3410
15,December,2016,BRGAS-Electricity,Bills,36,3374
15,December,2016,BRGAS-Gas,Bills,26,3348
15,December,2016,Wild Bean Cafe,Eating Out,2,3346
15,December,2016,Greggs,Eating Out,8,3338
16,December,2016,LBS Council Tax,Bills,50,3288
16,December,2016,Sainsburys,Groceries,70,3218
16,December,2016,Starbucks Coffee,Eating Out,2,3216
16,December,2016,Greggs,Eating Out,8,3208
19,December,2016,South West Trains,Transport,28,3180
19,December,2016,Starbucks Coffee,Eating Out,1,3179
19,December,2016,Chicken Cottage,Eating Out,6,3173
20,December,2016,VIRGIN MEDIA PYMTS,Bills,32,3141
20,December,2016,Caffe Nero,Eating Out,2,3139
20,December,2016,Greggs,Eating Out,6,3133
21,December,2016,Caffe Nero,Eating Out,1,3132
21,December,2016,The West Cornwall Pasty Company,Eating Out,4,3128
22,December,2016,Wild Bean Cafe,Eating Out,2,3126
23,December,2016,ASDA,Groceries,67,3059
23,December,2016,Starbucks Coffee,Eating Out,2,3057
24,December,2016,O2,Bills,34,3023
24,December,2016,ATM Cash Withdrawal,General,70,2953
26,December,2016,South West Trains,Transport,32,2921
26,December,2016,Starbucks Coffee,Eating Out,1,2920
27,December,2016,Costa Coffee,Eating Out,2,2918
27,December,2016,Subway,Eating Out,4,2914
27,December,2016,ATM Cash Withdrawal,General,10,2904
28,December,2016,Costa Coffee,Eating Out,2,2902
29,December,2016,Greggs,Eating Out,5,2897
30,December,2016,Waitrose,Groceries,84,2813
30,December,2016,Caffe Nero,Eating Out,2,2811
30,December,2016,Subway,Eating Out,7,2804
1,January,2017,Rhino Sports salary,General,1700,4504
2,January,2017,South West Trains,Transport,36,4468
2,January,2017,The West Cornwall Pasty Company,Eating Out,6,4462
3,January,2017,Starbucks Coffee,Eating Out,1,4461
3,January,2017,Subway,Eating Out,7,4454
4,January,2017,Wild Bean Cafe,Eating Out,1,4453
5,January,2017,Wild Bean Cafe,Eating Out,2,4451
6,January,2017,Waitrose,Groceries,63,4388
6,January,2017,Starbucks Coffee,Eating Out,1,4387
6,January,2017,Pret A Manger,Eating Out,5,4382
7,January,2017,Cubit and West rent,Rent,660,3722
7,January,2017,ATM Cash Withdrawal,General,50,3672
9,January,2017,South West Trains,Transport,30,3642
9,January,2017,Costa Coffee,Eating Out,2,3640
9,January,2017,The West Cornwall Pasty Company,Eating Out,6,3634
10,January,2017,Wild Bean Cafe,Eating Out,1,3633
10,January,2017,The West Cornwall Pasty Company,Eating Out,6,3627
11,January,2017,Caffe Nero,Eating Out,1,3626
11,January,2017,Greggs,Eating Out,8,3618
12,January,2017,Starbucks Coffee,Eating Out,2,3616
12,January,2017,Chicken Cottage,Eating Out,4,3612
13,January,2017,Morrisons,Groceries,74,3538
13,January,2017,Wild Bean Cafe,Eating Out,2,3536
13,January,2017,Chicken Cottage,Eating Out,7,3529
13,January,2017,The Grand Pub,Eating Out,15,3514
13,January,2017,The Grand Pub,Eating Out,8,3506
13,January,2017,The Grand Pub,Eating Out,7,3499
13,January,2017,The Grand Pub,Eating Out,14,3485
15,January,2017,BRGAS-Electricity,Bills,42,3443
15,January,2017,BRGAS-Gas,Bills,42,3401
16,January,2017,LBS Council Tax,Bills,50,3351
16,January,2017,South West Trains,Transport,31,3320
16,January,2017,Starbucks Coffee,Eating Out,2,3318
17,January,2017,McDonalds,Eating Out,6,3312
18,January,2017,Wild Bean Cafe,Eating Out,2,3310
18,January,2017,Subway,Eating Out,8,3302
19,January,2017,Costa Coffee,Eating Out,1,3301
19,January,2017,Chicken Cottage,Eating Out,7,3294
20,January,2017,VIRGIN MEDIA PYMTS,Bills,29,3265
20,January,2017,Tescos,Groceries,84,3181
20,January,2017,Starbucks Coffee,Eating Out,1,3180
20,January,2017,The West Cornwall Pasty Company,Eating Out,5,3175
23,January,2017,South West Trains,Transport,27,3148
23,January,2017,McDonalds,Eating Out,5,3143
24,January,2017,O2,Bills,30,3113
24,January,2017,ATM Cash Withdrawal,General,90,3023
25,January,2017,Starbucks Coffee,Eating Out,2,3021
26,January,2017,Caffe Nero,Eating Out,1,3020
26,January,2017,McDonalds,Eating Out,4,3016
27,January,2017,Morrisons,Groceries,70,2946
27,January,2017,Chicken Cottage,Eating Out,6,2940
27,January,2017,Anglo restaurant,Eating Out,55,2885
28,January,2017,ATM Cash Withdrawal,General,20,2865
30,January,2017,South West Trains,Transport,24,2841
31,January,2017,Costa Coffee,Eating Out,1,2840
31,January,2017,Subway,Eating Out,7,2833
1,February,2017,Rhino Sports salary,General,1700,4533
1,February,2017,Starbucks Coffee,Eating Out,2,4531
1,February,2017,Chicken Cottage,Eating Out,8,4523
2,February,2017,Caffe Nero,Eating Out,1,4522
2,February,2017,The West Cornwall Pasty Company,Eating Out,6,4516
3,February,2017,Tescos,Groceries,78,4438
3,February,2017,Caffe Nero,Eating Out,2,4436
3,February,2017,McDonalds,Eating Out,5,4431
3,February,2017,Restaurant Gordon RamsayPortland Restaurant,Eating Out,30,4401
6,February,2017,South West Trains,Transport,27,4374
6,February,2017,Caffe Nero,Eating Out,2,4372
6,February,2017,ATM Cash Withdrawal,General,30,4342
7,February,2017,Cubit and West rent,Rent,660,3682
7,February,2017,Starbucks Coffee,Eating Out,2,3680
7,February,2017,The West Cornwall Pasty Company,Eating Out,4,3676
8,February,2017,Starbucks Coffee,Eating Out,2,3674
9,February,2017,Greggs,Eating Out,4,3670
10,February,2017,Waitrose,Groceries,75,3595
10,February,2017,Costa Coffee,Eating Out,2,3593
10,February,2017,McDonalds,Eating Out,5,3588
10,February,2017,Pizza Express,Eating Out,27,3561
13,February,2017,South West Trains,Transport,27,3534
13,February,2017,Caffe Nero,Eating Out,2,3532
13,February,2017,Pret A Manger,Eating Out,7,3525
14,February,2017,Wild Bean Cafe,Eating Out,2,3523
14,February,2017,McDonalds,Eating Out,5,3518
15,February,2017,BRGAS-Electricity,Bills,27,3491
15,February,2017,BRGAS-Gas,Bills,31,3460
15,February,2017,Greggs,Eating Out,5,3455
16,February,2017,LBS Council Tax,Bills,50,3405
16,February,2017,Greggs,Eating Out,7,3398
17,February,2017,Sainsburys,Groceries,78,3320
17,February,2017,Caffe Nero,Eating Out,2,3318
17,February,2017,Pizza Express,Eating Out,24,3294
20,February,2017,VIRGIN MEDIA PYMTS,Bills,28,3266
20,February,2017,South West Trains,Transport,33,3233
20,February,2017,Chicken Cottage,Eating Out,6,3227
21,February,2017,Starbucks Coffee,Eating Out,1,3226
21,February,2017,The West Cornwall Pasty Company,Eating Out,5,3221
22,February,2017,Costa Coffee,Eating Out,2,3219
22,February,2017,Pret A Manger,Eating Out,6,3213
24,February,2017,O2,Bills,33,3180
24,February,2017,Waitrose,Groceries,61,3119
24,February,2017,The West Cornwall Pasty Company,Eating Out,5,3114
27,February,2017,South West Trains,Transport,26,3088
27,February,2017,Starbucks Coffee,Eating Out,2,3086
27,February,2017,The West Cornwall Pasty Company,Eating Out,5,3081
28,February,2017,Starbucks Coffee,Eating Out,2,3079
1,March,2017,Rhino Sports salary,General,1700,4779
1,March,2017,Costa Coffee,Eating Out,2,4777
1,March,2017,McDonalds,Eating Out,5,4772
2,March,2017,Starbucks Coffee,Eating Out,2,4770
2,March,2017,Chicken Cottage,Eating Out,8,4762
3,March,2017,Morrisons,Groceries,73,4689
3,March,2017,Caffe Nero,Eating Out,2,4687
3,March,2017,Greggs,Eating Out,8,4679
3,March,2017,ATM Cash Withdrawal,General,50,4629
5,March,2017,ATM Cash Withdrawal,General,10,4619
6,March,2017,South West Trains,Transport,33,4586
6,March,2017,Caffe Nero,Eating Out,2,4584
6,March,2017,Subway,Eating Out,8,4576
7,March,2017,Cubit and West rent,Rent,660,3916
7,March,2017,Caffe Nero,Eating Out,1,3915
8,March,2017,Starbucks Coffee,Eating Out,1,3914
9,March,2017,Wild Bean Cafe,Eating Out,2,3912
9,March,2017,Pret A Manger,Eating Out,8,3904
10,March,2017,Waitrose,Groceries,85,3819
10,March,2017,Costa Coffee,Eating Out,1,3818
13,March,2017,South West Trains,Transport,24,3794
13,March,2017,Wild Bean Cafe,Eating Out,1,3793
13,March,2017,The West Cornwall Pasty Company,Eating Out,4,3789
14,March,2017,Starbucks Coffee,Eating Out,1,3788
14,March,2017,Pret A Manger,Eating Out,6,3782
15,March,2017,BRGAS-Electricity,Bills,39,3743
15,March,2017,BRGAS-Gas,Bills,37,3706
15,March,2017,Caffe Nero,Eating Out,1,3705
15,March,2017,Pret A Manger,Eating Out,5,3700
16,March,2017,LBS Council Tax,Bills,50,3650
16,March,2017,Caffe Nero,Eating Out,2,3648
17,March,2017,Sainsburys,Groceries,78,3570
17,March,2017,Wild Bean Cafe,Eating Out,2,3568
17,March,2017,Pret A Manger,Eating Out,5,3563
18,March,2017,ATM Cash Withdrawal,General,60,3503
20,March,2017,VIRGIN MEDIA PYMTS,Bills,53,3450
20,March,2017,South West Trains,Transport,30,3420
20,March,2017,Wild Bean Cafe,Eating Out,1,3419
20,March,2017,Chicken Cottage,Eating Out,4,3415
21,March,2017,Caffe Nero,Eating Out,2,3413
21,March,2017,Greggs,Eating Out,5,3408
23,March,2017,Caffe Nero,Eating Out,1,3407
23,March,2017,Greggs,Eating Out,7,3400
24,March,2017,O2,Bills,36,3364
24,March,2017,Waitrose,Groceries,63,3301
24,March,2017,Starbucks Coffee,Eating Out,2,3299
26,March,2017,Pizza Express,Eating Out,28,3271
27,March,2017,South West Trains,Transport,26,3245
27,March,2017,Wild Bean Cafe,Eating Out,2,3243
28,March,2017,Wild Bean Cafe,Eating Out,1,3242
28,March,2017,Chicken Cottage,Eating Out,5,3237
29,March,2017,The West Cornwall Pasty Company,Eating Out,4,3233
29,March,2017,ATM Cash Withdrawal,General,50,3183
30,March,2017,Wild Bean Cafe,Eating Out,1,3182
30,March,2017,Chicken Cottage,Eating Out,4,3178
30,March,2017,ATM Cash Withdrawal,General,40,3138
31,March,2017,ASDA,Groceries,48,3090
31,March,2017,Starbucks Coffee,Eating Out,2,3088
1,April,2017,Rhino Sports salary,General,1700,4788
1,April,2017,Scott's Restaurant,Eating Out,53,4735
3,April,2017,South West Trains,Transport,38,4697
3,April,2017,McDonalds,Eating Out,8,4689
4,April,2017,Costa Coffee,Eating Out,1,4688
4,April,2017,Subway,Eating Out,6,4682
5,April,2017,Costa Coffee,Eating Out,2,4680
5,April,2017,McDonalds,Eating Out,8,4672
6,April,2017,Starbucks Coffee,Eating Out,1,4671
6,April,2017,Greggs,Eating Out,5,4666
7,April,2017,Cubit and West rent,Rent,660,4006
7,April,2017,Sainsburys,Groceries,65,3941
7,April,2017,Starbucks Coffee,Eating Out,2,3939
7,April,2017,Pret A Manger,Eating Out,5,3934
7,April,2017,Heaven Club,Eating Out,11,3923
7,April,2017,Heaven Club,Eating Out,13,3910
7,April,2017,Heaven Club,Eating Out,14,3896
10,April,2017,South West Trains,Transport,38,3858
10,April,2017,Starbucks Coffee,Eating Out,1,3857
11,April,2017,The West Cornwall Pasty Company,Eating Out,4,3853
12,April,2017,Starbucks Coffee,Eating Out,1,3852
12,April,2017,Subway,Eating Out,6,3846
13,April,2017,Subway,Eating Out,4,3842
14,April,2017,Morrisons,Groceries,51,3791
14,April,2017,Starbucks Coffee,Eating Out,2,3789
14,April,2017,Chicken Cottage,Eating Out,7,3782
15,April,2017,BRGAS-Electricity,Bills,25,3757
15,April,2017,BRGAS-Gas,Bills,23,3734
16,April,2017,LBS Council Tax,Bills,50,3684
17,April,2017,South West Trains,Transport,24,3660
17,April,2017,Wild Bean Cafe,Eating Out,2,3658
17,April,2017,The West Cornwall Pasty Company,Eating Out,5,3653
18,April,2017,Wild Bean Cafe,Eating Out,2,3651
18,April,2017,Subway,Eating Out,8,3643
19,April,2017,Wild Bean Cafe,Eating Out,2,3641
19,April,2017,Chicken Cottage,Eating Out,4,3637
20,April,2017,VIRGIN MEDIA PYMTS,Bills,46,3591
20,April,2017,Wild Bean Cafe,Eating Out,2,3589
20,April,2017,Pret A Manger,Eating Out,6,3583
21,April,2017,ASDA,Groceries,59,3524
21,April,2017,Wild Bean Cafe,Eating Out,2,3522
21,April,2017,Greggs,Eating Out,4,3518
24,April,2017,O2,Bills,31,3487
24,April,2017,South West Trains,Transport,32,3455
24,April,2017,Caffe Nero,Eating Out,2,3453
24,April,2017,Pret A Manger,Eating Out,4,3449
25,April,2017,Chicken Cottage,Eating Out,7,3442
26,April,2017,Costa Coffee,Eating Out,1,3441
27,April,2017,Starbucks Coffee,Eating Out,1,3440
28,April,2017,Waitrose,Groceries,62,3378
28,April,2017,The West Cornwall Pasty Company,Eating Out,8,3370
28,April,2017,Restaurant Gordon RamsayPortland Restaurant,Eating Out,52,3318
1,May,2017,Rhino Sports salary,General,1700,5018
1,May,2017,South West Trains,Transport,26,4992
1,May,2017,The West Cornwall Pasty Company,Eating Out,5,4987
2,May,2017,Caffe Nero,Eating Out,2,4985
2,May,2017,Subway,Eating Out,8,4977
3,May,2017,The West Cornwall Pasty Company,Eating Out,8,4969
4,May,2017,Pret A Manger,Eating Out,8,4961
5,May,2017,Morrisons,Groceries,62,4899
5,May,2017,Caffe Nero,Eating Out,2,4897
5,May,2017,Chicken Cottage,Eating Out,4,4893
5,May,2017,Scott's Restaurant,Eating Out,54,4839
7,May,2017,Cubit and West rent,Rent,660,4179
8,May,2017,South West Trains,Transport,32,4147
8,May,2017,Wild Bean Cafe,Eating Out,2,4145
8,May,2017,The West Cornwall Pasty Company,Eating Out,8,4137
9,May,2017,Caffe Nero,Eating Out,2,4135
9,May,2017,McDonalds,Eating Out,4,4131
10,May,2017,Wild Bean Cafe,Eating Out,2,4129
10,May,2017,Subway,Eating Out,4,4125
11,May,2017,Costa Coffee,Eating Out,2,4123
12,May,2017,ASDA,Groceries,51,4072
12,May,2017,Costa Coffee,Eating Out,2,4070
12,May,2017,Chicken Cottage,Eating Out,7,4063
15,May,2017,BRGAS-Electricity,Bills,39,4024
15,May,2017,BRGAS-Gas,Bills,22,4002
15,May,2017,South West Trains,Transport,38,3964
15,May,2017,Costa Coffee,Eating Out,2,3962
15,May,2017,Pret A Manger,Eating Out,7,3955
16,May,2017,LBS Council Tax,Bills,50,3905
16,May,2017,Costa Coffee,Eating Out,2,3903
16,May,2017,Pret A Manger,Eating Out,7,3896
17,May,2017,Starbucks Coffee,Eating Out,1,3895
18,May,2017,Wild Bean Cafe,Eating Out,2,3893
19,May,2017,Morrisons,Groceries,42,3851
19,May,2017,Costa Coffee,Eating Out,1,3850
19,May,2017,Greggs,Eating Out,4,3846
20,May,2017,VIRGIN MEDIA PYMTS,Bills,46,3800
22,May,2017,South West Trains,Transport,35,3765
22,May,2017,Caffe Nero,Eating Out,2,3763
23,May,2017,Wild Bean Cafe,Eating Out,2,3761
23,May,2017,Chicken Cottage,Eating Out,5,3756
24,May,2017,O2,Bills,33,3723
24,May,2017,Wild Bean Cafe,Eating Out,1,3722
24,May,2017,Subway,Eating Out,7,3715
25,May,2017,Costa Coffee,Eating Out,2,3713
25,May,2017,McDonalds,Eating Out,5,3708
26,May,2017,Sainsburys,Groceries,42,3666
26,May,2017,Wild Bean Cafe,Eating Out,2,3664
26,May,2017,ATM Cash Withdrawal,General,50,3614
29,May,2017,South West Trains,Transport,24,3590
29,May,2017,Starbucks Coffee,Eating Out,2,3588
30,May,2017,Caffe Nero,Eating Out,1,3587
30,May,2017,Pret A Manger,Eating Out,4,3583
31,May,2017,Starbucks Coffee,Eating Out,1,3582
31,May,2017,Subway,Eating Out,7,3575
1,June,2017,Rhino Sports salary,General,1700,5275
1,June,2017,Starbucks Coffee,Eating Out,2,5273
1,June,2017,The West Cornwall Pasty Company,Eating Out,6,5267
2,June,2017,ASDA,Groceries,55,5212
2,June,2017,Costa Coffee,Eating Out,2,5210
2,June,2017,Pret A Manger,Eating Out,5,5205
5,June,2017,South West Trains,Transport,32,5173
5,June,2017,Starbucks Coffee,Eating Out,1,5172
6,June,2017,Wild Bean Cafe,Eating Out,2,5170
6,June,2017,Subway,Eating Out,8,5162
7,June,2017,Cubit and West rent,Rent,660,4502
7,June,2017,Costa Coffee,Eating Out,2,4500
7,June,2017,Greggs,Eating Out,8,4492
8,June,2017,Greggs,Eating Out,6,4486
9,June,2017,Tescos,Groceries,62,4424
9,June,2017,Caffe Nero,Eating Out,1,4423
9,June,2017,The West Cornwall Pasty Company,Eating Out,4,4419
12,June,2017,South West Trains,Transport,33,4386
12,June,2017,Costa Coffee,Eating Out,2,4384
12,June,2017,Subway,Eating Out,5,4379
13,June,2017,Caffe Nero,Eating Out,2,4377
14,June,2017,Starbucks Coffee,Eating Out,1,4376
15,June,2017,BRGAS-Electricity,Bills,27,4349
15,June,2017,BRGAS-Gas,Bills,40,4309
15,June,2017,Starbucks Coffee,Eating Out,2,4307
16,June,2017,LBS Council Tax,Bills,50,4257
16,June,2017,Tescos,Groceries,52,4205
16,June,2017,Wild Bean Cafe,Eating Out,2,4203
16,June,2017,Subway,Eating Out,8,4195
17,June,2017,Restaurant Gordon RamsayPortland Restaurant,Eating Out,46,4149
19,June,2017,South West Trains,Transport,27,4122
19,June,2017,Chicken Cottage,Eating Out,7,4115
20,June,2017,VIRGIN MEDIA PYMTS,Bills,46,4069
20,June,2017,Caffe Nero,Eating Out,2,4067
20,June,2017,The West Cornwall Pasty Company,Eating Out,6,4061
22,June,2017,Starbucks Coffee,Eating Out,2,4059
22,June,2017,McDonalds,Eating Out,7,4052
23,June,2017,Waitrose,Groceries,87,3965
23,June,2017,Wild Bean Cafe,Eating Out,2,3963
24,June,2017,O2,Bills,30,3933
24,June,2017,Anglo restaurant,Eating Out,38,3895
26,June,2017,South West Trains,Transport,32,3863
26,June,2017,McDonalds,Eating Out,7,3856
27,June,2017,The West Cornwall Pasty Company,Eating Out,8,3848
28,June,2017,Starbucks Coffee,Eating Out,2,3846
29,June,2017,Caffe Nero,Eating Out,2,3844
29,June,2017,Subway,Eating Out,4,3840
30,June,2017,Waitrose,Groceries,77,3763
30,June,2017,Caffe Nero,Eating Out,2,3761
30,June,2017,McDonalds,Eating Out,4,3757
30,June,2017,Scott's Restaurant,Eating Out,59,3698
1,July,2017,Rhino Sports salary,General,1700,5398
3,July,2017,South West Trains,Transport,30,5368
3,July,2017,Starbucks Coffee,Eating Out,2,5366
3,July,2017,Pret A Manger,Eating Out,6,5360
4,July,2017,Caffe Nero,Eating Out,2,5358
4,July,2017,Chicken Cottage,Eating Out,4,5354
4,July,2017,ATM Cash Withdrawal,General,10,5344
5,July,2017,Caffe Nero,Eating Out,2,5342
6,July,2017,Costa Coffee,Eating Out,1,5341
6,July,2017,Greggs,Eating Out,6,5335
6,July,2017,ATM Cash Withdrawal,General,60,5275
7,July,2017,Cubit and West rent,Rent,660,4615
7,July,2017,Sainsburys,Groceries,61,4554
7,July,2017,The West Cornwall Pasty Company,Eating Out,5,4549
8,July,2017,Scott's Restaurant,Eating Out,38,4511
10,July,2017,South West Trains,Transport,32,4479
10,July,2017,Starbucks Coffee,Eating Out,2,4477
10,July,2017,McDonalds,Eating Out,5,4472
11,July,2017,Wild Bean Cafe,Eating Out,1,4471
11,July,2017,Greggs,Eating Out,8,4463
12,July,2017,Caffe Nero,Eating Out,2,4461
12,July,2017,Subway,Eating Out,5,4456
13,July,2017,Costa Coffee,Eating Out,2,4454
14,July,2017,Morrisons,Groceries,46,4408
14,July,2017,Starbucks Coffee,Eating Out,1,4407
14,July,2017,Subway,Eating Out,7,4400
15,July,2017,BRGAS-Electricity,Bills,29,4371
15,July,2017,BRGAS-Gas,Bills,44,4327
15,July,2017,The Grand Pub,Eating Out,14,4313
15,July,2017,The Grand Pub,Eating Out,14,4299
15,July,2017,The Grand Pub,Eating Out,14,4285
15,July,2017,The Grand Pub,Eating Out,6,4279
15,July,2017,Restaurant Gordon RamsayPortland Restaurant,Eating Out,38,4241
16,July,2017,LBS Council Tax,Bills,50,4191
16,July,2017,Scott's Restaurant,Eating Out,40,4151
16,July,2017,ATM Cash Withdrawal,General,80,4071
17,July,2017,South West Trains,Transport,36,4035
17,July,2017,Caffe Nero,Eating Out,2,4033
17,July,2017,Subway,Eating Out,6,4027
18,July,2017,Costa Coffee,Eating Out,2,4025
18,July,2017,Pret A Manger,Eating Out,4,4021
18,July,2017,ATM Cash Withdrawal,General,70,3951
19,July,2017,Wild Bean Cafe,Eating Out,2,3949
20,July,2017,VIRGIN MEDIA PYMTS,Bills,49,3900
20,July,2017,Starbucks Coffee,Eating Out,1,3899
21,July,2017,ASDA,Groceries,73,3826
21,July,2017,Caffe Nero,Eating Out,1,3825
21,July,2017,Chicken Cottage,Eating Out,7,3818
21,July,2017,Scott's Restaurant,Eating Out,49,3769
24,July,2017,O2,Bills,34,3735
24,July,2017,South West Trains,Transport,26,3709
24,July,2017,Wild Bean Cafe,Eating Out,2,3707
24,July,2017,Chicken Cottage,Eating Out,8,3699
25,July,2017,Starbucks Coffee,Eating Out,1,3698
25,July,2017,Greggs,Eating Out,7,3691
26,July,2017,Starbucks Coffee,Eating Out,2,3689
27,July,2017,Caffe Nero,Eating Out,1,3688
27,July,2017,Subway,Eating Out,8,3680
28,July,2017,Waitrose,Groceries,80,3600
28,July,2017,Wild Bean Cafe,Eating Out,2,3598
28,July,2017,The West Cornwall Pasty Company,Eating Out,7,3591
29,July,2017,ATM Cash Withdrawal,General,80,3511
30,July,2017,Dominos Pizza,Eating Out,50,3461
31,July,2017,South West Trains,Transport,28,3433
31,July,2017,Caffe Nero,Eating Out,2,3431
31,July,2017,The West Cornwall Pasty Company,Eating Out,6,3425
1,August,2017,Rhino Sports salary,General,1700,5125
1,August,2017,Starbucks Coffee,Eating Out,1,5124
2,August,2017,Wild Bean Cafe,Eating Out,1,5123
2,August,2017,McDonalds,Eating Out,6,5117
3,August,2017,Subway,Eating Out,8,5109
4,August,2017,Tescos,Groceries,48,5061
4,August,2017,Caffe Nero,Eating Out,2,5059
4,August,2017,Chicken Cottage,Eating Out,5,5054
7,August,2017,Cubit and West rent,Rent,660,4394
7,August,2017,South West Trains,Transport,26,4368
7,August,2017,Wild Bean Cafe,Eating Out,2,4366
8,August,2017,Costa Coffee,Eating Out,2,4364
8,August,2017,Subway,Eating Out,5,4359
9,August,2017,McDonalds,Eating Out,7,4352
10,August,2017,Costa Coffee,Eating Out,1,4351
10,August,2017,McDonalds,Eating Out,7,4344
11,August,2017,Sainsburys,Groceries,81,4263
11,August,2017,Costa Coffee,Eating Out,2,4261
11,August,2017,Chicken Cottage,Eating Out,6,4255
14,August,2017,South West Trains,Transport,33,4222
14,August,2017,Wild Bean Cafe,Eating Out,1,4221
14,August,2017,Chicken Cottage,Eating Out,5,4216
15,August,2017,BRGAS-Electricity,Bills,34,4182
15,August,2017,BRGAS-Gas,Bills,43,4139
15,August,2017,Caffe Nero,Eating Out,1,4138
15,August,2017,Greggs,Eating Out,5,4133
16,August,2017,LBS Council Tax,Bills,50,4083
16,August,2017,Costa Coffee,Eating Out,1,4082
17,August,2017,Wild Bean Cafe,Eating Out,2,4080
17,August,2017,Pret A Manger,Eating Out,5,4075
18,August,2017,Morrisons,Groceries,85,3990
18,August,2017,The West Cornwall Pasty Company,Eating Out,7,3983
20,August,2017,VIRGIN MEDIA PYMTS,Bills,30,3953
20,August,2017,Pizza Express,Eating Out,56,3897
21,August,2017,South West Trains,Transport,34,3863
21,August,2017,Starbucks Coffee,Eating Out,1,3862
22,August,2017,Starbucks Coffee,Eating Out,1,3861
22,August,2017,McDonalds,Eating Out,6,3855
23,August,2017,Costa Coffee,Eating Out,1,3854
23,August,2017,The West Cornwall Pasty Company,Eating Out,7,3847
24,August,2017,O2,Bills,37,3810
24,August,2017,Caffe Nero,Eating Out,1,3809
24,August,2017,Chicken Cottage,Eating Out,7,3802
25,August,2017,Tescos,Groceries,56,3746
25,August,2017,Costa Coffee,Eating Out,2,3744
25,August,2017,Restaurant Gordon RamsayPortland Restaurant,Eating Out,53,3691
25,August,2017,ATM Cash Withdrawal,General,50,3641
27,August,2017,Pizza Express,Eating Out,55,3586
28,August,2017,South West Trains,Transport,31,3555
28,August,2017,Starbucks Coffee,Eating Out,2,3553
28,August,2017,Chicken Cottage,Eating Out,5,3548
29,August,2017,Costa Coffee,Eating Out,1,3547
30,August,2017,Wild Bean Cafe,Eating Out,2,3545
30,August,2017,Subway,Eating Out,5,3540
31,August,2017,McDonalds,Eating Out,8,3532
31,August,2017,ATM Cash Withdrawal,General,60,3472
1,September,2017,Rhino Sports salary,General,1700,5172
1,September,2017,Sainsburys,Groceries,75,5097
1,September,2017,Wild Bean Cafe,Eating Out,2,5095
1,September,2017,Greggs,Eating Out,8,5087
4,September,2017,South West Trains,Transport,24,5063
4,September,2017,Pret A Manger,Eating Out,7,5056
6,September,2017,Caffe Nero,Eating Out,2,5054
6,September,2017,McDonalds,Eating Out,6,5048
6,September,2017,ATM Cash Withdrawal,General,80,4968
7,September,2017,Cubit and West rent,Rent,660,4308
7,September,2017,Starbucks Coffee,Eating Out,2,4306
7,September,2017,Pret A Manger,Eating Out,6,4300
8,September,2017,Tescos,Groceries,57,4243
8,September,2017,Starbucks Coffee,Eating Out,2,4241
9,September,2017,Pizza Express,Eating Out,57,4184
11,September,2017,South West Trains,Transport,29,4155
11,September,2017,McDonalds,Eating Out,5,4150
13,September,2017,McDonalds,Eating Out,4,4146
14,September,2017,Caffe Nero,Eating Out,2,4144
15,September,2017,BRGAS-Electricity,Bills,30,4114
15,September,2017,BRGAS-Gas,Bills,35,4079
15,September,2017,Sainsburys,Groceries,66,4013
15,September,2017,Greggs,Eating Out,8,4005
16,September,2017,LBS Council Tax,Bills,50,3955
18,September,2017,South West Trains,Transport,34,3921
18,September,2017,Starbucks Coffee,Eating Out,1,3920
19,September,2017,Costa Coffee,Eating Out,2,3918
19,September,2017,Chicken Cottage,Eating Out,4,3914
19,September,2017,ATM Cash Withdrawal,General,70,3844
20,September,2017,VIRGIN MEDIA PYMTS,Bills,33,3811
20,September,2017,Costa Coffee,Eating Out,2,3809
20,September,2017,The West Cornwall Pasty Company,Eating Out,4,3805
21,September,2017,Subway,Eating Out,7,3798
22,September,2017,Tescos,Groceries,72,3726
22,September,2017,Starbucks Coffee,Eating Out,1,3725
24,September,2017,O2,Bills,37,3688
24,September,2017,ATM Cash Withdrawal,General,30,3658
25,September,2017,South West Trains,Transport,38,3620
25,September,2017,Wild Bean Cafe,Eating Out,1,3619
26,September,2017,Costa Coffee,Eating Out,1,3618
26,September,2017,Subway,Eating Out,4,3614
27,September,2017,Starbucks Coffee,Eating Out,2,3612
27,September,2017,The West Cornwall Pasty Company,Eating Out,6,3606
28,September,2017,Subway,Eating Out,8,3598
29,September,2017,Morrisons,Groceries,70,3528
29,September,2017,Caffe Nero,Eating Out,2,3526
29,September,2017,Greggs,Eating Out,6,3520
1,October,2017,Rhino Sports salary,General,1700,5220
2,October,2017,South West Trains,Transport,31,5189
2,October,2017,Costa Coffee,Eating Out,2,5187
3,October,2017,Wild Bean Cafe,Eating Out,2,5185
3,October,2017,Subway,Eating Out,7,5178
4,October,2017,Starbucks Coffee,Eating Out,2,5176
4,October,2017,The West Cornwall Pasty Company,Eating Out,6,5170
5,October,2017,The West Cornwall Pasty Company,Eating Out,4,5166
6,October,2017,Morrisons,Groceries,69,5097
6,October,2017,Caffe Nero,Eating Out,2,5095
7,October,2017,Cubit and West rent,Rent,660,4435
7,October,2017,ATM Cash Withdrawal,General,90,4345
9,October,2017,South West Trains,Transport,24,4321
9,October,2017,Costa Coffee,Eating Out,1,4320
10,October,2017,Starbucks Coffee,Eating Out,2,4318
10,October,2017,The West Cornwall Pasty Company,Eating Out,7,4311
12,October,2017,Costa Coffee,Eating Out,1,4310
12,October,2017,McDonalds,Eating Out,8,4302
13,October,2017,Waitrose,Groceries,76,4226
13,October,2017,Costa Coffee,Eating Out,2,4224
13,October,2017,McDonalds,Eating Out,7,4217
15,October,2017,BRGAS-Electricity,Bills,24,4193
15,October,2017,BRGAS-Gas,Bills,21,4172
15,October,2017,Scott's Restaurant,Eating Out,53,4119
16,October,2017,LBS Council Tax,Bills,50,4069
16,October,2017,South West Trains,Transport,30,4039
16,October,2017,Costa Coffee,Eating Out,1,4038
16,October,2017,Subway,Eating Out,6,4032
17,October,2017,Wild Bean Cafe,Eating Out,1,4031
17,October,2017,Chicken Cottage,Eating Out,6,4025
17,October,2017,ATM Cash Withdrawal,General,60,3965
18,October,2017,Costa Coffee,Eating Out,1,3964
18,October,2017,Pret A Manger,Eating Out,4,3960
19,October,2017,Costa Coffee,Eating Out,2,3958
19,October,2017,Greggs,Eating Out,8,3950
20,October,2017,VIRGIN MEDIA PYMTS,Bills,58,3892
20,October,2017,Waitrose,Groceries,53,3839
20,October,2017,Costa Coffee,Eating Out,1,3838
20,October,2017,Subway,Eating Out,5,3833
21,October,2017,Restaurant Gordon RamsayPortland Restaurant,Eating Out,39,3794
23,October,2017,South West Trains,Transport,36,3758
23,October,2017,Caffe Nero,Eating Out,2,3756
23,October,2017,ATM Cash Withdrawal,General,30,3726
24,October,2017,O2,Bills,36,3690
24,October,2017,Starbucks Coffee,Eating Out,2,3688
24,October,2017,The West Cornwall Pasty Company,Eating Out,8,3680
25,October,2017,Starbucks Coffee,Eating Out,2,3678
26,October,2017,Wild Bean Cafe,Eating Out,2,3676
26,October,2017,Subway,Eating Out,7,3669
27,October,2017,Sainsburys,Groceries,73,3596
27,October,2017,Caffe Nero,Eating Out,2,3594
27,October,2017,Chicken Cottage,Eating Out,4,3590
30,October,2017,South West Trains,Transport,31,3559
30,October,2017,Costa Coffee,Eating Out,2,3557
31,October,2017,Starbucks Coffee,Eating Out,2,3555
31,October,2017,Pret A Manger,Eating Out,7,3548
1,November,2017,Rhino Sports salary,General,1700,5248
1,November,2017,Costa Coffee,Eating Out,2,5246
1,November,2017,Chicken Cottage,Eating Out,6,5240
2,November,2017,Starbucks Coffee,Eating Out,1,5239
3,November,2017,Morrisons,Groceries,46,5193
3,November,2017,Caffe Nero,Eating Out,2,5191
3,November,2017,McDonalds,Eating Out,6,5185
3,November,2017,Pizza Express,Eating Out,40,5145
6,November,2017,South West Trains,Transport,38,5107
6,November,2017,Wild Bean Cafe,Eating Out,1,5106
7,November,2017,Cubit and West rent,Rent,660,4446
7,November,2017,Wild Bean Cafe,Eating Out,2,4444
8,November,2017,Costa Coffee,Eating Out,2,4442
8,November,2017,Chicken Cottage,Eating Out,5,4437
10,November,2017,ASDA,Groceries,55,4382
10,November,2017,Chicken Cottage,Eating Out,5,4377
10,November,2017,Dominos Pizza,Eating Out,51,4326
12,November,2017,Scott's Restaurant,Eating Out,37,4289
12,November,2017,ATM Cash Withdrawal,General,30,4259
13,November,2017,South West Trains,Transport,29,4230
13,November,2017,Caffe Nero,Eating Out,2,4228
13,November,2017,McDonalds,Eating Out,6,4222
14,November,2017,The West Cornwall Pasty Company,Eating Out,7,4215
15,November,2017,BRGAS-Electricity,Bills,54,4161
15,November,2017,BRGAS-Gas,Bills,43,4118
15,November,2017,Wild Bean Cafe,Eating Out,2,4116
15,November,2017,Greggs,Eating Out,6,4110
15,November,2017,ATM Cash Withdrawal,General,80,4030
16,November,2017,LBS Council Tax,Bills,50,3980
16,November,2017,Starbucks Coffee,Eating Out,2,3978
16,November,2017,Pret A Manger,Eating Out,8,3970
17,November,2017,Tescos,Groceries,44,3926
17,November,2017,Wild Bean Cafe,Eating Out,2,3924
17,November,2017,Pret A Manger,Eating Out,7,3917
17,November,2017,Pizza Express,Eating Out,59,3858
18,November,2017,Dominos Pizza,Eating Out,37,3821
20,November,2017,VIRGIN MEDIA PYMTS,Bills,49,3772
20,November,2017,South West Trains,Transport,28,3744
20,November,2017,Costa Coffee,Eating Out,2,3742
20,November,2017,The West Cornwall Pasty Company,Eating Out,8,3734
21,November,2017,McDonalds,Eating Out,6,3728
22,November,2017,Caffe Nero,Eating Out,1,3727
23,November,2017,McDonalds,Eating Out,8,3719
24,November,2017,O2,Bills,30,3689
24,November,2017,Tescos,Groceries,81,3608
24,November,2017,Chicken Cottage,Eating Out,7,3601
25,November,2017,ATM Cash Withdrawal,General,80,3521
26,November,2017,Restaurant Gordon RamsayPortland Restaurant,Eating Out,50,3471
27,November,2017,South West Trains,Transport,33,3438
27,November,2017,Wild Bean Cafe,Eating Out,2,3436
27,November,2017,McDonalds,Eating Out,6,3430
28,November,2017,Wild Bean Cafe,Eating Out,1,3429
29,November,2017,Starbucks Coffee,Eating Out,2,3427
1,December,2017,Rhino Sports salary,General,1700,5127
1,December,2017,Sainsburys,Groceries,58,5069
1,December,2017,Wild Bean Cafe,Eating Out,2,5067
1,December,2017,Scott's Restaurant,Eating Out,34,5033
4,December,2017,South West Trains,Transport,26,5007
5,December,2017,Caffe Nero,Eating Out,2,5005
6,December,2017,Wild Bean Cafe,Eating Out,2,5003
6,December,2017,The West Cornwall Pasty Company,Eating Out,5,4998
7,December,2017,Cubit and West rent,Rent,660,4338
7,December,2017,Starbucks Coffee,Eating Out,2,4336
7,December,2017,Chicken Cottage,Eating Out,8,4328
8,December,2017,ASDA,Groceries,46,4282
8,December,2017,McDonalds,Eating Out,5,4277
8,December,2017,ATM Cash Withdrawal,General,10,4267
9,December,2017,Dominos Pizza,Eating Out,28,4239
11,December,2017,South West Trains,Transport,33,4206
11,December,2017,Wild Bean Cafe,Eating Out,1,4205
11,December,2017,Pret A Manger,Eating Out,8,4197
11,December,2017,ATM Cash Withdrawal,General,40,4157
12,December,2017,Starbucks Coffee,Eating Out,2,4155
12,December,2017,The West Cornwall Pasty Company,Eating Out,6,4149
13,December,2017,Starbucks Coffee,Eating Out,1,4148
13,December,2017,Subway,Eating Out,4,4144
14,December,2017,Starbucks Coffee,Eating Out,1,4143
14,December,2017,Chicken Cottage,Eating Out,6,4137
15,December,2017,BRGAS-Electricity,Bills,24,4113
15,December,2017,BRGAS-Gas,Bills,37,4076
15,December,2017,Morrisons,Groceries,78,3998
15,December,2017,Wild Bean Cafe,Eating Out,2,3996
15,December,2017,Subway,Eating Out,7,3989
15,December,2017,The Grand Pub,Eating Out,13,3976
15,December,2017,The Grand Pub,Eating Out,7,3969
15,December,2017,The Grand Pub,Eating Out,8,3961
16,December,2017,LBS Council Tax,Bills,50,3911
18,December,2017,South West Trains,Transport,38,3873
18,December,2017,Costa Coffee,Eating Out,2,3871
18,December,2017,Subway,Eating Out,7,3864
19,December,2017,Wild Bean Cafe,Eating Out,1,3863
19,December,2017,Chicken Cottage,Eating Out,6,3857
20,December,2017,VIRGIN MEDIA PYMTS,Bills,46,3811
20,December,2017,Wild Bean Cafe,Eating Out,1,3810
20,December,2017,Greggs,Eating Out,5,3805
21,December,2017,Greggs,Eating Out,5,3800
22,December,2017,Morrisons,Groceries,80,3720
22,December,2017,Wild Bean Cafe,Eating Out,1,3719
22,December,2017,Chicken Cottage,Eating Out,6,3713
24,December,2017,O2,Bills,33,3680
25,December,2017,South West Trains,Transport,34,3646
25,December,2017,Wild Bean Cafe,Eating Out,1,3645
26,December,2017,Starbucks Coffee,Eating Out,1,3644
27,December,2017,Caffe Nero,Eating Out,2,3642
27,December,2017,The West Cornwall Pasty Company,Eating Out,4,3638
28,December,2017,Wild Bean Cafe,Eating Out,2,3636
29,December,2017,Tescos,Groceries,53,3583
29,December,2017,Costa Coffee,Eating Out,1,3582
29,December,2017,The West Cornwall Pasty Company,Eating Out,8,3574
29,December,2017,The Grand Pub,Eating Out,5,3569
29,December,2017,The Grand Pub,Eating Out,10,3559
29,December,2017,The Grand Pub,Eating Out,15,3544
29,December,2017,The Grand Pub,Eating Out,16,3528
29,December,2017,The Grand Pub,Eating Out,9,3519
29,December,2017,The Grand Pub,Eating Out,13,3506
1,January,2018,Rhino Sports salary,General,1700,5206
1,January,2018,South West Trains,Transport,26,5180
1,January,2018,Starbucks Coffee,Eating Out,2,5178
2,January,2018,Wild Bean Cafe,Eating Out,2,5176
3,January,2018,Costa Coffee,Eating Out,2,5174
3,January,2018,Chicken Cottage,Eating Out,7,5167
4,January,2018,McDonalds,Eating Out,6,5161
5,January,2018,ASDA,Groceries,58,5103
5,January,2018,Starbucks Coffee,Eating Out,2,5101
5,January,2018,Greggs,Eating Out,7,5094
6,January,2018,ATM Cash Withdrawal,General,10,5084
7,January,2018,Cubit and West rent,Rent,660,4424
8,January,2018,South West Trains,Transport,30,4394
8,January,2018,Wild Bean Cafe,Eating Out,2,4392
8,January,2018,Subway,Eating Out,5,4387
9,January,2018,Wild Bean Cafe,Eating Out,1,4386
10,January,2018,Pret A Manger,Eating Out,6,4380
11,January,2018,Wild Bean Cafe,Eating Out,1,4379
11,January,2018,Pret A Manger,Eating Out,8,4371
11,January,2018,ATM Cash Withdrawal,General,50,4321
12,January,2018,Sainsburys,Groceries,69,4252
14,January,2018,Pizza Express,Eating Out,46,4206
15,January,2018,BRGAS-Electricity,Bills,47,4159
15,January,2018,BRGAS-Gas,Bills,65,4094
15,January,2018,South West Trains,Transport,34,4060
15,January,2018,Starbucks Coffee,Eating Out,1,4059
16,January,2018,LBS Council Tax,Bills,50,4009
16,January,2018,Wild Bean Cafe,Eating Out,1,4008
16,January,2018,McDonalds,Eating Out,6,4002
18,January,2018,Wild Bean Cafe,Eating Out,2,4000
18,January,2018,McDonalds,Eating Out,4,3996
19,January,2018,Waitrose,Groceries,55,3941
19,January,2018,Costa Coffee,Eating Out,2,3939
19,January,2018,Chicken Cottage,Eating Out,4,3935
20,January,2018,VIRGIN MEDIA PYMTS,Bills,57,3878
22,January,2018,South West Trains,Transport,34,3844
22,January,2018,Starbucks Coffee,Eating Out,2,3842
23,January,2018,Costa Coffee,Eating Out,2,3840
23,January,2018,Greggs,Eating Out,8,3832
24,January,2018,O2,Bills,31,3801
24,January,2018,Caffe Nero,Eating Out,1,3800
25,January,2018,Caffe Nero,Eating Out,2,3798
26,January,2018,Morrisons,Groceries,87,3711
26,January,2018,Wild Bean Cafe,Eating Out,2,3709
26,January,2018,McDonalds,Eating Out,8,3701
29,January,2018,South West Trains,Transport,32,3669
29,January,2018,Costa Coffee,Eating Out,1,3668
29,January,2018,McDonalds,Eating Out,5,3663
30,January,2018,Caffe Nero,Eating Out,2,3661
30,January,2018,The West Cornwall Pasty Company,Eating Out,7,3654
31,January,2018,Starbucks Coffee,Eating Out,2,3652
31,January,2018,Greggs,Eating Out,7,3645
1,February,2018,Rhino Sports salary,General,1700,5345
1,February,2018,Starbucks Coffee,Eating Out,2,5343
2,February,2018,Sainsburys,Groceries,72,5271
2,February,2018,Subway,Eating Out,7,5264
5,February,2018,South West Trains,Transport,27,5237
5,February,2018,Costa Coffee,Eating Out,2,5235
6,February,2018,Starbucks Coffee,Eating Out,2,5233
6,February,2018,Subway,Eating Out,5,5228
7,February,2018,Cubit and West rent,Rent,660,4568
7,February,2018,Costa Coffee,Eating Out,2,4566
7,February,2018,The West Cornwall Pasty Company,Eating Out,4,4562
8,February,2018,Wild Bean Cafe,Eating Out,2,4560
8,February,2018,Chicken Cottage,Eating Out,7,4553
9,February,2018,Waitrose,Groceries,81,4472
9,February,2018,Chicken Cottage,Eating Out,6,4466
11,February,2018,ATM Cash Withdrawal,General,80,4386
12,February,2018,South West Trains,Transport,24,4362
13,February,2018,The West Cornwall Pasty Company,Eating Out,5,4357
14,February,2018,Wild Bean Cafe,Eating Out,1,4356
14,February,2018,McDonalds,Eating Out,6,4350
15,February,2018,BRGAS-Electricity,Bills,37,4313
15,February,2018,BRGAS-Gas,Bills,28,4285
15,February,2018,Pret A Manger,Eating Out,8,4277
16,February,2018,LBS Council Tax,Bills,50,4227
16,February,2018,Sainsburys,Groceries,79,4148
17,February,2018,Dominos Pizza,Eating Out,49,4099
18,February,2018,Pizza Express,Eating Out,40,4059
19,February,2018,South West Trains,Transport,34,4025
19,February,2018,Starbucks Coffee,Eating Out,1,4024
19,February,2018,ATM Cash Withdrawal,General,50,3974
20,February,2018,VIRGIN MEDIA PYMTS,Bills,41,3933
20,February,2018,The West Cornwall Pasty Company,Eating Out,8,3925
21,February,2018,Costa Coffee,Eating Out,2,3923
21,February,2018,McDonalds,Eating Out,5,3918
22,February,2018,Caffe Nero,Eating Out,2,3916
22,February,2018,Chicken Cottage,Eating Out,7,3909
23,February,2018,Sainsburys,Groceries,59,3850
23,February,2018,Costa Coffee,Eating Out,1,3849
24,February,2018,O2,Bills,35,3814
24,February,2018,Scott's Restaurant,Eating Out,40,3774
26,February,2018,South West Trains,Transport,36,3738
26,February,2018,Costa Coffee,Eating Out,2,3736
27,February,2018,Caffe Nero,Eating Out,2,3734
27,February,2018,Subway,Eating Out,5,3729
28,February,2018,Caffe Nero,Eating Out,2,3727
1,March,2018,Rhino Sports salary,General,1700,5427
2,March,2018,Tescos,Groceries,68,5359
2,March,2018,Greggs,Eating Out,8,5351
5,March,2018,South West Trains,Transport,25,5326
5,March,2018,Wild Bean Cafe,Eating Out,1,5325
5,March,2018,McDonalds,Eating Out,5,5320
6,March,2018,ATM Cash Withdrawal,General,80,5240
7,March,2018,Cubit and West rent,Rent,660,4580
7,March,2018,Starbucks Coffee,Eating Out,2,4578
7,March,2018,McDonalds,Eating Out,4,4574
8,March,2018,The West Cornwall Pasty Company,Eating Out,6,4568
9,March,2018,Sainsburys,Groceries,81,4487
9,March,2018,McDonalds,Eating Out,7,4480
12,March,2018,South West Trains,Transport,38,4442
12,March,2018,Caffe Nero,Eating Out,2,4440
12,March,2018,The West Cornwall Pasty Company,Eating Out,6,4434
13,March,2018,Wild Bean Cafe,Eating Out,2,4432
13,March,2018,Pret A Manger,Eating Out,4,4428
13,March,2018,ATM Cash Withdrawal,General,70,4358
14,March,2018,Starbucks Coffee,Eating Out,2,4356
14,March,2018,The West Cornwall Pasty Company,Eating Out,7,4349
15,March,2018,BRGAS-Electricity,Bills,37,4312
15,March,2018,BRGAS-Gas,Bills,35,4277
15,March,2018,Costa Coffee,Eating Out,1,4276
16,March,2018,LBS Council Tax,Bills,50,4226
16,March,2018,Morrisons,Groceries,81,4145
16,March,2018,Wild Bean Cafe,Eating Out,2,4143
16,March,2018,The West Cornwall Pasty Company,Eating Out,6,4137
16,March,2018,The Grand Pub,Eating Out,9,4128
16,March,2018,The Grand Pub,Eating Out,12,4116
16,March,2018,The Grand Pub,Eating Out,15,4101
16,March,2018,The Grand Pub,Eating Out,13,4088
16,March,2018,The Grand Pub,Eating Out,7,4081
17,March,2018,Dominos Pizza,Eating Out,38,4043
18,March,2018,ATM Cash Withdrawal,General,70,3973
19,March,2018,South West Trains,Transport,24,3949
19,March,2018,Wild Bean Cafe,Eating Out,2,3947
19,March,2018,Greggs,Eating Out,4,3943
20,March,2018,VIRGIN MEDIA PYMTS,Bills,53,3890
21,March,2018,Caffe Nero,Eating Out,2,3888
21,March,2018,Chicken Cottage,Eating Out,4,3884
22,March,2018,Wild Bean Cafe,Eating Out,1,3883
22,March,2018,The West Cornwall Pasty Company,Eating Out,5,3878
23,March,2018,ASDA,Groceries,62,3816
23,March,2018,Starbucks Coffee,Eating Out,1,3815
23,March,2018,Scott's Restaurant,Eating Out,56,3759
24,March,2018,O2,Bills,38,3721
26,March,2018,South West Trains,Transport,36,3685
26,March,2018,Wild Bean Cafe,Eating Out,2,3683
26,March,2018,Subway,Eating Out,5,3678
