Day,Month,Year,Description,Category,Value,Balance
1,1,2010,Rhino Sports salary,General,1700,1700
1,1,2010,ASDA,Groceries,84,1616
1,1,2010,Starbucks Coffee,Eating Out,2,1614
1,1,2010,Greggs,Eating Out,5,1609
1,1,2010,Dominos Pizza,Eating Out,28,1581
4,1,2010,South West Trains,Transport,24,1557
4,1,2010,Pret A Manger,Eating Out,4,1553
4,1,2010,ATM Cash Withdrawal,General,10,1543
5,1,2010,Starbucks Coffee,Eating Out,1,1542
6,1,2010,Wild Bean Cafe,Eating Out,2,1540
6,1,2010,Chicken Cottage,Eating Out,7,1533
6,1,2010,ATM Cash Withdrawal,General,20,1513
7,1,2010,Cubit and West rent,Rent,550,963
7,1,2010,Costa Coffee,Eating Out,2,961
8,1,2010,Morrisons,Groceries,88,873
8,1,2010,Chicken Cottage,Eating Out,8,865
8,1,2010,Fabric Club,Eating Out,9,856
8,1,2010,Fabric Club,Eating Out,14,842
9,1,2010,Ministry of Sound ClubXOYO Club,Eating Out,12,830
9,1,2010,Ministry of Sound ClubXOYO Club,Eating Out,6,824
9,1,2010,Scott's Restaurant,Eating Out,29,795
11,1,2010,South West Trains,Transport,29,766
11,1,2010,Starbucks Coffee,Eating Out,2,764
11,1,2010,The West Cornwall Pasty Company,Eating Out,6,758
11,1,2010,ATM Cash Withdrawal,General,10,748
12,1,2010,Wild Bean Cafe,Eating Out,1,747
12,1,2010,The West Cornwall Pasty Company,Eating Out,6,741
12,1,2010,ATM Cash Withdrawal,General,20,721
13,1,2010,Costa Coffee,Eating Out,1,720
13,1,2010,Pret A Manger,Eating Out,4,716
13,1,2010,ATM Cash Withdrawal,General,20,696
14,1,2010,Starbucks Coffee,Eating Out,2,694
14,1,2010,ATM Cash Withdrawal,General,10,684
15,1,2010,BRGAS-Electricity,Bills,49,635
15,1,2010,BRGAS-Gas,Bills,49,586
15,1,2010,Waitrose,Groceries,89,497
15,1,2010,Starbucks Coffee,Eating Out,2,495
15,1,2010,Greggs,Eating Out,7,488
16,1,2010,LBS Council Tax,Bills,50,438
16,1,2010,Pizza Express,Eating Out,29,409
18,1,2010,South West Trains,Transport,25,384
18,1,2010,Caffe Nero,Eating Out,2,382
18,1,2010,McDonalds,Eating Out,4,378
19,1,2010,Caffe Nero,Eating Out,2,376
20,1,2010,VIRGIN MEDIA PYMTS,Bills,39,337
20,1,2010,Costa Coffee,Eating Out,1,336
20,1,2010,Pret A Manger,Eating Out,5,331
20,1,2010,ATM Cash Withdrawal,General,20,311
21,1,2010,Caffe Nero,Eating Out,2,309
21,1,2010,ATM Cash Withdrawal,General,10,299
22,1,2010,Tescos,Groceries,75,224
22,1,2010,Starbucks Coffee,Eating Out,1,223
22,1,2010,McDonalds,Eating Out,4,219
22,1,2010,ATM Cash Withdrawal,General,10,209
24,1,2010,O2,Bills,32,177
25,1,2010,South West Trains,Transport,33,144
26,1,2010,Starbucks Coffee,Eating Out,2,142
27,1,2010,Wild Bean Cafe,Eating Out,2,140
27,1,2010,McDonalds,Eating Out,7,133
28,1,2010,Starbucks Coffee,Eating Out,2,131
28,1,2010,ATM Cash Withdrawal,General,10,121
29,1,2010,ASDA,Groceries,42,79
29,1,2010,Costa Coffee,Eating Out,2,77
29,1,2010,Chicken Cottage,Eating Out,8,69
30,1,2010,Dominos Pizza,Eating Out,54,15
30,1,2010,ATM Cash Withdrawal,General,10,5
1,2,2010,Rhino Sports salary,General,1700,1705
1,2,2010,South West Trains,Transport,34,1671
1,2,2010,Wild Bean Cafe,Eating Out,2,1669
1,2,2010,McDonalds,Eating Out,4,1665
1,2,2010,ATM Cash Withdrawal,General,10,1655
2,2,2010,Caffe Nero,Eating Out,2,1653
2,2,2010,Greggs,Eating Out,5,1648
4,2,2010,The West Cornwall Pasty Company,Eating Out,5,1643
5,2,2010,ASDA,Groceries,53,1590
5,2,2010,Caffe Nero,Eating Out,2,1588
5,2,2010,ATM Cash Withdrawal,General,10,1578
7,2,2010,Cubit and West rent,Rent,550,1028
8,2,2010,South West Trains,Transport,36,992
8,2,2010,ATM Cash Withdrawal,General,10,982
9,2,2010,Wild Bean Cafe,Eating Out,1,981
10,2,2010,Costa Coffee,Eating Out,2,979
10,2,2010,McDonalds,Eating Out,8,971
11,2,2010,Chicken Cottage,Eating Out,7,964
12,2,2010,ASDA,Groceries,78,886
12,2,2010,Costa Coffee,Eating Out,1,885
12,2,2010,Ministry of Sound ClubXOYO Club,Eating Out,8,877
12,2,2010,Ministry of Sound ClubXOYO Club,Eating Out,8,869
12,2,2010,Ministry of Sound ClubXOYO Club,Eating Out,11,858
12,2,2010,Ministry of Sound ClubXOYO Club,Eating Out,5,853
12,2,2010,Ministry of Sound ClubXOYO Club,Eating Out,5,848
12,2,2010,Ministry of Sound ClubXOYO Club,Eating Out,14,834
12,2,2010,ATM Cash Withdrawal,General,20,814
13,2,2010,Fabric Club,Eating Out,16,798
13,2,2010,Fabric Club,Eating Out,12,786
13,2,2010,Fabric Club,Eating Out,14,772
13,2,2010,ATM Cash Withdrawal,General,10,762
15,2,2010,BRGAS-Electricity,Bills,43,719
15,2,2010,BRGAS-Gas,Bills,26,693
15,2,2010,South West Trains,Transport,37,656
15,2,2010,Costa Coffee,Eating Out,2,654
15,2,2010,ATM Cash Withdrawal,General,10,644
16,2,2010,LBS Council Tax,Bills,50,594
16,2,2010,Caffe Nero,Eating Out,2,592
16,2,2010,Subway,Eating Out,7,585
16,2,2010,ATM Cash Withdrawal,General,20,565
17,2,2010,Subway,Eating Out,7,558
18,2,2010,The West Cornwall Pasty Company,Eating Out,6,552
19,2,2010,Morrisons,Groceries,75,477
19,2,2010,Costa Coffee,Eating Out,2,475
19,2,2010,Pret A Manger,Eating Out,5,470
20,2,2010,VIRGIN MEDIA PYMTS,Bills,56,414
21,2,2010,Pizza Express,Eating Out,35,379
21,2,2010,ATM Cash Withdrawal,General,10,369
22,2,2010,South West Trains,Transport,37,332
22,2,2010,Caffe Nero,Eating Out,2,330
22,2,2010,Greggs,Eating Out,4,326
23,2,2010,Costa Coffee,Eating Out,1,325
24,2,2010,O2,Bills,35,290
24,2,2010,Wild Bean Cafe,Eating Out,1,289
25,2,2010,Caffe Nero,Eating Out,1,288
26,2,2010,Waitrose,Groceries,44,244
26,2,2010,Starbucks Coffee,Eating Out,1,243
26,2,2010,Dominos Pizza,Eating Out,25,218
1,3,2010,Rhino Sports salary,General,1700,1918
1,3,2010,South West Trains,Transport,36,1882
1,3,2010,Wild Bean Cafe,Eating Out,1,1881
1,3,2010,Chicken Cottage,Eating Out,7,1874
2,3,2010,Costa Coffee,Eating Out,2,1872
2,3,2010,McDonalds,Eating Out,4,1868
2,3,2010,ATM Cash Withdrawal,General,20,1848
3,3,2010,Caffe Nero,Eating Out,2,1846
3,3,2010,Pret A Manger,Eating Out,5,1841
3,3,2010,ATM Cash Withdrawal,General,20,1821
4,3,2010,Costa Coffee,Eating Out,1,1820
4,3,2010,The West Cornwall Pasty Company,Eating Out,5,1815
5,3,2010,Waitrose,Groceries,61,1754
5,3,2010,Costa Coffee,Eating Out,1,1753
5,3,2010,Heaven Club,Eating Out,12,1741
5,3,2010,Heaven Club,Eating Out,8,1733
5,3,2010,Restaurant Gordon RamsayPortland Restaurant,Eating Out,56,1677
6,3,2010,Heaven Club,Eating Out,11,1666
6,3,2010,Heaven Club,Eating Out,9,1657
6,3,2010,Pizza Express,Eating Out,32,1625
7,3,2010,Cubit and West rent,Rent,550,1075
7,3,2010,Restaurant Gordon RamsayPortland Restaurant,Eating Out,33,1042
8,3,2010,South West Trains,Transport,26,1016
8,3,2010,The West Cornwall Pasty Company,Eating Out,6,1010
8,3,2010,ATM Cash Withdrawal,General,20,990
9,3,2010,Wild Bean Cafe,Eating Out,1,989
9,3,2010,Chicken Cottage,Eating Out,5,984
10,3,2010,ATM Cash Withdrawal,General,10,974
11,3,2010,Wild Bean Cafe,Eating Out,1,973
11,3,2010,The West Cornwall Pasty Company,Eating Out,8,965
11,3,2010,ATM Cash Withdrawal,General,10,955
12,3,2010,Morrisons,Groceries,55,900
12,3,2010,Starbucks Coffee,Eating Out,1,899
13,3,2010,Anglo restaurant,Eating Out,28,871
15,3,2010,BRGAS-Electricity,Bills,41,830
15,3,2010,BRGAS-Gas,Bills,21,809
15,3,2010,South West Trains,Transport,25,784
15,3,2010,Wild Bean Cafe,Eating Out,2,782
16,3,2010,LBS Council Tax,Bills,50,732
16,3,2010,Starbucks Coffee,Eating Out,1,731
16,3,2010,Pret A Manger,Eating Out,6,725
17,3,2010,Wild Bean Cafe,Eating Out,2,723
17,3,2010,ATM Cash Withdrawal,General,20,703
18,3,2010,Subway,Eating Out,4,699
19,3,2010,Sainsburys,Groceries,53,646
19,3,2010,Starbucks Coffee,Eating Out,2,644
19,3,2010,Subway,Eating Out,4,640
19,3,2010,Scott's Restaurant,Eating Out,43,597
19,3,2010,ATM Cash Withdrawal,General,10,587
20,3,2010,VIRGIN MEDIA PYMTS,Bills,29,558
22,3,2010,South West Trains,Transport,28,530
22,3,2010,Caffe Nero,Eating Out,1,529
22,3,2010,Pret A Manger,Eating Out,5,524
23,3,2010,Caffe Nero,Eating Out,2,522
23,3,2010,Pret A Manger,Eating Out,7,515
23,3,2010,ATM Cash Withdrawal,General,10,505
24,3,2010,O2,Bills,33,472
24,3,2010,Caffe Nero,Eating Out,1,471
24,3,2010,Subway,Eating Out,5,466
24,3,2010,ATM Cash Withdrawal,General,20,446
25,3,2010,Starbucks Coffee,Eating Out,2,444
26,3,2010,Morrisons,Groceries,58,386
26,3,2010,Wild Bean Cafe,Eating Out,1,385
29,3,2010,South West Trains,Transport,25,360
29,3,2010,Costa Coffee,Eating Out,2,358
29,3,2010,Greggs,Eating Out,4,354
30,3,2010,Costa Coffee,Eating Out,1,353
30,3,2010,Pret A Manger,Eating Out,6,347
31,3,2010,Costa Coffee,Eating Out,2,345
31,3,2010,Subway,Eating Out,6,339
1,4,2010,Rhino Sports salary,General,1700,2039
1,4,2010,Starbucks Coffee,Eating Out,2,2037
2,4,2010,ASDA,Groceries,75,1962
2,4,2010,Costa Coffee,Eating Out,2,1960
2,4,2010,Anglo restaurant,Eating Out,38,1922
3,4,2010,Dominos Pizza,Eating Out,37,1885
3,4,2010,ATM Cash Withdrawal,General,10,1875
5,4,2010,South West Trains,Transport,37,1838
5,4,2010,Starbucks Coffee,Eating Out,2,1836
5,4,2010,The West Cornwall Pasty Company,Eating Out,5,1831
6,4,2010,Costa Coffee,Eating Out,2,1829
6,4,2010,Pret A Manger,Eating Out,6,1823
7,4,2010,Cubit and West rent,Rent,550,1273
7,4,2010,Wild Bean Cafe,Eating Out,2,1271
8,4,2010,Costa Coffee,Eating Out,1,1270
9,4,2010,Tescos,Groceries,69,1201
9,4,2010,Starbucks Coffee,Eating Out,2,1199
9,4,2010,Chicken Cottage,Eating Out,5,1194
9,4,2010,Restaurant Gordon RamsayPortland Restaurant,Eating Out,41,1153
10,4,2010,Pizza Express,Eating Out,27,1126
11,4,2010,Restaurant Gordon RamsayPortland Restaurant,Eating Out,43,1083
11,4,2010,ATM Cash Withdrawal,General,20,1063
12,4,2010,South West Trains,Transport,30,1033
12,4,2010,Caffe Nero,Eating Out,1,1032
12,4,2010,McDonalds,Eating Out,7,1025
13,4,2010,Wild Bean Cafe,Eating Out,1,1024
13,4,2010,Subway,Eating Out,8,1016
14,4,2010,Starbucks Coffee,Eating Out,2,1014
14,4,2010,McDonalds,Eating Out,4,1010
15,4,2010,BRGAS-Electricity,Bills,43,967
15,4,2010,BRGAS-Gas,Bills,28,939
15,4,2010,Wild Bean Cafe,Eating Out,2,937
16,4,2010,LBS Council Tax,Bills,50,887
16,4,2010,Sainsburys,Groceries,60,827
16,4,2010,Starbucks Coffee,Eating Out,1,826
17,4,2010,ATM Cash Withdrawal,General,10,816
18,4,2010,Anglo restaurant,Eating Out,59,757
18,4,2010,ATM Cash Withdrawal,General,20,737
19,4,2010,South West Trains,Transport,24,713
19,4,2010,Caffe Nero,Eating Out,2,711
19,4,2010,Pret A Manger,Eating Out,7,704
20,4,2010,VIRGIN MEDIA PYMTS,Bills,46,658
20,4,2010,McDonalds,Eating Out,7,651
20,4,2010,ATM Cash Withdrawal,General,10,641
21,4,2010,Wild Bean Cafe,Eating Out,2,639
21,4,2010,Pret A Manger,Eating Out,6,633
21,4,2010,ATM Cash Withdrawal,General,10,623
22,4,2010,Wild Bean Cafe,Eating Out,2,621
23,4,2010,Waitrose,Groceries,50,571
23,4,2010,Wild Bean Cafe,Eating Out,1,570
23,4,2010,Fabric Club,Eating Out,13,557
23,4,2010,Fabric Club,Eating Out,7,550
23,4,2010,Fabric Club,Eating Out,5,545
23,4,2010,Fabric Club,Eating Out,16,529
23,4,2010,Fabric Club,Eating Out,11,518
24,4,2010,O2,Bills,38,480
26,4,2010,South West Trains,Transport,27,453
26,4,2010,Wild Bean Cafe,Eating Out,2,451
27,4,2010,Caffe Nero,Eating Out,2,449
28,4,2010,Wild Bean Cafe,Eating Out,2,447
29,4,2010,Starbucks Coffee,Eating Out,2,445
30,4,2010,ASDA,Groceries,72,373
30,4,2010,Caffe Nero,Eating Out,2,371
30,4,2010,Subway,Eating Out,7,364
1,5,2010,Rhino Sports salary,General,1700,2064
1,5,2010,ATM Cash Withdrawal,General,10,2054
2,5,2010,Restaurant Gordon RamsayPortland Restaurant,Eating Out,40,2014
3,5,2010,South West Trains,Transport,30,1984
3,5,2010,Wild Bean Cafe,Eating Out,2,1982
4,5,2010,Pret A Manger,Eating Out,6,1976
4,5,2010,ATM Cash Withdrawal,General,20,1956
5,5,2010,Starbucks Coffee,Eating Out,1,1955
5,5,2010,Subway,Eating Out,6,1949
6,5,2010,Caffe Nero,Eating Out,2,1947
7,5,2010,Cubit and West rent,Rent,550,1397
7,5,2010,Tescos,Groceries,46,1351
7,5,2010,Caffe Nero,Eating Out,2,1349
7,5,2010,Pret A Manger,Eating Out,5,1344
7,5,2010,ATM Cash Withdrawal,General,20,1324
9,5,2010,Restaurant Gordon RamsayPortland Restaurant,Eating Out,42,1282
10,5,2010,South West Trains,Transport,31,1251
10,5,2010,Pret A Manger,Eating Out,5,1246
11,5,2010,Caffe Nero,Eating Out,1,1245
12,5,2010,McDonalds,Eating Out,7,1238
12,5,2010,ATM Cash Withdrawal,General,20,1218
13,5,2010,Wild Bean Cafe,Eating Out,2,1216
13,5,2010,Pret A Manger,Eating Out,7,1209
14,5,2010,Waitrose,Groceries,75,1134
14,5,2010,Wild Bean Cafe,Eating Out,1,1133
14,5,2010,Fabric Club,Eating Out,14,1119
14,5,2010,Fabric Club,Eating Out,6,1113
14,5,2010,Fabric Club,Eating Out,11,1102
14,5,2010,Fabric Club,Eating Out,7,1095
14,5,2010,Fabric Club,Eating Out,8,1087
14,5,2010,Fabric Club,Eating Out,14,1073
14,5,2010,Pizza Express,Eating Out,27,1046
15,5,2010,BRGAS-Electricity,Bills,30,1016
15,5,2010,BRGAS-Gas,Bills,41,975
16,5,2010,LBS Council Tax,Bills,50,925
16,5,2010,Anglo restaurant,Eating Out,44,881
17,5,2010,South West Trains,Transport,24,857
17,5,2010,Wild Bean Cafe,Eating Out,2,855
17,5,2010,ATM Cash Withdrawal,General,10,845
18,5,2010,Costa Coffee,Eating Out,1,844
18,5,2010,The West Cornwall Pasty Company,Eating Out,6,838
19,5,2010,Greggs,Eating Out,6,832
20,5,2010,VIRGIN MEDIA PYMTS,Bills,32,800
20,5,2010,Greggs,Eating Out,6,794
21,5,2010,Sainsburys,Groceries,52,742
21,5,2010,Chicken Cottage,Eating Out,6,736
21,5,2010,Scott's Restaurant,Eating Out,43,693
21,5,2010,ATM Cash Withdrawal,General,10,683
23,5,2010,Scott's Restaurant,Eating Out,48,635
23,5,2010,ATM Cash Withdrawal,General,10,625
24,5,2010,O2,Bills,33,592
24,5,2010,South West Trains,Transport,30,562
24,5,2010,Starbucks Coffee,Eating Out,2,560
24,5,2010,Greggs,Eating Out,5,555
24,5,2010,ATM Cash Withdrawal,General,20,535
25,5,2010,Starbucks Coffee,Eating Out,1,534
25,5,2010,The West Cornwall Pasty Company,Eating Out,8,526
26,5,2010,Wild Bean Cafe,Eating Out,1,525
27,5,2010,ATM Cash Withdrawal,General,10,515
28,5,2010,Waitrose,Groceries,70,445
28,5,2010,Costa Coffee,Eating Out,1,444
29,5,2010,The Grand Pub,Eating Out,10,434
31,5,2010,South West Trains,Transport,27,407
31,5,2010,Caffe Nero,Eating Out,2,405
31,5,2010,Chicken Cottage,Eating Out,6,399
1,6,2010,Rhino Sports salary,General,1700,2099
1,6,2010,Costa Coffee,Eating Out,2,2097
1,6,2010,British Airways,General,141,1956
2,6,2010,Caffe Nero,Eating Out,2,1954
2,6,2010,Subway,Eating Out,8,1946
3,6,2010,Caffe Nero,Eating Out,2,1944
3,6,2010,ATM Cash Withdrawal,General,10,1934
4,6,2010,Waitrose,Groceries,76,1858
4,6,2010,Starbucks Coffee,Eating Out,2,1856
4,6,2010,Subway,Eating Out,7,1849
7,6,2010,Cubit and West rent,Rent,550,1299
7,6,2010,South West Trains,Transport,32,1267
8,6,2010,Costa Coffee,Eating Out,2,1265
8,6,2010,McDonalds,Eating Out,4,1261
9,6,2010,Wild Bean Cafe,Eating Out,2,1259
9,6,2010,ATM Cash Withdrawal,General,10,1249
10,6,2010,Starbucks Coffee,Eating Out,2,1247
10,6,2010,Chicken Cottage,Eating Out,6,1241
11,6,2010,Waitrose,Groceries,89,1152
11,6,2010,Costa Coffee,Eating Out,1,1151
11,6,2010,Restaurant Gordon RamsayPortland Restaurant,Eating Out,28,1123
12,6,2010,The Grand Pub,Eating Out,9,1114
12,6,2010,The Grand Pub,Eating Out,10,1104
12,6,2010,The Grand Pub,Eating Out,12,1092
12,6,2010,The Grand Pub,Eating Out,6,1086
12,6,2010,The Grand Pub,Eating Out,15,1071
13,6,2010,Dominos Pizza,Eating Out,31,1040
14,6,2010,South West Trains,Transport,30,1010
14,6,2010,Starbucks Coffee,Eating Out,2,1008
15,6,2010,BRGAS-Electricity,Bills,28,980
15,6,2010,BRGAS-Gas,Bills,33,947
15,6,2010,Caffe Nero,Eating Out,2,945
16,6,2010,LBS Council Tax,Bills,50,895
16,6,2010,Costa Coffee,Eating Out,2,893
16,6,2010,McDonalds,Eating Out,4,889
17,6,2010,Wild Bean Cafe,Eating Out,1,888
18,6,2010,Waitrose,Groceries,68,820
18,6,2010,Wild Bean Cafe,Eating Out,2,818
18,6,2010,Greggs,Eating Out,4,814
19,6,2010,The Grand Pub,Eating Out,8,806
19,6,2010,The Grand Pub,Eating Out,6,800
19,6,2010,The Grand Pub,Eating Out,16,784
19,6,2010,The Grand Pub,Eating Out,10,774
19,6,2010,The Grand Pub,Eating Out,8,766
20,6,2010,VIRGIN MEDIA PYMTS,Bills,44,722
20,6,2010,Anglo restaurant,Eating Out,35,687
20,6,2010,ATM Cash Withdrawal,General,10,677
21,6,2010,South West Trains,Transport,38,639
21,6,2010,Caffe Nero,Eating Out,2,637
21,6,2010,Pret A Manger,Eating Out,8,629
22,6,2010,Costa Coffee,Eating Out,2,627
24,6,2010,O2,Bills,32,595
24,6,2010,Caffe Nero,Eating Out,2,593
24,6,2010,Pret A Manger,Eating Out,7,586
25,6,2010,Waitrose,Groceries,58,528
25,6,2010,McDonalds,Eating Out,5,523
26,6,2010,Heaven Club,Eating Out,16,507
26,6,2010,Heaven Club,Eating Out,15,492
26,6,2010,Heaven Club,Eating Out,13,479
26,6,2010,Heaven Club,Eating Out,13,466
26,6,2010,Heaven Club,Eating Out,10,456
27,6,2010,ATM Cash Withdrawal,General,10,446
28,6,2010,South West Trains,Transport,32,414
29,6,2010,Caffe Nero,Eating Out,2,412
29,6,2010,Pret A Manger,Eating Out,6,406
30,6,2010,Costa Coffee,Eating Out,1,405
30,6,2010,Greggs,Eating Out,6,399
30,6,2010,ATM Cash Withdrawal,General,10,389
1,7,2010,Rhino Sports salary,General,1700,2089
1,7,2010,Starbucks Coffee,Eating Out,2,2087
2,7,2010,Sainsburys,Groceries,47,2040
2,7,2010,Wild Bean Cafe,Eating Out,2,2038
2,7,2010,Greggs,Eating Out,6,2032
3,7,2010,ATM Cash Withdrawal,General,20,2012
5,7,2010,South West Trains,Transport,28,1984
5,7,2010,Caffe Nero,Eating Out,1,1983
6,7,2010,Starbucks Coffee,Eating Out,2,1981
6,7,2010,Subway,Eating Out,7,1974
7,7,2010,Cubit and West rent,Rent,550,1424
7,7,2010,Caffe Nero,Eating Out,2,1422
7,7,2010,McDonalds,Eating Out,4,1418
7,7,2010,ATM Cash Withdrawal,General,20,1398
8,7,2010,Starbucks Coffee,Eating Out,1,1397
8,7,2010,Chicken Cottage,Eating Out,8,1389
9,7,2010,Waitrose,Groceries,44,1345
9,7,2010,Wild Bean Cafe,Eating Out,1,1344
9,7,2010,Dominos Pizza,Eating Out,54,1290
12,7,2010,South West Trains,Transport,25,1265
12,7,2010,Costa Coffee,Eating Out,2,1263
13,7,2010,Starbucks Coffee,Eating Out,1,1262
13,7,2010,The West Cornwall Pasty Company,Eating Out,6,1256
14,7,2010,Chicken Cottage,Eating Out,8,1248
14,7,2010,ATM Cash Withdrawal,General,20,1228
15,7,2010,BRGAS-Electricity,Bills,28,1200
15,7,2010,BRGAS-Gas,Bills,43,1157
15,7,2010,Starbucks Coffee,Eating Out,1,1156
15,7,2010,Pret A Manger,Eating Out,5,1151
16,7,2010,LBS Council Tax,Bills,50,1101
16,7,2010,ASDA,Groceries,64,1037
16,7,2010,Scott's Restaurant,Eating Out,49,988
19,7,2010,South West Trains,Transport,25,963
19,7,2010,Pret A Manger,Eating Out,5,958
20,7,2010,VIRGIN MEDIA PYMTS,Bills,46,912
20,7,2010,Caffe Nero,Eating Out,2,910
20,7,2010,ATM Cash Withdrawal,General,10,900
21,7,2010,Starbucks Coffee,Eating Out,1,899
21,7,2010,Subway,Eating Out,7,892
22,7,2010,Costa Coffee,Eating Out,2,890
22,7,2010,Chicken Cottage,Eating Out,8,882
23,7,2010,Tescos,Groceries,77,805
23,7,2010,Caffe Nero,Eating Out,2,803
23,7,2010,Scott's Restaurant,Eating Out,26,777
23,7,2010,ATM Cash Withdrawal,General,20,757
24,7,2010,O2,Bills,36,721
24,7,2010,Restaurant Gordon RamsayPortland Restaurant,Eating Out,51,670
25,7,2010,Anglo restaurant,Eating Out,31,639
26,7,2010,South West Trains,Transport,27,612
26,7,2010,Starbucks Coffee,Eating Out,1,611
26,7,2010,ATM Cash Withdrawal,General,20,591
27,7,2010,Caffe Nero,Eating Out,2,589
27,7,2010,Greggs,Eating Out,6,583
28,7,2010,Caffe Nero,Eating Out,1,582
29,7,2010,Costa Coffee,Eating Out,2,580
29,7,2010,The West Cornwall Pasty Company,Eating Out,7,573
30,7,2010,Morrisons,Groceries,81,492
30,7,2010,Costa Coffee,Eating Out,2,490
30,7,2010,Greggs,Eating Out,7,483
30,7,2010,Dominos Pizza,Eating Out,54,429
1,8,2010,Rhino Sports salary,General,1700,2129
1,8,2010,Pizza Express,Eating Out,39,2090
1,8,2010,ATM Cash Withdrawal,General,20,2070
2,8,2010,South West Trains,Transport,33,2037
2,8,2010,Costa Coffee,Eating Out,2,2035
2,8,2010,The West Cornwall Pasty Company,Eating Out,6,2029
3,8,2010,Costa Coffee,Eating Out,2,2027
3,8,2010,Greggs,Eating Out,6,2021
4,8,2010,Wild Bean Cafe,Eating Out,2,2019
4,8,2010,Pret A Manger,Eating Out,7,2012
4,8,2010,ATM Cash Withdrawal,General,10,2002
5,8,2010,Wild Bean Cafe,Eating Out,1,2001
5,8,2010,The West Cornwall Pasty Company,Eating Out,8,1993
6,8,2010,ASDA,Groceries,74,1919
6,8,2010,Starbucks Coffee,Eating Out,1,1918
6,8,2010,Chicken Cottage,Eating Out,8,1910
6,8,2010,Restaurant Gordon RamsayPortland Restaurant,Eating Out,50,1860
7,8,2010,Cubit and West rent,Rent,550,1310
7,8,2010,Pizza Express,Eating Out,44,1266
8,8,2010,Scott's Restaurant,Eating Out,46,1220
9,8,2010,South West Trains,Transport,26,1194
9,8,2010,Wild Bean Cafe,Eating Out,1,1193
9,8,2010,McDonalds,Eating Out,6,1187
10,8,2010,Starbucks Coffee,Eating Out,2,1185
10,8,2010,The West Cornwall Pasty Company,Eating Out,6,1179
10,8,2010,ATM Cash Withdrawal,General,20,1159
11,8,2010,Wild Bean Cafe,Eating Out,1,1158
12,8,2010,Wild Bean Cafe,Eating Out,2,1156
13,8,2010,Sainsburys,Groceries,81,1075
13,8,2010,Starbucks Coffee,Eating Out,1,1074
13,8,2010,Scott's Restaurant,Eating Out,30,1044
14,8,2010,Dominos Pizza,Eating Out,31,1013
15,8,2010,BRGAS-Electricity,Bills,38,975
15,8,2010,BRGAS-Gas,Bills,38,937
16,8,2010,LBS Council Tax,Bills,50,887
16,8,2010,South West Trains,Transport,38,849
17,8,2010,Costa Coffee,Eating Out,2,847
17,8,2010,Greggs,Eating Out,5,842
18,8,2010,Wild Bean Cafe,Eating Out,2,840
18,8,2010,The West Cornwall Pasty Company,Eating Out,5,835
19,8,2010,Starbucks Coffee,Eating Out,1,834
19,8,2010,McDonalds,Eating Out,7,827
20,8,2010,VIRGIN MEDIA PYMTS,Bills,53,774
20,8,2010,Morrisons,Groceries,44,730
20,8,2010,Chicken Cottage,Eating Out,7,723
20,8,2010,ATM Cash Withdrawal,General,20,703
21,8,2010,Fabric Club,Eating Out,5,698
21,8,2010,Fabric Club,Eating Out,13,685
21,8,2010,Fabric Club,Eating Out,16,669
21,8,2010,Fabric Club,Eating Out,16,653
21,8,2010,Pizza Express,Eating Out,28,625
22,8,2010,ATM Cash Withdrawal,General,20,605
23,8,2010,South West Trains,Transport,26,579
23,8,2010,Pret A Manger,Eating Out,5,574
23,8,2010,ATM Cash Withdrawal,General,10,564
24,8,2010,O2,Bills,31,533
24,8,2010,Caffe Nero,Eating Out,2,531
26,8,2010,McDonalds,Eating Out,6,525
27,8,2010,ASDA,Groceries,80,445
27,8,2010,ATM Cash Withdrawal,General,10,435
28,8,2010,Fabric Club,Eating Out,7,428
28,8,2010,Fabric Club,Eating Out,9,419
28,8,2010,Fabric Club,Eating Out,11,408
28,8,2010,Fabric Club,Eating Out,10,398
28,8,2010,Fabric Club,Eating Out,7,391
28,8,2010,ATM Cash Withdrawal,General,10,381
29,8,2010,Dominos Pizza,Eating Out,54,327
29,8,2010,ATM Cash Withdrawal,General,20,307
30,8,2010,South West Trains,Transport,31,276
30,8,2010,Caffe Nero,Eating Out,2,274
30,8,2010,The West Cornwall Pasty Company,Eating Out,4,270
30,8,2010,ATM Cash Withdrawal,General,20,250
31,8,2010,Wild Bean Cafe,Eating Out,1,249
31,8,2010,Subway,Eating Out,8,241
31,8,2010,ATM Cash Withdrawal,General,20,221
1,9,2010,Rhino Sports salary,General,1700,1921
1,9,2010,Costa Coffee,Eating Out,2,1919
1,9,2010,McDonalds,Eating Out,8,1911
2,9,2010,Costa Coffee,Eating Out,2,1909
2,9,2010,The West Cornwall Pasty Company,Eating Out,7,1902
2,9,2010,ATM Cash Withdrawal,General,20,1882
3,9,2010,Waitrose,Groceries,49,1833
3,9,2010,Caffe Nero,Eating Out,1,1832
3,9,2010,Dominos Pizza,Eating Out,35,1797
5,9,2010,Scott's Restaurant,Eating Out,34,1763
6,9,2010,South West Trains,Transport,34,1729
6,9,2010,Costa Coffee,Eating Out,1,1728
6,9,2010,The West Cornwall Pasty Company,Eating Out,6,1722
7,9,2010,Cubit and West rent,Rent,550,1172
7,9,2010,Costa Coffee,Eating Out,2,1170
7,9,2010,McDonalds,Eating Out,5,1165
8,9,2010,Costa Coffee,Eating Out,1,1164
8,9,2010,McDonalds,Eating Out,5,1159
9,9,2010,Caffe Nero,Eating Out,2,1157
9,9,2010,Subway,Eating Out,6,1151
10,9,2010,Tescos,Groceries,73,1078
10,9,2010,Wild Bean Cafe,Eating Out,2,1076
10,9,2010,Pret A Manger,Eating Out,5,1071
10,9,2010,Scott's Restaurant,Eating Out,36,1035
10,9,2010,ATM Cash Withdrawal,General,20,1015
11,9,2010,Anglo restaurant,Eating Out,54,961
11,9,2010,ATM Cash Withdrawal,General,20,941
12,9,2010,Scott's Restaurant,Eating Out,59,882
13,9,2010,South West Trains,Transport,37,845
13,9,2010,Wild Bean Cafe,Eating Out,1,844
13,9,2010,The West Cornwall Pasty Company,Eating Out,8,836
15,9,2010,BRGAS-Electricity,Bills,41,795
15,9,2010,BRGAS-Gas,Bills,34,761
15,9,2010,Costa Coffee,Eating Out,2,759
16,9,2010,LBS Council Tax,Bills,50,709
16,9,2010,Caffe Nero,Eating Out,2,707
16,9,2010,Subway,Eating Out,6,701
16,9,2010,ATM Cash Withdrawal,General,20,681
17,9,2010,Waitrose,Groceries,71,610
17,9,2010,Wild Bean Cafe,Eating Out,2,608
17,9,2010,Pret A Manger,Eating Out,8,600
19,9,2010,ATM Cash Withdrawal,General,20,580
20,9,2010,VIRGIN MEDIA PYMTS,Bills,55,525
20,9,2010,South West Trains,Transport,28,497
20,9,2010,Caffe Nero,Eating Out,2,495
20,9,2010,McDonalds,Eating Out,7,488
21,9,2010,Costa Coffee,Eating Out,2,486
21,9,2010,Greggs,Eating Out,6,480
22,9,2010,Wild Bean Cafe,Eating Out,2,478
22,9,2010,Greggs,Eating Out,6,472
22,9,2010,ATM Cash Withdrawal,General,10,462
23,9,2010,Chicken Cottage,Eating Out,6,456
24,9,2010,O2,Bills,37,419
24,9,2010,Waitrose,Groceries,83,336
24,9,2010,The West Cornwall Pasty Company,Eating Out,4,332
24,9,2010,Fabric Club,Eating Out,12,320
24,9,2010,Fabric Club,Eating Out,5,315
25,9,2010,Pizza Express,Eating Out,48,267
26,9,2010,Pizza Express,Eating Out,49,218
27,9,2010,South West Trains,Transport,37,181
27,9,2010,Wild Bean Cafe,Eating Out,1,180
28,9,2010,Starbucks Coffee,Eating Out,2,178
28,9,2010,ATM Cash Withdrawal,General,10,168
29,9,2010,Wild Bean Cafe,Eating Out,2,166
30,9,2010,The West Cornwall Pasty Company,Eating Out,6,160
1,10,2010,Rhino Sports salary,General,1700,1860
1,10,2010,Tescos,Groceries,62,1798
1,10,2010,Costa Coffee,Eating Out,2,1796
1,10,2010,McDonalds,Eating Out,6,1790
3,10,2010,Dominos Pizza,Eating Out,44,1746
4,10,2010,South West Trains,Transport,30,1716
4,10,2010,Subway,Eating Out,4,1712
5,10,2010,Starbucks Coffee,Eating Out,1,1711
5,10,2010,ATM Cash Withdrawal,General,10,1701
6,10,2010,Starbucks Coffee,Eating Out,2,1699
6,10,2010,Greggs,Eating Out,4,1695
6,10,2010,ATM Cash Withdrawal,General,20,1675
7,10,2010,Cubit and West rent,Rent,550,1125
7,10,2010,Starbucks Coffee,Eating Out,2,1123
8,10,2010,Morrisons,Groceries,69,1054
8,10,2010,Wild Bean Cafe,Eating Out,1,1053
10,10,2010,ATM Cash Withdrawal,General,20,1033
11,10,2010,South West Trains,Transport,30,1003
11,10,2010,Costa Coffee,Eating Out,2,1001
11,10,2010,McDonalds,Eating Out,4,997
12,10,2010,Wild Bean Cafe,Eating Out,2,995
12,10,2010,McDonalds,Eating Out,4,991
13,10,2010,Costa Coffee,Eating Out,1,990
13,10,2010,Greggs,Eating Out,6,984
14,10,2010,Greggs,Eating Out,8,976
14,10,2010,ATM Cash Withdrawal,General,10,966
15,10,2010,BRGAS-Electricity,Bills,37,929
15,10,2010,BRGAS-Gas,Bills,38,891
15,10,2010,ASDA,Groceries,52,839
15,10,2010,Starbucks Coffee,Eating Out,1,838
15,10,2010,Greggs,Eating Out,8,830
15,10,2010,Anglo restaurant,Eating Out,41,789
16,10,2010,LBS Council Tax,Bills,50,739
16,10,2010,Heaven Club,Eating Out,16,723
16,10,2010,Heaven Club,Eating Out,13,710
16,10,2010,Heaven Club,Eating Out,12,698
16,10,2010,Heaven Club,Eating Out,5,693
16,10,2010,Pizza Express,Eating Out,38,655
16,10,2010,ATM Cash Withdrawal,General,20,635
17,10,2010,ATM Cash Withdrawal,General,20,615
18,10,2010,South West Trains,Transport,28,587
18,10,2010,Caffe Nero,Eating Out,2,585
19,10,2010,Caffe Nero,Eating Out,1,584
19,10,2010,Subway,Eating Out,7,577
20,10,2010,VIRGIN MEDIA PYMTS,Bills,55,522
20,10,2010,Caffe Nero,Eating Out,2,520
21,10,2010,Starbucks Coffee,Eating Out,1,519
21,10,2010,McDonalds,Eating Out,4,515
22,10,2010,Waitrose,Groceries,79,436
22,10,2010,Wild Bean Cafe,Eating Out,2,434
22,10,2010,The West Cornwall Pasty Company,Eating Out,6,428
23,10,2010,ATM Cash Withdrawal,General,10,418
24,10,2010,O2,Bills,33,385
24,10,2010,Dominos Pizza,Eating Out,52,333
25,10,2010,South West Trains,Transport,28,305
25,10,2010,McDonalds,Eating Out,4,301
26,10,2010,Starbucks Coffee,Eating Out,1,300
26,10,2010,McDonalds,Eating Out,4,296
27,10,2010,Caffe Nero,Eating Out,2,294
27,10,2010,Pret A Manger,Eating Out,4,290
28,10,2010,Starbucks Coffee,Eating Out,1,289
28,10,2010,The West Cornwall Pasty Company,Eating Out,8,281
29,10,2010,Tescos,Groceries,64,217
29,10,2010,Caffe Nero,Eating Out,1,216
29,10,2010,McDonalds,Eating Out,7,209
29,10,2010,Fabric Club,Eating Out,5,204
29,10,2010,Fabric Club,Eating Out,13,191
29,10,2010,Fabric Club,Eating Out,6,185
29,10,2010,Fabric Club,Eating Out,15,170
29,10,2010,Fabric Club,Eating Out,10,160
29,10,2010,Fabric Club,Eating Out,16,144
29,10,2010,Scott's Restaurant,Eating Out,54,90
30,10,2010,Restaurant Gordon RamsayPortland Restaurant,Eating Out,26,64
1,11,2010,Rhino Sports salary,General,1700,1764
1,11,2010,South West Trains,Transport,29,1735
2,11,2010,The West Cornwall Pasty Company,Eating Out,6,1729
2,11,2010,ATM Cash Withdrawal,General,20,1709
3,11,2010,Starbucks Coffee,Eating Out,1,1708
3,11,2010,Chicken Cottage,Eating Out,5,1703
3,11,2010,ATM Cash Withdrawal,General,20,1683
4,11,2010,Starbucks Coffee,Eating Out,2,1681
4,11,2010,Greggs,Eating Out,7,1674
5,11,2010,ASDA,Groceries,86,1588
5,11,2010,Starbucks Coffee,Eating Out,1,1587
5,11,2010,Pret A Manger,Eating Out,5,1582
6,11,2010,Anglo restaurant,Eating Out,51,1531
7,11,2010,Cubit and West rent,Rent,550,981
8,11,2010,South West Trains,Transport,35,946
8,11,2010,Wild Bean Cafe,Eating Out,1,945
9,11,2010,Costa Coffee,Eating Out,1,944
10,11,2010,Subway,Eating Out,5,939
10,11,2010,ATM Cash Withdrawal,General,20,919
11,11,2010,Caffe Nero,Eating Out,2,917
11,11,2010,Pret A Manger,Eating Out,7,910
11,11,2010,ATM Cash Withdrawal,General,10,900
12,11,2010,Waitrose,Groceries,65,835
12,11,2010,Chicken Cottage,Eating Out,7,828
15,11,2010,BRGAS-Electricity,Bills,66,762
15,11,2010,BRGAS-Gas,Bills,35,727
15,11,2010,South West Trains,Transport,32,695
15,11,2010,Starbucks Coffee,Eating Out,1,694
15,11,2010,Pret A Manger,Eating Out,4,690
16,11,2010,LBS Council Tax,Bills,50,640
16,11,2010,Starbucks Coffee,Eating Out,2,638
16,11,2010,The West Cornwall Pasty Company,Eating Out,8,630
16,11,2010,ATM Cash Withdrawal,General,20,610
17,11,2010,Caffe Nero,Eating Out,2,608
17,11,2010,McDonalds,Eating Out,6,602
18,11,2010,Costa Coffee,Eating Out,2,600
18,11,2010,Subway,Eating Out,8,592
18,11,2010,ATM Cash Withdrawal,General,20,572
19,11,2010,Tescos,Groceries,52,520
19,11,2010,Caffe Nero,Eating Out,2,518
19,11,2010,Restaurant Gordon RamsayPortland Restaurant,Eating Out,53,465
20,11,2010,VIRGIN MEDIA PYMTS,Bills,34,431
20,11,2010,Anglo restaurant,Eating Out,39,392
22,11,2010,South West Trains,Transport,38,354
22,11,2010,Caffe Nero,Eating Out,1,353
22,11,2010,ATM Cash Withdrawal,General,10,343
23,11,2010,Starbucks Coffee,Eating Out,1,342
23,11,2010,ATM Cash Withdrawal,General,10,332
24,11,2010,O2,Bills,35,297
24,11,2010,Costa Coffee,Eating Out,2,295
24,11,2010,Chicken Cottage,Eating Out,6,289
25,11,2010,ATM Cash Withdrawal,General,10,279
26,11,2010,Sainsburys,Groceries,74,205
26,11,2010,Caffe Nero,Eating Out,2,203
26,11,2010,Chicken Cottage,Eating Out,7,196
26,11,2010,Fabric Club,Eating Out,7,189
26,11,2010,Fabric Club,Eating Out,15,174
26,11,2010,Fabric Club,Eating Out,11,163
26,11,2010,Fabric Club,Eating Out,16,147
27,11,2010,Fabric Club,Eating Out,10,137
28,11,2010,Scott's Restaurant,Eating Out,43,94
28,11,2010,ATM Cash Withdrawal,General,10,84
29,11,2010,South West Trains,Transport,26,58
29,11,2010,Wild Bean Cafe,Eating Out,2,56
30,11,2010,Starbucks Coffee,Eating Out,2,54
30,11,2010,ATM Cash Withdrawal,General,20,34
1,12,2010,Rhino Sports salary,General,1700,1734
1,12,2010,Wild Bean Cafe,Eating Out,1,1733
2,12,2010,Chicken Cottage,Eating Out,5,1728
3,12,2010,Morrisons,Groceries,60,1668
3,12,2010,Wild Bean Cafe,Eating Out,2,1666
3,12,2010,Dominos Pizza,Eating Out,27,1639
3,12,2010,ATM Cash Withdrawal,General,10,1629
4,12,2010,Restaurant Gordon RamsayPortland Restaurant,Eating Out,50,1579
4,12,2010,ATM Cash Withdrawal,General,10,1569
6,12,2010,South West Trains,Transport,28,1541
6,12,2010,Wild Bean Cafe,Eating Out,2,1539
6,12,2010,Subway,Eating Out,5,1534
6,12,2010,ATM Cash Withdrawal,General,10,1524
7,12,2010,Cubit and West rent,Rent,550,974
7,12,2010,Costa Coffee,Eating Out,1,973
7,12,2010,McDonalds,Eating Out,7,966
7,12,2010,ATM Cash Withdrawal,General,10,956
8,12,2010,Starbucks Coffee,Eating Out,2,954
9,12,2010,Costa Coffee,Eating Out,1,953
9,12,2010,Greggs,Eating Out,8,945
10,12,2010,Waitrose,Groceries,50,895
10,12,2010,Costa Coffee,Eating Out,1,894
10,12,2010,Greggs,Eating Out,6,888
11,12,2010,Anglo restaurant,Eating Out,46,842
12,12,2010,Pizza Express,Eating Out,48,794
12,12,2010,ATM Cash Withdrawal,General,20,774
13,12,2010,South West Trains,Transport,36,738
13,12,2010,Costa Coffee,Eating Out,1,737
13,12,2010,McDonalds,Eating Out,7,730
14,12,2010,Wild Bean Cafe,Eating Out,2,728
14,12,2010,Subway,Eating Out,7,721
15,12,2010,BRGAS-Electricity,Bills,36,685
15,12,2010,BRGAS-Gas,Bills,31,654
15,12,2010,Starbucks Coffee,Eating Out,2,652
15,12,2010,Subway,Eating Out,6,646
16,12,2010,LBS Council Tax,Bills,50,596
16,12,2010,Starbucks Coffee,Eating Out,2,594
16,12,2010,Subway,Eating Out,6,588
17,12,2010,Tescos,Groceries,49,539
17,12,2010,Costa Coffee,Eating Out,1,538
18,12,2010,Scott's Restaurant,Eating Out,30,508
19,12,2010,Pizza Express,Eating Out,54,454
20,12,2010,VIRGIN MEDIA PYMTS,Bills,47,407
20,12,2010,South West Trains,Transport,28,379
20,12,2010,McDonalds,Eating Out,6,373
21,12,2010,Costa Coffee,Eating Out,2,371
21,12,2010,Greggs,Eating Out,5,366
22,12,2010,Wild Bean Cafe,Eating Out,2,364
22,12,2010,The West Cornwall Pasty Company,Eating Out,8,356
23,12,2010,Starbucks Coffee,Eating Out,1,355
23,12,2010,Subway,Eating Out,5,350
24,12,2010,O2,Bills,34,316
24,12,2010,Morrisons,Groceries,45,271
24,12,2010,Costa Coffee,Eating Out,2,269
24,12,2010,ATM Cash Withdrawal,General,20,249
25,12,2010,Ministry of Sound ClubXOYO Club,Eating Out,12,237
25,12,2010,Ministry of Sound ClubXOYO Club,Eating Out,13,224
25,12,2010,ATM Cash Withdrawal,General,10,214
27,12,2010,South West Trains,Transport,31,183
27,12,2010,Starbucks Coffee,Eating Out,1,182
27,12,2010,The West Cornwall Pasty Company,Eating Out,5,177
28,12,2010,Caffe Nero,Eating Out,2,175
28,12,2010,ATM Cash Withdrawal,General,10,165
29,12,2010,Starbucks Coffee,Eating Out,2,163
30,12,2010,Subway,Eating Out,6,157
30,12,2010,ATM Cash Withdrawal,General,10,147
31,12,2010,Sainsburys,Groceries,57,90
31,12,2010,Starbucks Coffee,Eating Out,2,88
31,12,2010,The West Cornwall Pasty Company,Eating Out,6,82
31,12,2010,Restaurant Gordon RamsayPortland Restaurant,Eating Out,58,24
1,1,2011,Rhino Sports salary,General,1700,1724
1,1,2011,ATM Cash Withdrawal,General,20,1704
2,1,2011,Pizza Express,Eating Out,34,1670
3,1,2011,South West Trains,Transport,34,1636
3,1,2011,Caffe Nero,Eating Out,2,1634
3,1,2011,The West Cornwall Pasty Company,Eating Out,8,1626
4,1,2011,Caffe Nero,Eating Out,2,1624
4,1,2011,Greggs,Eating Out,6,1618
5,1,2011,McDonalds,Eating Out,5,1613
6,1,2011,Wild Bean Cafe,Eating Out,2,1611
6,1,2011,The West Cornwall Pasty Company,Eating Out,7,1604
7,1,2011,Cubit and West rent,Rent,550,1054
7,1,2011,Tescos,Groceries,55,999
7,1,2011,Costa Coffee,Eating Out,2,997
7,1,2011,Heaven Club,Eating Out,16,981
7,1,2011,Heaven Club,Eating Out,15,966
7,1,2011,Heaven Club,Eating Out,7,959
7,1,2011,Heaven Club,Eating Out,13,946
9,1,2011,ATM Cash Withdrawal,General,10,936
10,1,2011,South West Trains,Transport,28,908
10,1,2011,Caffe Nero,Eating Out,2,906
10,1,2011,Chicken Cottage,Eating Out,5,901
11,1,2011,Caffe Nero,Eating Out,1,900
12,1,2011,Starbucks Coffee,Eating Out,1,899
12,1,2011,McDonalds,Eating Out,6,893
13,1,2011,Costa Coffee,Eating Out,2,891
13,1,2011,Greggs,Eating Out,7,884
14,1,2011,Waitrose,Groceries,71,813
14,1,2011,Starbucks Coffee,Eating Out,2,811
14,1,2011,McDonalds,Eating Out,5,806
14,1,2011,Anglo restaurant,Eating Out,24,782
15,1,2011,BRGAS-Electricity,Bills,57,725
15,1,2011,BRGAS-Gas,Bills,63,662
16,1,2011,LBS Council Tax,Bills,50,612
17,1,2011,South West Trains,Transport,35,577
17,1,2011,ATM Cash Withdrawal,General,20,557
19,1,2011,Wild Bean Cafe,Eating Out,1,556
19,1,2011,Greggs,Eating Out,8,548
20,1,2011,VIRGIN MEDIA PYMTS,Bills,29,519
20,1,2011,Starbucks Coffee,Eating Out,2,517
20,1,2011,Chicken Cottage,Eating Out,4,513
21,1,2011,Waitrose,Groceries,61,452
21,1,2011,Wild Bean Cafe,Eating Out,2,450
21,1,2011,Chicken Cottage,Eating Out,7,443
21,1,2011,Restaurant Gordon RamsayPortland Restaurant,Eating Out,33,410
21,1,2011,ATM Cash Withdrawal,General,10,400
22,1,2011,The Grand Pub,Eating Out,10,390
22,1,2011,The Grand Pub,Eating Out,13,377
22,1,2011,The Grand Pub,Eating Out,5,372
22,1,2011,The Grand Pub,Eating Out,11,361
22,1,2011,The Grand Pub,Eating Out,13,348
22,1,2011,The Grand Pub,Eating Out,8,340
22,1,2011,Scott's Restaurant,Eating Out,50,290
24,1,2011,O2,Bills,36,254
24,1,2011,South West Trains,Transport,26,228
24,1,2011,Starbucks Coffee,Eating Out,2,226
24,1,2011,Pret A Manger,Eating Out,5,221
26,1,2011,Pret A Manger,Eating Out,6,215
27,1,2011,Caffe Nero,Eating Out,1,214
27,1,2011,The West Cornwall Pasty Company,Eating Out,7,207
27,1,2011,ATM Cash Withdrawal,General,10,197
28,1,2011,Tescos,Groceries,58,139
28,1,2011,Starbucks Coffee,Eating Out,2,137
28,1,2011,Greggs,Eating Out,6,131
28,1,2011,Scott's Restaurant,Eating Out,30,101
29,1,2011,Restaurant Gordon RamsayPortland Restaurant,Eating Out,35,66
30,1,2011,ATM Cash Withdrawal,General,20,46
31,1,2011,South West Trains,Transport,35,11
31,1,2011,McDonalds,Eating Out,6,5
1,2,2011,Rhino Sports salary,General,1700,1705
1,2,2011,Wild Bean Cafe,Eating Out,1,1704
2,2,2011,Caffe Nero,Eating Out,2,1702
2,2,2011,ATM Cash Withdrawal,General,10,1692
3,2,2011,Caffe Nero,Eating Out,1,1691
3,2,2011,Chicken Cottage,Eating Out,5,1686
4,2,2011,Waitrose,Groceries,60,1626
4,2,2011,Wild Bean Cafe,Eating Out,2,1624
4,2,2011,Fabric Club,Eating Out,15,1609
4,2,2011,Fabric Club,Eating Out,12,1597
4,2,2011,Anglo restaurant,Eating Out,45,1552
4,2,2011,ATM Cash Withdrawal,General,20,1532
6,2,2011,ATM Cash Withdrawal,General,10,1522
7,2,2011,Cubit and West rent,Rent,550,972
7,2,2011,South West Trains,Transport,37,935
7,2,2011,Costa Coffee,Eating Out,2,933
8,2,2011,Starbucks Coffee,Eating Out,1,932
8,2,2011,Pret A Manger,Eating Out,8,924
9,2,2011,Costa Coffee,Eating Out,2,922
9,2,2011,ATM Cash Withdrawal,General,10,912
10,2,2011,ATM Cash Withdrawal,General,10,902
11,2,2011,Waitrose,Groceries,84,818
11,2,2011,Wild Bean Cafe,Eating Out,1,817
11,2,2011,Chicken Cottage,Eating Out,6,811
11,2,2011,Fabric Club,Eating Out,13,798
11,2,2011,Fabric Club,Eating Out,15,783
11,2,2011,Anglo restaurant,Eating Out,42,741
11,2,2011,ATM Cash Withdrawal,General,20,721
12,2,2011,The Grand Pub,Eating Out,13,708
12,2,2011,The Grand Pub,Eating Out,6,702
12,2,2011,The Grand Pub,Eating Out,11,691
12,2,2011,The Grand Pub,Eating Out,15,676
12,2,2011,The Grand Pub,Eating Out,12,664
12,2,2011,The Grand Pub,Eating Out,15,649
14,2,2011,South West Trains,Transport,24,625
14,2,2011,Starbucks Coffee,Eating Out,1,624
14,2,2011,Subway,Eating Out,4,620
14,2,2011,ATM Cash Withdrawal,General,10,610
15,2,2011,BRGAS-Electricity,Bills,38,572
15,2,2011,BRGAS-Gas,Bills,27,545
15,2,2011,Costa Coffee,Eating Out,2,543
15,2,2011,The West Cornwall Pasty Company,Eating Out,5,538
16,2,2011,LBS Council Tax,Bills,50,488
16,2,2011,Caffe Nero,Eating Out,2,486
17,2,2011,Starbucks Coffee,Eating Out,1,485
17,2,2011,Greggs,Eating Out,8,477
17,2,2011,ATM Cash Withdrawal,General,10,467
18,2,2011,Sainsburys,Groceries,58,409
18,2,2011,Greggs,Eating Out,5,404
20,2,2011,VIRGIN MEDIA PYMTS,Bills,41,363
20,2,2011,Scott's Restaurant,Eating Out,24,339
21,2,2011,South West Trains,Transport,36,303
21,2,2011,Costa Coffee,Eating Out,2,301
23,2,2011,Starbucks Coffee,Eating Out,2,299
23,2,2011,Pret A Manger,Eating Out,6,293
23,2,2011,ATM Cash Withdrawal,General,10,283
24,2,2011,O2,Bills,31,252
24,2,2011,Wild Bean Cafe,Eating Out,2,250
25,2,2011,Tescos,Groceries,70,180
25,2,2011,Starbucks Coffee,Eating Out,2,178
25,2,2011,McDonalds,Eating Out,6,172
25,2,2011,Anglo restaurant,Eating Out,29,143
26,2,2011,Pizza Express,Eating Out,34,109
26,2,2011,ATM Cash Withdrawal,General,20,89
28,2,2011,South West Trains,Transport,31,58
28,2,2011,Caffe Nero,Eating Out,1,57
1,3,2011,Rhino Sports salary,General,1700,1757
1,3,2011,ATM Cash Withdrawal,General,10,1747
2,3,2011,Starbucks Coffee,Eating Out,2,1745
3,3,2011,Costa Coffee,Eating Out,2,1743
4,3,2011,Sainsburys,Groceries,87,1656
4,3,2011,Wild Bean Cafe,Eating Out,2,1654
4,3,2011,Fabric Club,Eating Out,13,1641
4,3,2011,Fabric Club,Eating Out,9,1632
4,3,2011,Fabric Club,Eating Out,11,1621
4,3,2011,Fabric Club,Eating Out,5,1616
4,3,2011,Fabric Club,Eating Out,5,1611
4,3,2011,Pizza Express,Eating Out,47,1564
6,3,2011,ATM Cash Withdrawal,General,10,1554
7,3,2011,Cubit and West rent,Rent,550,1004
7,3,2011,South West Trains,Transport,33,971
8,3,2011,Wild Bean Cafe,Eating Out,1,970
8,3,2011,ATM Cash Withdrawal,General,10,960
9,3,2011,Subway,Eating Out,8,952
10,3,2011,Starbucks Coffee,Eating Out,2,950
10,3,2011,Chicken Cottage,Eating Out,7,943
11,3,2011,Tescos,Groceries,53,890
11,3,2011,Wild Bean Cafe,Eating Out,2,888
11,3,2011,Anglo restaurant,Eating Out,35,853
14,3,2011,South West Trains,Transport,32,821
14,3,2011,Wild Bean Cafe,Eating Out,2,819
14,3,2011,Subway,Eating Out,7,812
14,3,2011,ATM Cash Withdrawal,General,20,792
15,3,2011,BRGAS-Electricity,Bills,37,755
15,3,2011,BRGAS-Gas,Bills,36,719
15,3,2011,Starbucks Coffee,Eating Out,1,718
15,3,2011,ATM Cash Withdrawal,General,20,698
16,3,2011,LBS Council Tax,Bills,50,648
16,3,2011,Caffe Nero,Eating Out,2,646
17,3,2011,Costa Coffee,Eating Out,2,644
17,3,2011,Chicken Cottage,Eating Out,8,636
17,3,2011,ATM Cash Withdrawal,General,20,616
18,3,2011,Waitrose,Groceries,69,547
18,3,2011,Costa Coffee,Eating Out,2,545
20,3,2011,VIRGIN MEDIA PYMTS,Bills,59,486
20,3,2011,Dominos Pizza,Eating Out,58,428
20,3,2011,ATM Cash Withdrawal,General,10,418
21,3,2011,South West Trains,Transport,31,387
21,3,2011,Costa Coffee,Eating Out,2,385
23,3,2011,Starbucks Coffee,Eating Out,2,383
23,3,2011,McDonalds,Eating Out,7,376
24,3,2011,O2,Bills,34,342
24,3,2011,Wild Bean Cafe,Eating Out,1,341
24,3,2011,Chicken Cottage,Eating Out,4,337
25,3,2011,Tescos,Groceries,58,279
25,3,2011,Pret A Manger,Eating Out,8,271
25,3,2011,Pizza Express,Eating Out,51,220
26,3,2011,The Grand Pub,Eating Out,10,210
26,3,2011,The Grand Pub,Eating Out,5,205
26,3,2011,The Grand Pub,Eating Out,7,198
26,3,2011,The Grand Pub,Eating Out,15,183
26,3,2011,The Grand Pub,Eating Out,11,172
26,3,2011,The Grand Pub,Eating Out,7,165
26,3,2011,ATM Cash Withdrawal,General,10,155
28,3,2011,South West Trains,Transport,24,131
28,3,2011,Starbucks Coffee,Eating Out,2,129
28,3,2011,ATM Cash Withdrawal,General,20,109
29,3,2011,Caffe Nero,Eating Out,2,107
29,3,2011,Subway,Eating Out,6,101
30,3,2011,Costa Coffee,Eating Out,1,100
31,3,2011,Caffe Nero,Eating Out,2,98
31,3,2011,Greggs,Eating Out,4,94
1,4,2011,Rhino Sports salary,General,1700,1794
1,4,2011,Morrisons,Groceries,88,1706
1,4,2011,Subway,Eating Out,6,1700
2,4,2011,Restaurant Gordon RamsayPortland Restaurant,Eating Out,28,1672
4,4,2011,South West Trains,Transport,33,1639
4,4,2011,Starbucks Coffee,Eating Out,2,1637
4,4,2011,ATM Cash Withdrawal,General,10,1627
5,4,2011,Caffe Nero,Eating Out,1,1626
5,4,2011,Pret A Manger,Eating Out,4,1622
6,4,2011,Pret A Manger,Eating Out,8,1614
7,4,2011,Cubit and West rent,Rent,550,1064
7,4,2011,Costa Coffee,Eating Out,2,1062
7,4,2011,Greggs,Eating Out,6,1056
8,4,2011,Sainsburys,Groceries,88,968
8,4,2011,Costa Coffee,Eating Out,1,967
8,4,2011,Subway,Eating Out,6,961
8,4,2011,ATM Cash Withdrawal,General,20,941
10,4,2011,ATM Cash Withdrawal,General,20,921
11,4,2011,South West Trains,Transport,30,891
11,4,2011,Starbucks Coffee,Eating Out,1,890
12,4,2011,Wild Bean Cafe,Eating Out,2,888
12,4,2011,Pret A Manger,Eating Out,5,883
13,4,2011,Starbucks Coffee,Eating Out,2,881
13,4,2011,McDonalds,Eating Out,7,874
14,4,2011,Pret A Manger,Eating Out,5,869
14,4,2011,ATM Cash Withdrawal,General,10,859
15,4,2011,BRGAS-Electricity,Bills,41,818
15,4,2011,BRGAS-Gas,Bills,25,793
15,4,2011,Sainsburys,Groceries,82,711
15,4,2011,Wild Bean Cafe,Eating Out,2,709
16,4,2011,LBS Council Tax,Bills,50,659
17,4,2011,ATM Cash Withdrawal,General,10,649
18,4,2011,South West Trains,Transport,25,624
18,4,2011,Wild Bean Cafe,Eating Out,1,623
18,4,2011,Greggs,Eating Out,4,619
19,4,2011,Caffe Nero,Eating Out,1,618
19,4,2011,McDonalds,Eating Out,7,611
19,4,2011,ATM Cash Withdrawal,General,20,591
20,4,2011,VIRGIN MEDIA PYMTS,Bills,50,541
20,4,2011,Caffe Nero,Eating Out,2,539
20,4,2011,McDonalds,Eating Out,5,534
21,4,2011,Costa Coffee,Eating Out,2,532
21,4,2011,Greggs,Eating Out,8,524
21,4,2011,ATM Cash Withdrawal,General,20,504
22,4,2011,ASDA,Groceries,87,417
22,4,2011,Costa Coffee,Eating Out,1,416
22,4,2011,McDonalds,Eating Out,6,410
23,4,2011,Scott's Restaurant,Eating Out,39,371
23,4,2011,ATM Cash Withdrawal,General,20,351
24,4,2011,O2,Bills,32,319
25,4,2011,South West Trains,Transport,30,289
25,4,2011,Costa Coffee,Eating Out,2,287
26,4,2011,Starbucks Coffee,Eating Out,2,285
27,4,2011,Costa Coffee,Eating Out,2,283
28,4,2011,Caffe Nero,Eating Out,2,281
28,4,2011,Chicken Cottage,Eating Out,5,276
28,4,2011,ATM Cash Withdrawal,General,10,266
29,4,2011,ASDA,Groceries,84,182
29,4,2011,Subway,Eating Out,8,174
29,4,2011,ATM Cash Withdrawal,General,10,164
1,5,2011,Rhino Sports salary,General,1700,1864
1,5,2011,ATM Cash Withdrawal,General,20,1844
2,5,2011,South West Trains,Transport,28,1816
2,5,2011,Costa Coffee,Eating Out,2,1814
3,5,2011,Chicken Cottage,Eating Out,8,1806
4,5,2011,The West Cornwall Pasty Company,Eating Out,4,1802
4,5,2011,ATM Cash Withdrawal,General,20,1782
5,5,2011,Wild Bean Cafe,Eating Out,2,1780
5,5,2011,Subway,Eating Out,4,1776
6,5,2011,Sainsburys,Groceries,42,1734
6,5,2011,Caffe Nero,Eating Out,2,1732
6,5,2011,Subway,Eating Out,7,1725
6,5,2011,ATM Cash Withdrawal,General,10,1715
7,5,2011,Cubit and West rent,Rent,550,1165
8,5,2011,ATM Cash Withdrawal,General,20,1145
9,5,2011,South West Trains,Transport,29,1116
9,5,2011,Starbucks Coffee,Eating Out,2,1114
9,5,2011,Chicken Cottage,Eating Out,5,1109
10,5,2011,Wild Bean Cafe,Eating Out,2,1107
10,5,2011,Chicken Cottage,Eating Out,6,1101
11,5,2011,Starbucks Coffee,Eating Out,2,1099
11,5,2011,ATM Cash Withdrawal,General,10,1089
12,5,2011,Caffe Nero,Eating Out,1,1088
12,5,2011,Subway,Eating Out,6,1082
12,5,2011,ATM Cash Withdrawal,General,10,1072
13,5,2011,Waitrose,Groceries,81,991
13,5,2011,Costa Coffee,Eating Out,2,989
13,5,2011,Heaven Club,Eating Out,8,981
13,5,2011,Heaven Club,Eating Out,9,972
13,5,2011,Heaven Club,Eating Out,12,960
13,5,2011,Heaven Club,Eating Out,13,947
15,5,2011,BRGAS-Electricity,Bills,30,917
15,5,2011,BRGAS-Gas,Bills,30,887
15,5,2011,Dominos Pizza,Eating Out,38,849
16,5,2011,LBS Council Tax,Bills,50,799
16,5,2011,South West Trains,Transport,31,768
16,5,2011,Caffe Nero,Eating Out,2,766
16,5,2011,Chicken Cottage,Eating Out,5,761
16,5,2011,ATM Cash Withdrawal,General,20,741
17,5,2011,McDonalds,Eating Out,7,734
18,5,2011,Subway,Eating Out,6,728
20,5,2011,VIRGIN MEDIA PYMTS,Bills,53,675
20,5,2011,Tescos,Groceries,72,603
20,5,2011,Costa Coffee,Eating Out,1,602
20,5,2011,ATM Cash Withdrawal,General,20,582
21,5,2011,Pizza Express,Eating Out,29,553
23,5,2011,South West Trains,Transport,35,518
23,5,2011,Wild Bean Cafe,Eating Out,2,516
24,5,2011,O2,Bills,30,486
24,5,2011,Wild Bean Cafe,Eating Out,1,485
24,5,2011,McDonalds,Eating Out,4,481
25,5,2011,Starbucks Coffee,Eating Out,2,479
25,5,2011,Greggs,Eating Out,6,473
26,5,2011,Caffe Nero,Eating Out,2,471
26,5,2011,Chicken Cottage,Eating Out,8,463
26,5,2011,ATM Cash Withdrawal,General,20,443
27,5,2011,Sainsburys,Groceries,65,378
27,5,2011,Costa Coffee,Eating Out,2,376
27,5,2011,The West Cornwall Pasty Company,Eating Out,4,372
28,5,2011,Heaven Club,Eating Out,16,356
28,5,2011,Heaven Club,Eating Out,14,342
28,5,2011,Heaven Club,Eating Out,7,335
28,5,2011,Heaven Club,Eating Out,9,326
28,5,2011,Heaven Club,Eating Out,16,310
28,5,2011,Heaven Club,Eating Out,9,301
28,5,2011,Dominos Pizza,Eating Out,58,243
29,5,2011,ATM Cash Withdrawal,General,10,233
30,5,2011,South West Trains,Transport,35,198
30,5,2011,Wild Bean Cafe,Eating Out,1,197
31,5,2011,Costa Coffee,Eating Out,1,196
1,6,2011,Rhino Sports salary,General,1700,1896
1,6,2011,Pret A Manger,Eating Out,5,1891
2,6,2011,Starbucks Coffee,Eating Out,2,1889
3,6,2011,Tescos,Groceries,46,1843
3,6,2011,Chicken Cottage,Eating Out,4,1839
3,6,2011,Fabric Club,Eating Out,6,1833
3,6,2011,Fabric Club,Eating Out,15,1818
3,6,2011,Fabric Club,Eating Out,11,1807
3,6,2011,Fabric Club,Eating Out,10,1797
3,6,2011,Fabric Club,Eating Out,8,1789
3,6,2011,Fabric Club,Eating Out,9,1780
4,6,2011,ATM Cash Withdrawal,General,20,1760
5,6,2011,Dominos Pizza,Eating Out,29,1731
6,6,2011,South West Trains,Transport,31,1700
6,6,2011,Caffe Nero,Eating Out,2,1698
7,6,2011,Cubit and West rent,Rent,550,1148
7,6,2011,Caffe Nero,Eating Out,2,1146
7,6,2011,Greggs,Eating Out,8,1138
8,6,2011,Wild Bean Cafe,Eating Out,2,1136
8,6,2011,Subway,Eating Out,5,1131
9,6,2011,Starbucks Coffee,Eating Out,2,1129
9,6,2011,Pret A Manger,Eating Out,8,1121
10,6,2011,Morrisons,Groceries,50,1071
10,6,2011,Costa Coffee,Eating Out,2,1069
10,6,2011,ATM Cash Withdrawal,General,10,1059
11,6,2011,The Grand Pub,Eating Out,14,1045
11,6,2011,The Grand Pub,Eating Out,9,1036
11,6,2011,The Grand Pub,Eating Out,9,1027
11,6,2011,The Grand Pub,Eating Out,5,1022
11,6,2011,The Grand Pub,Eating Out,13,1009
13,6,2011,South West Trains,Transport,25,984
14,6,2011,Caffe Nero,Eating Out,2,982
14,6,2011,Pret A Manger,Eating Out,8,974
15,6,2011,BRGAS-Electricity,Bills,41,933
15,6,2011,BRGAS-Gas,Bills,35,898
15,6,2011,Starbucks Coffee,Eating Out,2,896
15,6,2011,ATM Cash Withdrawal,General,20,876
16,6,2011,LBS Council Tax,Bills,50,826
16,6,2011,Starbucks Coffee,Eating Out,2,824
16,6,2011,Greggs,Eating Out,8,816
17,6,2011,Morrisons,Groceries,74,742
17,6,2011,Wild Bean Cafe,Eating Out,2,740
17,6,2011,Pret A Manger,Eating Out,7,733
17,6,2011,Dominos Pizza,Eating Out,25,708
17,6,2011,ATM Cash Withdrawal,General,20,688
18,6,2011,Ministry of Sound ClubXOYO Club,Eating Out,7,681
18,6,2011,Ministry of Sound ClubXOYO Club,Eating Out,13,668
18,6,2011,Ministry of Sound ClubXOYO Club,Eating Out,10,658
18,6,2011,Ministry of Sound ClubXOYO Club,Eating Out,5,653
18,6,2011,Ministry of Sound ClubXOYO Club,Eating Out,16,637
18,6,2011,Ministry of Sound ClubXOYO Club,Eating Out,8,629
19,6,2011,ATM Cash Withdrawal,General,10,619
20,6,2011,VIRGIN MEDIA PYMTS,Bills,56,563
20,6,2011,South West Trains,Transport,36,527
20,6,2011,Starbucks Coffee,Eating Out,1,526
20,6,2011,The West Cornwall Pasty Company,Eating Out,7,519
21,6,2011,Chicken Cottage,Eating Out,7,512
22,6,2011,Wild Bean Cafe,Eating Out,2,510
22,6,2011,McDonalds,Eating Out,6,504
23,6,2011,Costa Coffee,Eating Out,2,502
24,6,2011,O2,Bills,31,471
24,6,2011,Waitrose,Groceries,63,408
24,6,2011,Wild Bean Cafe,Eating Out,2,406
24,6,2011,McDonalds,Eating Out,8,398
24,6,2011,Dominos Pizza,Eating Out,34,364
25,6,2011,Anglo restaurant,Eating Out,31,333
26,6,2011,ATM Cash Withdrawal,General,10,323
27,6,2011,South West Trains,Transport,25,298
27,6,2011,Chicken Cottage,Eating Out,5,293
27,6,2011,ATM Cash Withdrawal,General,10,283
28,6,2011,Wild Bean Cafe,Eating Out,2,281
28,6,2011,McDonalds,Eating Out,8,273
29,6,2011,Chicken Cottage,Eating Out,8,265
30,6,2011,Costa Coffee,Eating Out,2,263
30,6,2011,ATM Cash Withdrawal,General,20,243
1,7,2011,Rhino Sports salary,General,1700,1943
1,7,2011,Waitrose,Groceries,69,1874
1,7,2011,The West Cornwall Pasty Company,Eating Out,8,1866
2,7,2011,Pizza Express,Eating Out,50,1816
3,7,2011,ATM Cash Withdrawal,General,10,1806
4,7,2011,South West Trains,Transport,35,1771
4,7,2011,Starbucks Coffee,Eating Out,1,1770
4,7,2011,The West Cornwall Pasty Company,Eating Out,5,1765
5,7,2011,Caffe Nero,Eating Out,1,1764
5,7,2011,Pret A Manger,Eating Out,5,1759
6,7,2011,Caffe Nero,Eating Out,2,1757
6,7,2011,ATM Cash Withdrawal,General,10,1747
7,7,2011,Cubit and West rent,Rent,550,1197
7,7,2011,Caffe Nero,Eating Out,1,1196
8,7,2011,Morrisons,Groceries,73,1123
8,7,2011,Starbucks Coffee,Eating Out,2,1121
8,7,2011,Chicken Cottage,Eating Out,4,1117
8,7,2011,Pizza Express,Eating Out,43,1074
9,7,2011,Heaven Club,Eating Out,6,1068
9,7,2011,Heaven Club,Eating Out,11,1057
11,7,2011,South West Trains,Transport,25,1032
11,7,2011,Starbucks Coffee,Eating Out,2,1030
11,7,2011,Subway,Eating Out,7,1023
12,7,2011,Caffe Nero,Eating Out,1,1022
12,7,2011,McDonalds,Eating Out,7,1015
13,7,2011,Costa Coffee,Eating Out,2,1013
13,7,2011,Chicken Cottage,Eating Out,7,1006
13,7,2011,ATM Cash Withdrawal,General,20,986
14,7,2011,Starbucks Coffee,Eating Out,2,984
14,7,2011,Subway,Eating Out,5,979
14,7,2011,ATM Cash Withdrawal,General,20,959
15,7,2011,BRGAS-Electricity,Bills,31,928
15,7,2011,BRGAS-Gas,Bills,38,890
15,7,2011,Waitrose,Groceries,45,845
15,7,2011,Costa Coffee,Eating Out,1,844
15,7,2011,The Grand Pub,Eating Out,11,833
16,7,2011,LBS Council Tax,Bills,50,783
16,7,2011,Anglo restaurant,Eating Out,27,756
18,7,2011,South West Trains,Transport,35,721
18,7,2011,Costa Coffee,Eating Out,2,719
18,7,2011,Subway,Eating Out,5,714
18,7,2011,ATM Cash Withdrawal,General,10,704
19,7,2011,Costa Coffee,Eating Out,1,703
19,7,2011,Greggs,Eating Out,4,699
20,7,2011,VIRGIN MEDIA PYMTS,Bills,46,653
20,7,2011,Wild Bean Cafe,Eating Out,2,651
20,7,2011,Greggs,Eating Out,7,644
20,7,2011,ATM Cash Withdrawal,General,20,624
21,7,2011,Subway,Eating Out,8,616
22,7,2011,Waitrose,Groceries,73,543
22,7,2011,ATM Cash Withdrawal,General,20,523
23,7,2011,The Grand Pub,Eating Out,14,509
23,7,2011,The Grand Pub,Eating Out,16,493
23,7,2011,The Grand Pub,Eating Out,14,479
23,7,2011,The Grand Pub,Eating Out,7,472
23,7,2011,The Grand Pub,Eating Out,15,457
24,7,2011,O2,Bills,31,426
25,7,2011,South West Trains,Transport,32,394
25,7,2011,Chicken Cottage,Eating Out,5,389
25,7,2011,ATM Cash Withdrawal,General,20,369
26,7,2011,Caffe Nero,Eating Out,2,367
26,7,2011,The West Cornwall Pasty Company,Eating Out,4,363
27,7,2011,Starbucks Coffee,Eating Out,2,361
27,7,2011,Subway,Eating Out,6,355
28,7,2011,Costa Coffee,Eating Out,2,353
28,7,2011,McDonalds,Eating Out,7,346
28,7,2011,ATM Cash Withdrawal,General,10,336
29,7,2011,Morrisons,Groceries,78,258
29,7,2011,Starbucks Coffee,Eating Out,2,256
29,7,2011,Pret A Manger,Eating Out,4,252
29,7,2011,Heaven Club,Eating Out,7,245
29,7,2011,Heaven Club,Eating Out,8,237
29,7,2011,Heaven Club,Eating Out,11,226
29,7,2011,Heaven Club,Eating Out,10,216
29,7,2011,Heaven Club,Eating Out,13,203
29,7,2011,Heaven Club,Eating Out,12,191
29,7,2011,Anglo restaurant,Eating Out,34,157
30,7,2011,Scott's Restaurant,Eating Out,36,121
1,8,2011,Rhino Sports salary,General,1700,1821
1,8,2011,South West Trains,Transport,34,1787
1,8,2011,Wild Bean Cafe,Eating Out,2,1785
1,8,2011,Pret A Manger,Eating Out,5,1780
1,8,2011,ATM Cash Withdrawal,General,20,1760
2,8,2011,Starbucks Coffee,Eating Out,2,1758
2,8,2011,Chicken Cottage,Eating Out,7,1751
3,8,2011,Caffe Nero,Eating Out,2,1749
3,8,2011,The West Cornwall Pasty Company,Eating Out,4,1745
4,8,2011,Starbucks Coffee,Eating Out,2,1743
4,8,2011,Chicken Cottage,Eating Out,6,1737
5,8,2011,ASDA,Groceries,58,1679
5,8,2011,Costa Coffee,Eating Out,2,1677
5,8,2011,The West Cornwall Pasty Company,Eating Out,5,1672
7,8,2011,Cubit and West rent,Rent,550,1122
7,8,2011,Dominos Pizza,Eating Out,56,1066
8,8,2011,South West Trains,Transport,36,1030
8,8,2011,Wild Bean Cafe,Eating Out,2,1028
8,8,2011,Subway,Eating Out,4,1024
9,8,2011,Costa Coffee,Eating Out,2,1022
9,8,2011,ATM Cash Withdrawal,General,10,1012
10,8,2011,Costa Coffee,Eating Out,1,1011
11,8,2011,McDonalds,Eating Out,8,1003
12,8,2011,Morrisons,Groceries,46,957
12,8,2011,Pret A Manger,Eating Out,8,949
12,8,2011,Fabric Club,Eating Out,9,940
12,8,2011,Fabric Club,Eating Out,8,932
12,8,2011,Fabric Club,Eating Out,15,917
12,8,2011,Fabric Club,Eating Out,11,906
12,8,2011,Dominos Pizza,Eating Out,26,880
14,8,2011,Anglo restaurant,Eating Out,44,836
14,8,2011,ATM Cash Withdrawal,General,10,826
15,8,2011,BRGAS-Electricity,Bills,40,786
15,8,2011,BRGAS-Gas,Bills,38,748
15,8,2011,South West Trains,Transport,24,724
15,8,2011,Starbucks Coffee,Eating Out,1,723
15,8,2011,McDonalds,Eating Out,5,718
16,8,2011,LBS Council Tax,Bills,50,668
16,8,2011,Starbucks Coffee,Eating Out,2,666
17,8,2011,Starbucks Coffee,Eating Out,2,664
17,8,2011,Pret A Manger,Eating Out,7,657
18,8,2011,Caffe Nero,Eating Out,1,656
19,8,2011,ASDA,Groceries,63,593
19,8,2011,Starbucks Coffee,Eating Out,1,592
19,8,2011,Chicken Cottage,Eating Out,5,587
20,8,2011,VIRGIN MEDIA PYMTS,Bills,32,555
21,8,2011,Restaurant Gordon RamsayPortland Restaurant,Eating Out,47,508
22,8,2011,South West Trains,Transport,37,471
22,8,2011,ATM Cash Withdrawal,General,20,451
23,8,2011,Costa Coffee,Eating Out,2,449
23,8,2011,Chicken Cottage,Eating Out,5,444
24,8,2011,O2,Bills,33,411
24,8,2011,Pret A Manger,Eating Out,7,404
25,8,2011,Costa Coffee,Eating Out,2,402
25,8,2011,Pret A Manger,Eating Out,5,397
25,8,2011,ATM Cash Withdrawal,General,20,377
26,8,2011,ASDA,Groceries,67,310
26,8,2011,Caffe Nero,Eating Out,2,308
26,8,2011,Restaurant Gordon RamsayPortland Restaurant,Eating Out,48,260
26,8,2011,ATM Cash Withdrawal,General,10,250
27,8,2011,The Grand Pub,Eating Out,12,238
27,8,2011,The Grand Pub,Eating Out,12,226
27,8,2011,The Grand Pub,Eating Out,14,212
27,8,2011,The Grand Pub,Eating Out,13,199
27,8,2011,The Grand Pub,Eating Out,9,190
27,8,2011,The Grand Pub,Eating Out,10,180
27,8,2011,Pizza Express,Eating Out,39,141
29,8,2011,South West Trains,Transport,33,108
29,8,2011,Costa Coffee,Eating Out,1,107
30,8,2011,Wild Bean Cafe,Eating Out,1,106
30,8,2011,Subway,Eating Out,5,101
31,8,2011,Wild Bean Cafe,Eating Out,2,99
31,8,2011,Greggs,Eating Out,4,95
1,9,2011,Rhino Sports salary,General,1700,1795
1,9,2011,Caffe Nero,Eating Out,1,1794
1,9,2011,Chicken Cottage,Eating Out,5,1789
2,9,2011,Tescos,Groceries,70,1719
2,9,2011,Starbucks Coffee,Eating Out,2,1717
2,9,2011,Pizza Express,Eating Out,50,1667
5,9,2011,South West Trains,Transport,30,1637
5,9,2011,Starbucks Coffee,Eating Out,2,1635
5,9,2011,McDonalds,Eating Out,6,1629
6,9,2011,Starbucks Coffee,Eating Out,2,1627
7,9,2011,Cubit and West rent,Rent,550,1077
7,9,2011,Wild Bean Cafe,Eating Out,2,1075
8,9,2011,Starbucks Coffee,Eating Out,1,1074
8,9,2011,Pret A Manger,Eating Out,7,1067
9,9,2011,ASDA,Groceries,63,1004
9,9,2011,Chicken Cottage,Eating Out,7,997
9,9,2011,Restaurant Gordon RamsayPortland Restaurant,Eating Out,30,967
10,9,2011,Ministry of Sound ClubXOYO Club,Eating Out,7,960
10,9,2011,Ministry of Sound ClubXOYO Club,Eating Out,13,947
10,9,2011,Ministry of Sound ClubXOYO Club,Eating Out,11,936
10,9,2011,Ministry of Sound ClubXOYO Club,Eating Out,12,924
10,9,2011,Ministry of Sound ClubXOYO Club,Eating Out,5,919
11,9,2011,Restaurant Gordon RamsayPortland Restaurant,Eating Out,27,892
12,9,2011,South West Trains,Transport,31,861
12,9,2011,Subway,Eating Out,6,855
13,9,2011,Wild Bean Cafe,Eating Out,1,854
13,9,2011,Pret A Manger,Eating Out,8,846
14,9,2011,Costa Coffee,Eating Out,2,844
14,9,2011,ATM Cash Withdrawal,General,20,824
15,9,2011,BRGAS-Electricity,Bills,33,791
15,9,2011,BRGAS-Gas,Bills,22,769
15,9,2011,Chicken Cottage,Eating Out,8,761
16,9,2011,LBS Council Tax,Bills,50,711
16,9,2011,Tescos,Groceries,72,639
16,9,2011,Anglo restaurant,Eating Out,39,600
17,9,2011,ATM Cash Withdrawal,General,20,580
19,9,2011,South West Trains,Transport,32,548
19,9,2011,ATM Cash Withdrawal,General,20,528
20,9,2011,VIRGIN MEDIA PYMTS,Bills,31,497
21,9,2011,Wild Bean Cafe,Eating Out,1,496
21,9,2011,ATM Cash Withdrawal,General,10,486
22,9,2011,Pret A Manger,Eating Out,7,479
23,9,2011,ASDA,Groceries,56,423
23,9,2011,Caffe Nero,Eating Out,2,421
23,9,2011,Pret A Manger,Eating Out,5,416
23,9,2011,Heaven Club,Eating Out,7,409
23,9,2011,Heaven Club,Eating Out,6,403
23,9,2011,Heaven Club,Eating Out,12,391
23,9,2011,Heaven Club,Eating Out,12,379
23,9,2011,Anglo restaurant,Eating Out,31,348
24,9,2011,O2,Bills,37,311
26,9,2011,South West Trains,Transport,27,284
26,9,2011,Wild Bean Cafe,Eating Out,1,283
26,9,2011,Subway,Eating Out,5,278
26,9,2011,ATM Cash Withdrawal,General,20,258
27,9,2011,Caffe Nero,Eating Out,1,257
27,9,2011,The West Cornwall Pasty Company,Eating Out,6,251
28,9,2011,Costa Coffee,Eating Out,2,249
29,9,2011,Greggs,Eating Out,5,244
30,9,2011,Waitrose,Groceries,59,185
30,9,2011,The West Cornwall Pasty Company,Eating Out,6,179
30,9,2011,Restaurant Gordon RamsayPortland Restaurant,Eating Out,36,143
30,9,2011,ATM Cash Withdrawal,General,10,133
1,10,2011,Rhino Sports salary,General,1700,1833
3,10,2011,South West Trains,Transport,36,1797
4,10,2011,Starbucks Coffee,Eating Out,1,1796
4,10,2011,The West Cornwall Pasty Company,Eating Out,7,1789
5,10,2011,Costa Coffee,Eating Out,2,1787
5,10,2011,Subway,Eating Out,7,1780
5,10,2011,ATM Cash Withdrawal,General,10,1770
6,10,2011,Costa Coffee,Eating Out,1,1769
7,10,2011,Cubit and West rent,Rent,550,1219
7,10,2011,ASDA,Groceries,68,1151
7,10,2011,Wild Bean Cafe,Eating Out,1,1150
7,10,2011,McDonalds,Eating Out,8,1142
7,10,2011,Dominos Pizza,Eating Out,42,1100
7,10,2011,ATM Cash Withdrawal,General,20,1080
9,10,2011,Restaurant Gordon RamsayPortland Restaurant,Eating Out,25,1055
10,10,2011,South West Trains,Transport,35,1020
10,10,2011,Wild Bean Cafe,Eating Out,2,1018
10,10,2011,McDonalds,Eating Out,7,1011
11,10,2011,Costa Coffee,Eating Out,2,1009
12,10,2011,Starbucks Coffee,Eating Out,2,1007
12,10,2011,McDonalds,Eating Out,5,1002
12,10,2011,ATM Cash Withdrawal,General,10,992
13,10,2011,Pret A Manger,Eating Out,5,987
14,10,2011,Sainsburys,Groceries,68,919
14,10,2011,ATM Cash Withdrawal,General,10,909
15,10,2011,BRGAS-Electricity,Bills,26,883
15,10,2011,BRGAS-Gas,Bills,42,841
16,10,2011,LBS Council Tax,Bills,50,791
16,10,2011,ATM Cash Withdrawal,General,20,771
17,10,2011,South West Trains,Transport,30,741
17,10,2011,Costa Coffee,Eating Out,2,739
18,10,2011,Costa Coffee,Eating Out,2,737
18,10,2011,Chicken Cottage,Eating Out,6,731
18,10,2011,ATM Cash Withdrawal,General,10,721
19,10,2011,Starbucks Coffee,Eating Out,2,719
20,10,2011,VIRGIN MEDIA PYMTS,Bills,49,670
20,10,2011,Subway,Eating Out,8,662
21,10,2011,Tescos,Groceries,55,607
21,10,2011,Starbucks Coffee,Eating Out,2,605
21,10,2011,Chicken Cottage,Eating Out,5,600
21,10,2011,Pizza Express,Eating Out,42,558
23,10,2011,ATM Cash Withdrawal,General,20,538
24,10,2011,O2,Bills,31,507
24,10,2011,South West Trains,Transport,32,475
24,10,2011,Costa Coffee,Eating Out,2,473
25,10,2011,Wild Bean Cafe,Eating Out,2,471
25,10,2011,The West Cornwall Pasty Company,Eating Out,7,464
26,10,2011,Costa Coffee,Eating Out,2,462
26,10,2011,Pret A Manger,Eating Out,7,455
27,10,2011,Caffe Nero,Eating Out,2,453
27,10,2011,McDonalds,Eating Out,7,446
28,10,2011,Sainsburys,Groceries,61,385
28,10,2011,Subway,Eating Out,7,378
28,10,2011,The Grand Pub,Eating Out,5,373
28,10,2011,The Grand Pub,Eating Out,12,361
29,10,2011,Fabric Club,Eating Out,5,356
29,10,2011,Fabric Club,Eating Out,8,348
29,10,2011,Fabric Club,Eating Out,6,342
29,10,2011,Fabric Club,Eating Out,16,326
29,10,2011,ATM Cash Withdrawal,General,20,306
30,10,2011,ATM Cash Withdrawal,General,20,286
31,10,2011,South West Trains,Transport,28,258
31,10,2011,Caffe Nero,Eating Out,2,256
31,10,2011,Chicken Cottage,Eating Out,8,248
1,11,2011,Rhino Sports salary,General,1700,1948
2,11,2011,Costa Coffee,Eating Out,2,1946
2,11,2011,Pret A Manger,Eating Out,8,1938
2,11,2011,ATM Cash Withdrawal,General,10,1928
3,11,2011,Starbucks Coffee,Eating Out,1,1927
4,11,2011,Morrisons,Groceries,73,1854
4,11,2011,Wild Bean Cafe,Eating Out,1,1853
4,11,2011,Subway,Eating Out,6,1847
5,11,2011,Pizza Express,Eating Out,56,1791
7,11,2011,Cubit and West rent,Rent,550,1241
7,11,2011,South West Trains,Transport,38,1203
7,11,2011,Subway,Eating Out,6,1197
8,11,2011,Caffe Nero,Eating Out,2,1195
9,11,2011,Pret A Manger,Eating Out,8,1187
10,11,2011,Caffe Nero,Eating Out,2,1185
11,11,2011,Sainsburys,Groceries,47,1138
11,11,2011,Greggs,Eating Out,4,1134
11,11,2011,Anglo restaurant,Eating Out,50,1084
12,11,2011,Fabric Club,Eating Out,13,1071
12,11,2011,Fabric Club,Eating Out,10,1061
12,11,2011,Fabric Club,Eating Out,6,1055
12,11,2011,Fabric Club,Eating Out,8,1047
12,11,2011,ATM Cash Withdrawal,General,10,1037
13,11,2011,ATM Cash Withdrawal,General,20,1017
14,11,2011,South West Trains,Transport,33,984
14,11,2011,Costa Coffee,Eating Out,2,982
15,11,2011,BRGAS-Electricity,Bills,45,937
15,11,2011,BRGAS-Gas,Bills,45,892
15,11,2011,Starbucks Coffee,Eating Out,2,890
15,11,2011,ATM Cash Withdrawal,General,20,870
16,11,2011,LBS Council Tax,Bills,50,820
16,11,2011,Wild Bean Cafe,Eating Out,1,819
17,11,2011,Wild Bean Cafe,Eating Out,2,817
17,11,2011,Greggs,Eating Out,5,812
17,11,2011,ATM Cash Withdrawal,General,20,792
18,11,2011,Sainsburys,Groceries,89,703
18,11,2011,Starbucks Coffee,Eating Out,2,701
18,11,2011,Greggs,Eating Out,6,695
19,11,2011,Anglo restaurant,Eating Out,55,640
20,11,2011,VIRGIN MEDIA PYMTS,Bills,48,592
21,11,2011,South West Trains,Transport,30,562
21,11,2011,Caffe Nero,Eating Out,1,561
22,11,2011,Caffe Nero,Eating Out,2,559
22,11,2011,The West Cornwall Pasty Company,Eating Out,7,552
23,11,2011,Costa Coffee,Eating Out,2,550
23,11,2011,The West Cornwall Pasty Company,Eating Out,4,546
24,11,2011,O2,Bills,37,509
24,11,2011,Caffe Nero,Eating Out,2,507
24,11,2011,The West Cornwall Pasty Company,Eating Out,7,500
24,11,2011,ATM Cash Withdrawal,General,10,490
25,11,2011,Morrisons,Groceries,58,432
25,11,2011,Caffe Nero,Eating Out,2,430
25,11,2011,Pizza Express,Eating Out,29,401
26,11,2011,ATM Cash Withdrawal,General,10,391
27,11,2011,ATM Cash Withdrawal,General,20,371
28,11,2011,South West Trains,Transport,29,342
28,11,2011,Costa Coffee,Eating Out,1,341
28,11,2011,Chicken Cottage,Eating Out,6,335
29,11,2011,Costa Coffee,Eating Out,1,334
29,11,2011,Chicken Cottage,Eating Out,5,329
29,11,2011,ATM Cash Withdrawal,General,20,309
30,11,2011,Starbucks Coffee,Eating Out,2,307
30,11,2011,Pret A Manger,Eating Out,7,300
1,12,2011,Rhino Sports salary,General,1700,2000
1,12,2011,Costa Coffee,Eating Out,2,1998
1,12,2011,ATM Cash Withdrawal,General,20,1978
2,12,2011,Sainsburys,Groceries,60,1918
2,12,2011,Caffe Nero,Eating Out,2,1916
3,12,2011,Ministry of Sound ClubXOYO Club,Eating Out,14,1902
3,12,2011,Ministry of Sound ClubXOYO Club,Eating Out,6,1896
3,12,2011,ATM Cash Withdrawal,General,10,1886
4,12,2011,Anglo restaurant,Eating Out,40,1846
4,12,2011,ATM Cash Withdrawal,General,20,1826
5,12,2011,South West Trains,Transport,24,1802
5,12,2011,Costa Coffee,Eating Out,1,1801
5,12,2011,The West Cornwall Pasty Company,Eating Out,7,1794
6,12,2011,Caffe Nero,Eating Out,1,1793
7,12,2011,Cubit and West rent,Rent,550,1243
7,12,2011,Starbucks Coffee,Eating Out,1,1242
7,12,2011,The West Cornwall Pasty Company,Eating Out,6,1236
7,12,2011,ATM Cash Withdrawal,General,10,1226
8,12,2011,Starbucks Coffee,Eating Out,2,1224
8,12,2011,The West Cornwall Pasty Company,Eating Out,4,1220
9,12,2011,ASDA,Groceries,87,1133
9,12,2011,Starbucks Coffee,Eating Out,2,1131
9,12,2011,Dominos Pizza,Eating Out,52,1079
9,12,2011,ATM Cash Withdrawal,General,10,1069
11,12,2011,Anglo restaurant,Eating Out,43,1026
12,12,2011,South West Trains,Transport,25,1001
14,12,2011,Starbucks Coffee,Eating Out,1,1000
14,12,2011,Pret A Manger,Eating Out,8,992
15,12,2011,BRGAS-Electricity,Bills,34,958
15,12,2011,BRGAS-Gas,Bills,43,915
15,12,2011,Costa Coffee,Eating Out,2,913
15,12,2011,Greggs,Eating Out,4,909
16,12,2011,LBS Council Tax,Bills,50,859
16,12,2011,Tescos,Groceries,54,805
16,12,2011,Dominos Pizza,Eating Out,59,746
17,12,2011,Ministry of Sound ClubXOYO Club,Eating Out,12,734
17,12,2011,Ministry of Sound ClubXOYO Club,Eating Out,9,725
17,12,2011,Ministry of Sound ClubXOYO Club,Eating Out,13,712
18,12,2011,Restaurant Gordon RamsayPortland Restaurant,Eating Out,50,662
19,12,2011,South West Trains,Transport,33,629
19,12,2011,Pret A Manger,Eating Out,8,621
19,12,2011,ATM Cash Withdrawal,General,20,601
20,12,2011,VIRGIN MEDIA PYMTS,Bills,31,570
20,12,2011,Caffe Nero,Eating Out,1,569
21,12,2011,Starbucks Coffee,Eating Out,1,568
21,12,2011,Subway,Eating Out,7,561
22,12,2011,Caffe Nero,Eating Out,1,560
22,12,2011,ATM Cash Withdrawal,General,20,540
23,12,2011,Tescos,Groceries,58,482
23,12,2011,The West Cornwall Pasty Company,Eating Out,5,477
24,12,2011,O2,Bills,33,444
25,12,2011,Pizza Express,Eating Out,29,415
26,12,2011,South West Trains,Transport,25,390
26,12,2011,Caffe Nero,Eating Out,1,389
26,12,2011,Chicken Cottage,Eating Out,8,381
27,12,2011,Wild Bean Cafe,Eating Out,2,379
27,12,2011,The West Cornwall Pasty Company,Eating Out,5,374
28,12,2011,Wild Bean Cafe,Eating Out,2,372
28,12,2011,McDonalds,Eating Out,7,365
28,12,2011,ATM Cash Withdrawal,General,20,345
29,12,2011,Starbucks Coffee,Eating Out,2,343
29,12,2011,Chicken Cottage,Eating Out,7,336
30,12,2011,Tescos,Groceries,61,275
30,12,2011,Starbucks Coffee,Eating Out,2,273
31,12,2011,Heaven Club,Eating Out,8,265
31,12,2011,Heaven Club,Eating Out,12,253
31,12,2011,Heaven Club,Eating Out,8,245
31,12,2011,Restaurant Gordon RamsayPortland Restaurant,Eating Out,51,194
31,12,2011,ATM Cash Withdrawal,General,20,174
1,1,2012,Rhino Sports salary,General,1700,1874
2,1,2012,South West Trains,Transport,33,1841
2,1,2012,Caffe Nero,Eating Out,1,1840
3,1,2012,Caffe Nero,Eating Out,1,1839
4,1,2012,Caffe Nero,Eating Out,2,1837
4,1,2012,The West Cornwall Pasty Company,Eating Out,7,1830
5,1,2012,Costa Coffee,Eating Out,2,1828
5,1,2012,Subway,Eating Out,5,1823
6,1,2012,Waitrose,Groceries,89,1734
6,1,2012,Costa Coffee,Eating Out,2,1732
7,1,2012,Cubit and West rent,Rent,550,1182
7,1,2012,ATM Cash Withdrawal,General,10,1172
9,1,2012,South West Trains,Transport,28,1144
9,1,2012,Costa Coffee,Eating Out,2,1142
9,1,2012,Greggs,Eating Out,5,1137
9,1,2012,ATM Cash Withdrawal,General,10,1127
10,1,2012,Starbucks Coffee,Eating Out,2,1125
10,1,2012,Chicken Cottage,Eating Out,4,1121
11,1,2012,Wild Bean Cafe,Eating Out,2,1119
11,1,2012,McDonalds,Eating Out,5,1114
12,1,2012,Caffe Nero,Eating Out,2,1112
12,1,2012,Greggs,Eating Out,7,1105
13,1,2012,Morrisons,Groceries,62,1043
13,1,2012,Wild Bean Cafe,Eating Out,2,1041
13,1,2012,The West Cornwall Pasty Company,Eating Out,5,1036
14,1,2012,Pizza Express,Eating Out,32,1004
15,1,2012,BRGAS-Electricity,Bills,34,970
15,1,2012,BRGAS-Gas,Bills,89,881
16,1,2012,LBS Council Tax,Bills,50,831
16,1,2012,South West Trains,Transport,24,807
18,1,2012,Caffe Nero,Eating Out,1,806
18,1,2012,McDonalds,Eating Out,6,800
19,1,2012,Wild Bean Cafe,Eating Out,1,799
19,1,2012,Subway,Eating Out,8,791
20,1,2012,VIRGIN MEDIA PYMTS,Bills,33,758
20,1,2012,Waitrose,Groceries,68,690
20,1,2012,Caffe Nero,Eating Out,2,688
20,1,2012,Chicken Cottage,Eating Out,6,682
23,1,2012,South West Trains,Transport,30,652
23,1,2012,Wild Bean Cafe,Eating Out,2,650
23,1,2012,ATM Cash Withdrawal,General,20,630
24,1,2012,O2,Bills,35,595
24,1,2012,McDonalds,Eating Out,4,591
25,1,2012,Starbucks Coffee,Eating Out,2,589
25,1,2012,ATM Cash Withdrawal,General,20,569
26,1,2012,ATM Cash Withdrawal,General,10,559
27,1,2012,Morrisons,Groceries,67,492
27,1,2012,Caffe Nero,Eating Out,1,491
27,1,2012,McDonalds,Eating Out,8,483
29,1,2012,Pizza Express,Eating Out,42,441
30,1,2012,South West Trains,Transport,27,414
30,1,2012,Caffe Nero,Eating Out,1,413
30,1,2012,Pret A Manger,Eating Out,6,407
31,1,2012,The West Cornwall Pasty Company,Eating Out,8,399
1,2,2012,Rhino Sports salary,General,1700,2099
1,2,2012,Starbucks Coffee,Eating Out,1,2098
1,2,2012,Greggs,Eating Out,6,2092
2,2,2012,Wild Bean Cafe,Eating Out,1,2091
3,2,2012,Sainsburys,Groceries,64,2027
3,2,2012,Costa Coffee,Eating Out,1,2026
3,2,2012,ATM Cash Withdrawal,General,10,2016
6,2,2012,South West Trains,Transport,29,1987
6,2,2012,Wild Bean Cafe,Eating Out,1,1986
6,2,2012,Greggs,Eating Out,7,1979
7,2,2012,Cubit and West rent,Rent,550,1429
7,2,2012,ATM Cash Withdrawal,General,20,1409
8,2,2012,Caffe Nero,Eating Out,2,1407
8,2,2012,Subway,Eating Out,4,1403
8,2,2012,ATM Cash Withdrawal,General,20,1383
9,2,2012,Greggs,Eating Out,5,1378
10,2,2012,ASDA,Groceries,47,1331
10,2,2012,Costa Coffee,Eating Out,1,1330
10,2,2012,Chicken Cottage,Eating Out,6,1324
10,2,2012,Fabric Club,Eating Out,16,1308
10,2,2012,Pizza Express,Eating Out,30,1278
10,2,2012,ATM Cash Withdrawal,General,20,1258
11,2,2012,Fabric Club,Eating Out,5,1253
11,2,2012,Fabric Club,Eating Out,10,1243
11,2,2012,Fabric Club,Eating Out,5,1238
11,2,2012,Dominos Pizza,Eating Out,30,1208
11,2,2012,ATM Cash Withdrawal,General,10,1198
13,2,2012,South West Trains,Transport,33,1165
13,2,2012,Caffe Nero,Eating Out,2,1163
14,2,2012,Greggs,Eating Out,4,1159
15,2,2012,BRGAS-Electricity,Bills,40,1119
15,2,2012,BRGAS-Gas,Bills,33,1086
15,2,2012,ATM Cash Withdrawal,General,20,1066
16,2,2012,LBS Council Tax,Bills,50,1016
16,2,2012,Wild Bean Cafe,Eating Out,2,1014
16,2,2012,Greggs,Eating Out,6,1008
16,2,2012,ATM Cash Withdrawal,General,20,988
17,2,2012,Waitrose,Groceries,88,900
17,2,2012,Wild Bean Cafe,Eating Out,1,899
17,2,2012,Dominos Pizza,Eating Out,37,862
17,2,2012,ATM Cash Withdrawal,General,20,842
18,2,2012,Heaven Club,Eating Out,5,837
18,2,2012,Heaven Club,Eating Out,16,821
20,2,2012,VIRGIN MEDIA PYMTS,Bills,51,770
20,2,2012,South West Trains,Transport,25,745
20,2,2012,Costa Coffee,Eating Out,1,744
20,2,2012,Pret A Manger,Eating Out,8,736
20,2,2012,ATM Cash Withdrawal,General,10,726
22,2,2012,Wild Bean Cafe,Eating Out,1,725
22,2,2012,The West Cornwall Pasty Company,Eating Out,5,720
23,2,2012,McDonalds,Eating Out,4,716
24,2,2012,O2,Bills,34,682
24,2,2012,Tescos,Groceries,68,614
24,2,2012,Starbucks Coffee,Eating Out,2,612
24,2,2012,Restaurant Gordon RamsayPortland Restaurant,Eating Out,48,564
26,2,2012,Scott's Restaurant,Eating Out,32,532
26,2,2012,ATM Cash Withdrawal,General,20,512
27,2,2012,South West Trains,Transport,35,477
27,2,2012,Costa Coffee,Eating Out,1,476
28,2,2012,Costa Coffee,Eating Out,2,474
28,2,2012,Subway,Eating Out,6,468
29,2,2012,Wild Bean Cafe,Eating Out,2,466
29,2,2012,The West Cornwall Pasty Company,Eating Out,5,461
1,3,2012,Rhino Sports salary,General,1700,2161
1,3,2012,Starbucks Coffee,Eating Out,2,2159
2,3,2012,ASDA,Groceries,59,2100
2,3,2012,The Grand Pub,Eating Out,9,2091
2,3,2012,The Grand Pub,Eating Out,6,2085
2,3,2012,The Grand Pub,Eating Out,14,2071
2,3,2012,The Grand Pub,Eating Out,10,2061
3,3,2012,ATM Cash Withdrawal,General,20,2041
4,3,2012,ATM Cash Withdrawal,General,20,2021
5,3,2012,South West Trains,Transport,36,1985
5,3,2012,Pret A Manger,Eating Out,7,1978
5,3,2012,ATM Cash Withdrawal,General,20,1958
6,3,2012,Wild Bean Cafe,Eating Out,1,1957
6,3,2012,ATM Cash Withdrawal,General,10,1947
7,3,2012,Cubit and West rent,Rent,550,1397
7,3,2012,Wild Bean Cafe,Eating Out,2,1395
8,3,2012,Starbucks Coffee,Eating Out,2,1393
8,3,2012,Chicken Cottage,Eating Out,8,1385
8,3,2012,ATM Cash Withdrawal,General,20,1365
9,3,2012,Waitrose,Groceries,72,1293
9,3,2012,McDonalds,Eating Out,4,1289
9,3,2012,Heaven Club,Eating Out,5,1284
9,3,2012,Anglo restaurant,Eating Out,42,1242
11,3,2012,Dominos Pizza,Eating Out,30,1212
11,3,2012,ATM Cash Withdrawal,General,10,1202
12,3,2012,South West Trains,Transport,30,1172
12,3,2012,Caffe Nero,Eating Out,1,1171
13,3,2012,Wild Bean Cafe,Eating Out,2,1169
13,3,2012,Greggs,Eating Out,8,1161
14,3,2012,Caffe Nero,Eating Out,1,1160
15,3,2012,BRGAS-Electricity,Bills,30,1130
15,3,2012,BRGAS-Gas,Bills,31,1099
15,3,2012,Wild Bean Cafe,Eating Out,2,1097
15,3,2012,Chicken Cottage,Eating Out,4,1093
16,3,2012,LBS Council Tax,Bills,50,1043
16,3,2012,ASDA,Groceries,58,985
16,3,2012,Chicken Cottage,Eating Out,8,977
16,3,2012,Scott's Restaurant,Eating Out,38,939
16,3,2012,ATM Cash Withdrawal,General,20,919
19,3,2012,South West Trains,Transport,37,882
19,3,2012,Caffe Nero,Eating Out,2,880
20,3,2012,VIRGIN MEDIA PYMTS,Bills,46,834
20,3,2012,Wild Bean Cafe,Eating Out,1,833
20,3,2012,The West Cornwall Pasty Company,Eating Out,6,827
21,3,2012,Starbucks Coffee,Eating Out,2,825
23,3,2012,ASDA,Groceries,48,777
23,3,2012,McDonalds,Eating Out,5,772
23,3,2012,Dominos Pizza,Eating Out,54,718
24,3,2012,O2,Bills,36,682
24,3,2012,Anglo restaurant,Eating Out,42,640
26,3,2012,South West Trains,Transport,37,603
26,3,2012,Wild Bean Cafe,Eating Out,2,601
26,3,2012,Greggs,Eating Out,7,594
27,3,2012,Costa Coffee,Eating Out,2,592
27,3,2012,Subway,Eating Out,6,586
28,3,2012,Caffe Nero,Eating Out,2,584
29,3,2012,Caffe Nero,Eating Out,1,583
29,3,2012,Chicken Cottage,Eating Out,5,578
30,3,2012,Morrisons,Groceries,81,497
30,3,2012,Starbucks Coffee,Eating Out,2,495
30,3,2012,Subway,Eating Out,6,489
30,3,2012,Ministry of Sound ClubXOYO Club,Eating Out,12,477
30,3,2012,Ministry of Sound ClubXOYO Club,Eating Out,15,462
30,3,2012,Ministry of Sound ClubXOYO Club,Eating Out,14,448
1,4,2012,Rhino Sports salary,General,1700,2148
1,4,2012,ATM Cash Withdrawal,General,20,2128
2,4,2012,South West Trains,Transport,24,2104
2,4,2012,Starbucks Coffee,Eating Out,1,2103
2,4,2012,The West Cornwall Pasty Company,Eating Out,5,2098
3,4,2012,Starbucks Coffee,Eating Out,2,2096
3,4,2012,ATM Cash Withdrawal,General,20,2076
4,4,2012,Caffe Nero,Eating Out,2,2074
4,4,2012,Greggs,Eating Out,4,2070
4,4,2012,ATM Cash Withdrawal,General,20,2050
5,4,2012,Caffe Nero,Eating Out,2,2048
5,4,2012,Subway,Eating Out,6,2042
6,4,2012,Tescos,Groceries,43,1999
6,4,2012,Wild Bean Cafe,Eating Out,2,1997
6,4,2012,Pret A Manger,Eating Out,6,1991
7,4,2012,Cubit and West rent,Rent,550,1441
9,4,2012,South West Trains,Transport,25,1416
9,4,2012,Starbucks Coffee,Eating Out,1,1415
9,4,2012,The West Cornwall Pasty Company,Eating Out,6,1409
9,4,2012,ATM Cash Withdrawal,General,10,1399
10,4,2012,Caffe Nero,Eating Out,1,1398
10,4,2012,ATM Cash Withdrawal,General,10,1388
11,4,2012,Starbucks Coffee,Eating Out,1,1387
11,4,2012,Greggs,Eating Out,6,1381
12,4,2012,Costa Coffee,Eating Out,2,1379
12,4,2012,McDonalds,Eating Out,7,1372
13,4,2012,ASDA,Groceries,52,1320
13,4,2012,Costa Coffee,Eating Out,2,1318
13,4,2012,ATM Cash Withdrawal,General,20,1298
14,4,2012,Heaven Club,Eating Out,12,1286
14,4,2012,Heaven Club,Eating Out,15,1271
14,4,2012,Heaven Club,Eating Out,12,1259
14,4,2012,Heaven Club,Eating Out,6,1253
14,4,2012,Heaven Club,Eating Out,15,1238
14,4,2012,ATM Cash Withdrawal,General,20,1218
15,4,2012,BRGAS-Electricity,Bills,34,1184
15,4,2012,BRGAS-Gas,Bills,22,1162
15,4,2012,Anglo restaurant,Eating Out,48,1114
15,4,2012,ATM Cash Withdrawal,General,10,1104
16,4,2012,LBS Council Tax,Bills,50,1054
16,4,2012,South West Trains,Transport,30,1024
16,4,2012,Starbucks Coffee,Eating Out,2,1022
16,4,2012,Subway,Eating Out,8,1014
16,4,2012,ATM Cash Withdrawal,General,10,1004
17,4,2012,Greggs,Eating Out,5,999
18,4,2012,Wild Bean Cafe,Eating Out,2,997
18,4,2012,Chicken Cottage,Eating Out,4,993
19,4,2012,Wild Bean Cafe,Eating Out,1,992
19,4,2012,Pret A Manger,Eating Out,8,984
19,4,2012,ATM Cash Withdrawal,General,10,974
20,4,2012,VIRGIN MEDIA PYMTS,Bills,55,919
20,4,2012,Waitrose,Groceries,82,837
20,4,2012,Caffe Nero,Eating Out,2,835
20,4,2012,Pizza Express,Eating Out,35,800
21,4,2012,Heaven Club,Eating Out,15,785
21,4,2012,Heaven Club,Eating Out,15,770
21,4,2012,Heaven Club,Eating Out,11,759
21,4,2012,Heaven Club,Eating Out,6,753
21,4,2012,Heaven Club,Eating Out,5,748
21,4,2012,Heaven Club,Eating Out,9,739
21,4,2012,ATM Cash Withdrawal,General,20,719
23,4,2012,South West Trains,Transport,31,688
23,4,2012,Wild Bean Cafe,Eating Out,2,686
23,4,2012,The West Cornwall Pasty Company,Eating Out,6,680
24,4,2012,O2,Bills,37,643
24,4,2012,Pret A Manger,Eating Out,6,637
25,4,2012,Costa Coffee,Eating Out,2,635
25,4,2012,Chicken Cottage,Eating Out,5,630
26,4,2012,Caffe Nero,Eating Out,2,628
26,4,2012,Greggs,Eating Out,4,624
27,4,2012,Sainsburys,Groceries,47,577
27,4,2012,Starbucks Coffee,Eating Out,2,575
27,4,2012,Pizza Express,Eating Out,48,527
27,4,2012,ATM Cash Withdrawal,General,10,517
28,4,2012,ATM Cash Withdrawal,General,20,497
30,4,2012,South West Trains,Transport,27,470
30,4,2012,Wild Bean Cafe,Eating Out,1,469
30,4,2012,The West Cornwall Pasty Company,Eating Out,5,464
1,5,2012,Rhino Sports salary,General,1700,2164
1,5,2012,Costa Coffee,Eating Out,1,2163
1,5,2012,Subway,Eating Out,6,2157
2,5,2012,Starbucks Coffee,Eating Out,1,2156
3,5,2012,Costa Coffee,Eating Out,2,2154
4,5,2012,Tescos,Groceries,76,2078
4,5,2012,Costa Coffee,Eating Out,1,2077
4,5,2012,ATM Cash Withdrawal,General,10,2067
5,5,2012,Pizza Express,Eating Out,37,2030
5,5,2012,ATM Cash Withdrawal,General,10,2020
6,5,2012,Dominos Pizza,Eating Out,54,1966
7,5,2012,Cubit and West rent,Rent,550,1416
7,5,2012,South West Trains,Transport,32,1384
7,5,2012,Wild Bean Cafe,Eating Out,1,1383
8,5,2012,Chicken Cottage,Eating Out,6,1377
8,5,2012,ATM Cash Withdrawal,General,10,1367
9,5,2012,ATM Cash Withdrawal,General,20,1347
10,5,2012,Costa Coffee,Eating Out,2,1345
11,5,2012,Waitrose,Groceries,43,1302
11,5,2012,Caffe Nero,Eating Out,2,1300
11,5,2012,ATM Cash Withdrawal,General,10,1290
12,5,2012,Anglo restaurant,Eating Out,48,1242
13,5,2012,ATM Cash Withdrawal,General,10,1232
14,5,2012,South West Trains,Transport,37,1195
14,5,2012,Wild Bean Cafe,Eating Out,2,1193
15,5,2012,BRGAS-Electricity,Bills,26,1167
15,5,2012,BRGAS-Gas,Bills,32,1135
15,5,2012,Starbucks Coffee,Eating Out,2,1133
15,5,2012,Pret A Manger,Eating Out,4,1129
16,5,2012,LBS Council Tax,Bills,50,1079
16,5,2012,Starbucks Coffee,Eating Out,2,1077
16,5,2012,Pret A Manger,Eating Out,6,1071
18,5,2012,Sainsburys,Groceries,72,999
18,5,2012,Costa Coffee,Eating Out,1,998
20,5,2012,VIRGIN MEDIA PYMTS,Bills,31,967
20,5,2012,ATM Cash Withdrawal,General,20,947
21,5,2012,South West Trains,Transport,27,920
21,5,2012,The West Cornwall Pasty Company,Eating Out,4,916
22,5,2012,Wild Bean Cafe,Eating Out,1,915
22,5,2012,Greggs,Eating Out,6,909
22,5,2012,ATM Cash Withdrawal,General,10,899
23,5,2012,Costa Coffee,Eating Out,2,897
24,5,2012,O2,Bills,35,862
24,5,2012,Wild Bean Cafe,Eating Out,2,860
24,5,2012,McDonalds,Eating Out,6,854
24,5,2012,ATM Cash Withdrawal,General,20,834
25,5,2012,ASDA,Groceries,87,747
25,5,2012,Wild Bean Cafe,Eating Out,2,745
25,5,2012,Greggs,Eating Out,7,738
25,5,2012,Restaurant Gordon RamsayPortland Restaurant,Eating Out,54,684
26,5,2012,Anglo restaurant,Eating Out,54,630
28,5,2012,South West Trains,Transport,34,596
28,5,2012,Costa Coffee,Eating Out,2,594
29,5,2012,Wild Bean Cafe,Eating Out,2,592
29,5,2012,Pret A Manger,Eating Out,5,587
30,5,2012,Wild Bean Cafe,Eating Out,2,585
30,5,2012,Chicken Cottage,Eating Out,5,580
31,5,2012,Wild Bean Cafe,Eating Out,2,578
31,5,2012,ATM Cash Withdrawal,General,20,558
1,6,2012,Rhino Sports salary,General,1700,2258
1,6,2012,Tescos,Groceries,82,2176
1,6,2012,Subway,Eating Out,6,2170
1,6,2012,Dominos Pizza,Eating Out,32,2138
1,6,2012,ATM Cash Withdrawal,General,20,2118
4,6,2012,South West Trains,Transport,32,2086
4,6,2012,Caffe Nero,Eating Out,2,2084
4,6,2012,McDonalds,Eating Out,7,2077
5,6,2012,Costa Coffee,Eating Out,2,2075
5,6,2012,ATM Cash Withdrawal,General,10,2065
6,6,2012,Chicken Cottage,Eating Out,5,2060
6,6,2012,ATM Cash Withdrawal,General,10,2050
7,6,2012,Cubit and West rent,Rent,550,1500
7,6,2012,Wild Bean Cafe,Eating Out,1,1499
7,6,2012,Chicken Cottage,Eating Out,7,1492
8,6,2012,Waitrose,Groceries,60,1432
8,6,2012,Subway,Eating Out,8,1424
9,6,2012,Heaven Club,Eating Out,12,1412
9,6,2012,Heaven Club,Eating Out,5,1407
9,6,2012,Heaven Club,Eating Out,7,1400
9,6,2012,Heaven Club,Eating Out,10,1390
9,6,2012,Anglo restaurant,Eating Out,33,1357
11,6,2012,South West Trains,Transport,36,1321
11,6,2012,Wild Bean Cafe,Eating Out,2,1319
11,6,2012,McDonalds,Eating Out,6,1313
12,6,2012,Caffe Nero,Eating Out,2,1311
13,6,2012,McDonalds,Eating Out,6,1305
13,6,2012,ATM Cash Withdrawal,General,10,1295
14,6,2012,Costa Coffee,Eating Out,2,1293
14,6,2012,Chicken Cottage,Eating Out,8,1285
15,6,2012,BRGAS-Electricity,Bills,25,1260
15,6,2012,BRGAS-Gas,Bills,35,1225
15,6,2012,Tescos,Groceries,68,1157
15,6,2012,Caffe Nero,Eating Out,2,1155
15,6,2012,The West Cornwall Pasty Company,Eating Out,8,1147
16,6,2012,LBS Council Tax,Bills,50,1097
16,6,2012,Heaven Club,Eating Out,9,1088
16,6,2012,ATM Cash Withdrawal,General,10,1078
17,6,2012,Scott's Restaurant,Eating Out,39,1039
17,6,2012,ATM Cash Withdrawal,General,20,1019
18,6,2012,South West Trains,Transport,24,995
18,6,2012,McDonalds,Eating Out,4,991
19,6,2012,Wild Bean Cafe,Eating Out,2,989
19,6,2012,The West Cornwall Pasty Company,Eating Out,5,984
20,6,2012,VIRGIN MEDIA PYMTS,Bills,51,933
20,6,2012,Caffe Nero,Eating Out,1,932
21,6,2012,Starbucks Coffee,Eating Out,2,930
21,6,2012,Chicken Cottage,Eating Out,8,922
22,6,2012,Tescos,Groceries,50,872
22,6,2012,Wild Bean Cafe,Eating Out,1,871
22,6,2012,McDonalds,Eating Out,8,863
22,6,2012,Restaurant Gordon RamsayPortland Restaurant,Eating Out,55,808
23,6,2012,Pizza Express,Eating Out,39,769
23,6,2012,ATM Cash Withdrawal,General,20,749
24,6,2012,O2,Bills,35,714
24,6,2012,ATM Cash Withdrawal,General,20,694
25,6,2012,South West Trains,Transport,33,661
25,6,2012,Caffe Nero,Eating Out,2,659
25,6,2012,Chicken Cottage,Eating Out,6,653
26,6,2012,Costa Coffee,Eating Out,2,651
26,6,2012,ATM Cash Withdrawal,General,10,641
28,6,2012,Starbucks Coffee,Eating Out,2,639
28,6,2012,Greggs,Eating Out,4,635
28,6,2012,ATM Cash Withdrawal,General,20,615
29,6,2012,Sainsburys,Groceries,58,557
29,6,2012,Caffe Nero,Eating Out,1,556
29,6,2012,Restaurant Gordon RamsayPortland Restaurant,Eating Out,52,504
29,6,2012,ATM Cash Withdrawal,General,20,484
30,6,2012,Dominos Pizza,Eating Out,50,434
30,6,2012,ATM Cash Withdrawal,General,20,414
1,7,2012,Rhino Sports salary,General,1700,2114
1,7,2012,Scott's Restaurant,Eating Out,45,2069
1,7,2012,ATM Cash Withdrawal,General,10,2059
2,7,2012,South West Trains,Transport,28,2031
2,7,2012,Caffe Nero,Eating Out,2,2029
2,7,2012,Greggs,Eating Out,8,2021
3,7,2012,Wild Bean Cafe,Eating Out,2,2019
3,7,2012,The West Cornwall Pasty Company,Eating Out,8,2011
3,7,2012,ATM Cash Withdrawal,General,10,2001
4,7,2012,Starbucks Coffee,Eating Out,2,1999
4,7,2012,The West Cornwall Pasty Company,Eating Out,5,1994
4,7,2012,ATM Cash Withdrawal,General,10,1984
5,7,2012,Costa Coffee,Eating Out,1,1983
6,7,2012,Sainsburys,Groceries,85,1898
6,7,2012,Caffe Nero,Eating Out,2,1896
6,7,2012,Pret A Manger,Eating Out,5,1891
6,7,2012,Dominos Pizza,Eating Out,48,1843
6,7,2012,ATM Cash Withdrawal,General,20,1823
7,7,2012,Cubit and West rent,Rent,550,1273
7,7,2012,Heaven Club,Eating Out,11,1262
7,7,2012,Heaven Club,Eating Out,6,1256
7,7,2012,Heaven Club,Eating Out,16,1240
7,7,2012,Heaven Club,Eating Out,12,1228
7,7,2012,Heaven Club,Eating Out,11,1217
8,7,2012,ATM Cash Withdrawal,General,10,1207
9,7,2012,South West Trains,Transport,29,1178
9,7,2012,Wild Bean Cafe,Eating Out,2,1176
9,7,2012,Greggs,Eating Out,7,1169
10,7,2012,Costa Coffee,Eating Out,1,1168
10,7,2012,McDonalds,Eating Out,7,1161
11,7,2012,Starbucks Coffee,Eating Out,1,1160
12,7,2012,Wild Bean Cafe,Eating Out,1,1159
12,7,2012,McDonalds,Eating Out,8,1151
13,7,2012,Waitrose,Groceries,49,1102
13,7,2012,Caffe Nero,Eating Out,1,1101
13,7,2012,Subway,Eating Out,8,1093
13,7,2012,Anglo restaurant,Eating Out,58,1035
14,7,2012,Scott's Restaurant,Eating Out,47,988
15,7,2012,BRGAS-Electricity,Bills,42,946
15,7,2012,BRGAS-Gas,Bills,21,925
15,7,2012,Scott's Restaurant,Eating Out,30,895
16,7,2012,LBS Council Tax,Bills,50,845
16,7,2012,South West Trains,Transport,30,815
16,7,2012,Caffe Nero,Eating Out,1,814
17,7,2012,Starbucks Coffee,Eating Out,2,812
17,7,2012,Greggs,Eating Out,8,804
18,7,2012,Wild Bean Cafe,Eating Out,2,802
19,7,2012,Caffe Nero,Eating Out,1,801
19,7,2012,Chicken Cottage,Eating Out,6,795
20,7,2012,VIRGIN MEDIA PYMTS,Bills,57,738
20,7,2012,Morrisons,Groceries,49,689
20,7,2012,Caffe Nero,Eating Out,2,687
20,7,2012,McDonalds,Eating Out,6,681
20,7,2012,Anglo restaurant,Eating Out,55,626
21,7,2012,Anglo restaurant,Eating Out,51,575
23,7,2012,South West Trains,Transport,28,547
23,7,2012,Wild Bean Cafe,Eating Out,2,545
23,7,2012,Pret A Manger,Eating Out,8,537
23,7,2012,ATM Cash Withdrawal,General,20,517
24,7,2012,O2,Bills,37,480
25,7,2012,Wild Bean Cafe,Eating Out,1,479
25,7,2012,The West Cornwall Pasty Company,Eating Out,7,472
26,7,2012,Caffe Nero,Eating Out,1,471
27,7,2012,Sainsburys,Groceries,78,393
27,7,2012,Starbucks Coffee,Eating Out,2,391
27,7,2012,Anglo restaurant,Eating Out,56,335
28,7,2012,Scott's Restaurant,Eating Out,37,298
28,7,2012,ATM Cash Withdrawal,General,20,278
30,7,2012,South West Trains,Transport,35,243
30,7,2012,Caffe Nero,Eating Out,2,241
30,7,2012,Pret A Manger,Eating Out,6,235
31,7,2012,Caffe Nero,Eating Out,2,233
31,7,2012,ATM Cash Withdrawal,General,10,223
1,8,2012,Rhino Sports salary,General,1700,1923
1,8,2012,Costa Coffee,Eating Out,2,1921
1,8,2012,McDonalds,Eating Out,4,1917
1,8,2012,ATM Cash Withdrawal,General,10,1907
2,8,2012,Starbucks Coffee,Eating Out,1,1906
2,8,2012,Chicken Cottage,Eating Out,4,1902
3,8,2012,ASDA,Groceries,82,1820
3,8,2012,Caffe Nero,Eating Out,2,1818
3,8,2012,The West Cornwall Pasty Company,Eating Out,7,1811
3,8,2012,ATM Cash Withdrawal,General,20,1791
5,8,2012,ATM Cash Withdrawal,General,10,1781
6,8,2012,South West Trains,Transport,35,1746
6,8,2012,The West Cornwall Pasty Company,Eating Out,7,1739
6,8,2012,ATM Cash Withdrawal,General,10,1729
7,8,2012,Cubit and West rent,Rent,550,1179
7,8,2012,Pret A Manger,Eating Out,8,1171
8,8,2012,Wild Bean Cafe,Eating Out,1,1170
8,8,2012,ATM Cash Withdrawal,General,20,1150
9,8,2012,Costa Coffee,Eating Out,1,1149
9,8,2012,McDonalds,Eating Out,4,1145
10,8,2012,Waitrose,Groceries,77,1068
10,8,2012,Starbucks Coffee,Eating Out,2,1066
10,8,2012,Chicken Cottage,Eating Out,7,1059
10,8,2012,Fabric Club,Eating Out,10,1049
10,8,2012,Fabric Club,Eating Out,12,1037
10,8,2012,Fabric Club,Eating Out,11,1026
10,8,2012,Fabric Club,Eating Out,5,1021
10,8,2012,Fabric Club,Eating Out,8,1013
10,8,2012,ATM Cash Withdrawal,General,20,993
12,8,2012,ATM Cash Withdrawal,General,20,973
13,8,2012,South West Trains,Transport,27,946
13,8,2012,Costa Coffee,Eating Out,1,945
13,8,2012,ATM Cash Withdrawal,General,20,925
14,8,2012,Caffe Nero,Eating Out,1,924
14,8,2012,The West Cornwall Pasty Company,Eating Out,5,919
15,8,2012,BRGAS-Electricity,Bills,21,898
15,8,2012,BRGAS-Gas,Bills,29,869
15,8,2012,Wild Bean Cafe,Eating Out,2,867
16,8,2012,LBS Council Tax,Bills,50,817
16,8,2012,Pret A Manger,Eating Out,6,811
17,8,2012,Tescos,Groceries,86,725
17,8,2012,Wild Bean Cafe,Eating Out,2,723
17,8,2012,Ministry of Sound ClubXOYO Club,Eating Out,8,715
18,8,2012,ATM Cash Withdrawal,General,10,705
19,8,2012,Pizza Express,Eating Out,53,652
20,8,2012,VIRGIN MEDIA PYMTS,Bills,35,617
20,8,2012,South West Trains,Transport,25,592
20,8,2012,Costa Coffee,Eating Out,2,590
21,8,2012,McDonalds,Eating Out,8,582
21,8,2012,ATM Cash Withdrawal,General,20,562
22,8,2012,Caffe Nero,Eating Out,2,560
22,8,2012,McDonalds,Eating Out,8,552
23,8,2012,The West Cornwall Pasty Company,Eating Out,8,544
24,8,2012,O2,Bills,35,509
24,8,2012,ASDA,Groceries,70,439
24,8,2012,Wild Bean Cafe,Eating Out,1,438
24,8,2012,Pret A Manger,Eating Out,7,431
25,8,2012,Pizza Express,Eating Out,29,402
27,8,2012,South West Trains,Transport,36,366
27,8,2012,Wild Bean Cafe,Eating Out,2,364
28,8,2012,Caffe Nero,Eating Out,1,363
29,8,2012,Wild Bean Cafe,Eating Out,2,361
29,8,2012,Subway,Eating Out,7,354
29,8,2012,ATM Cash Withdrawal,General,20,334
31,8,2012,Sainsburys,Groceries,58,276
31,8,2012,Caffe Nero,Eating Out,2,274
31,8,2012,McDonalds,Eating Out,4,270
1,9,2012,Rhino Sports salary,General,1700,1970
2,9,2012,ATM Cash Withdrawal,General,10,1960
3,9,2012,South West Trains,Transport,26,1934
3,9,2012,Costa Coffee,Eating Out,1,1933
3,9,2012,Subway,Eating Out,5,1928
4,9,2012,Starbucks Coffee,Eating Out,1,1927
4,9,2012,McDonalds,Eating Out,6,1921
5,9,2012,Costa Coffee,Eating Out,1,1920
5,9,2012,ATM Cash Withdrawal,General,20,1900
6,9,2012,Starbucks Coffee,Eating Out,2,1898
6,9,2012,The West Cornwall Pasty Company,Eating Out,6,1892
7,9,2012,Cubit and West rent,Rent,550,1342
7,9,2012,Waitrose,Groceries,76,1266
7,9,2012,Costa Coffee,Eating Out,1,1265
7,9,2012,Restaurant Gordon RamsayPortland Restaurant,Eating Out,49,1216
8,9,2012,Heaven Club,Eating Out,7,1209
8,9,2012,Heaven Club,Eating Out,11,1198
8,9,2012,Heaven Club,Eating Out,12,1186
8,9,2012,ATM Cash Withdrawal,General,10,1176
9,9,2012,Pizza Express,Eating Out,59,1117
9,9,2012,ATM Cash Withdrawal,General,20,1097
10,9,2012,South West Trains,Transport,26,1071
10,9,2012,Wild Bean Cafe,Eating Out,2,1069
10,9,2012,Subway,Eating Out,8,1061
11,9,2012,Starbucks Coffee,Eating Out,2,1059
11,9,2012,Pret A Manger,Eating Out,6,1053
11,9,2012,ATM Cash Withdrawal,General,20,1033
12,9,2012,Caffe Nero,Eating Out,2,1031
12,9,2012,The West Cornwall Pasty Company,Eating Out,7,1024
13,9,2012,Starbucks Coffee,Eating Out,2,1022
13,9,2012,McDonalds,Eating Out,8,1014
13,9,2012,ATM Cash Withdrawal,General,10,1004
14,9,2012,Morrisons,Groceries,61,943
14,9,2012,Starbucks Coffee,Eating Out,1,942
14,9,2012,Subway,Eating Out,4,938
14,9,2012,The Grand Pub,Eating Out,13,925
14,9,2012,The Grand Pub,Eating Out,10,915
14,9,2012,The Grand Pub,Eating Out,15,900
14,9,2012,The Grand Pub,Eating Out,15,885
14,9,2012,The Grand Pub,Eating Out,8,877
15,9,2012,BRGAS-Electricity,Bills,28,849
15,9,2012,BRGAS-Gas,Bills,27,822
15,9,2012,ATM Cash Withdrawal,General,20,802
16,9,2012,LBS Council Tax,Bills,50,752
16,9,2012,Dominos Pizza,Eating Out,53,699
17,9,2012,South West Trains,Transport,36,663
17,9,2012,ATM Cash Withdrawal,General,20,643
18,9,2012,Caffe Nero,Eating Out,2,641
18,9,2012,The West Cornwall Pasty Company,Eating Out,8,633
19,9,2012,Wild Bean Cafe,Eating Out,2,631
19,9,2012,McDonalds,Eating Out,5,626
19,9,2012,ATM Cash Withdrawal,General,20,606
20,9,2012,VIRGIN MEDIA PYMTS,Bills,51,555
20,9,2012,Costa Coffee,Eating Out,2,553
20,9,2012,ATM Cash Withdrawal,General,10,543
21,9,2012,Morrisons,Groceries,68,475
21,9,2012,Caffe Nero,Eating Out,2,473
21,9,2012,Scott's Restaurant,Eating Out,44,429
22,9,2012,ATM Cash Withdrawal,General,10,419
24,9,2012,O2,Bills,30,389
24,9,2012,South West Trains,Transport,28,361
24,9,2012,Costa Coffee,Eating Out,2,359
24,9,2012,The West Cornwall Pasty Company,Eating Out,8,351
24,9,2012,ATM Cash Withdrawal,General,20,331
25,9,2012,Wild Bean Cafe,Eating Out,2,329
26,9,2012,Wild Bean Cafe,Eating Out,2,327
26,9,2012,Greggs,Eating Out,7,320
28,9,2012,ASDA,Groceries,58,262
28,9,2012,Wild Bean Cafe,Eating Out,2,260
28,9,2012,McDonalds,Eating Out,4,256
28,9,2012,Anglo restaurant,Eating Out,44,212
29,9,2012,ATM Cash Withdrawal,General,20,192
30,9,2012,Restaurant Gordon RamsayPortland Restaurant,Eating Out,56,136
1,10,2012,Rhino Sports salary,General,1700,1836
1,10,2012,South West Trains,Transport,28,1808
1,10,2012,Wild Bean Cafe,Eating Out,2,1806
1,10,2012,ATM Cash Withdrawal,General,20,1786
2,10,2012,Starbucks Coffee,Eating Out,2,1784
2,10,2012,Pret A Manger,Eating Out,8,1776
3,10,2012,Costa Coffee,Eating Out,1,1775
3,10,2012,Subway,Eating Out,6,1769
3,10,2012,ATM Cash Withdrawal,General,20,1749
4,10,2012,Wild Bean Cafe,Eating Out,2,1747
4,10,2012,Greggs,Eating Out,6,1741
5,10,2012,Waitrose,Groceries,77,1664
5,10,2012,Starbucks Coffee,Eating Out,2,1662
5,10,2012,Pret A Manger,Eating Out,8,1654
6,10,2012,ATM Cash Withdrawal,General,10,1644
7,10,2012,Cubit and West rent,Rent,550,1094
7,10,2012,ATM Cash Withdrawal,General,20,1074
8,10,2012,South West Trains,Transport,36,1038
8,10,2012,ATM Cash Withdrawal,General,20,1018
9,10,2012,Wild Bean Cafe,Eating Out,1,1017
10,10,2012,Subway,Eating Out,6,1011
11,10,2012,Starbucks Coffee,Eating Out,2,1009
11,10,2012,Subway,Eating Out,8,1001
12,10,2012,Sainsburys,Groceries,79,922
13,10,2012,ATM Cash Withdrawal,General,20,902
15,10,2012,BRGAS-Electricity,Bills,22,880
15,10,2012,BRGAS-Gas,Bills,34,846
15,10,2012,South West Trains,Transport,27,819
15,10,2012,ATM Cash Withdrawal,General,20,799
16,10,2012,LBS Council Tax,Bills,50,749
16,10,2012,Costa Coffee,Eating Out,1,748
16,10,2012,Subway,Eating Out,8,740
16,10,2012,ATM Cash Withdrawal,General,10,730
17,10,2012,Wild Bean Cafe,Eating Out,2,728
17,10,2012,Chicken Cottage,Eating Out,7,721
18,10,2012,Wild Bean Cafe,Eating Out,2,719
18,10,2012,Greggs,Eating Out,5,714
19,10,2012,Tescos,Groceries,51,663
19,10,2012,Caffe Nero,Eating Out,2,661
19,10,2012,Restaurant Gordon RamsayPortland Restaurant,Eating Out,39,622
20,10,2012,VIRGIN MEDIA PYMTS,Bills,33,589
20,10,2012,Pizza Express,Eating Out,47,542
22,10,2012,South West Trains,Transport,28,514
22,10,2012,Wild Bean Cafe,Eating Out,2,512
22,10,2012,McDonalds,Eating Out,7,505
23,10,2012,Starbucks Coffee,Eating Out,1,504
23,10,2012,The West Cornwall Pasty Company,Eating Out,7,497
24,10,2012,O2,Bills,35,462
24,10,2012,Wild Bean Cafe,Eating Out,1,461
25,10,2012,Wild Bean Cafe,Eating Out,2,459
26,10,2012,Sainsburys,Groceries,47,412
26,10,2012,The Grand Pub,Eating Out,15,397
26,10,2012,The Grand Pub,Eating Out,11,386
26,10,2012,The Grand Pub,Eating Out,6,380
26,10,2012,The Grand Pub,Eating Out,14,366
26,10,2012,The Grand Pub,Eating Out,12,354
27,10,2012,ATM Cash Withdrawal,General,10,344
29,10,2012,South West Trains,Transport,27,317
29,10,2012,Caffe Nero,Eating Out,2,315
29,10,2012,Greggs,Eating Out,4,311
30,10,2012,The West Cornwall Pasty Company,Eating Out,6,305
31,10,2012,Caffe Nero,Eating Out,1,304
1,11,2012,Rhino Sports salary,General,1700,2004
2,11,2012,Sainsburys,Groceries,89,1915
2,11,2012,Wild Bean Cafe,Eating Out,2,1913
2,11,2012,Subway,Eating Out,6,1907
2,11,2012,Anglo restaurant,Eating Out,48,1859
3,11,2012,ATM Cash Withdrawal,General,10,1849
4,11,2012,ATM Cash Withdrawal,General,10,1839
5,11,2012,South West Trains,Transport,27,1812
5,11,2012,Costa Coffee,Eating Out,2,1810
6,11,2012,Greggs,Eating Out,7,1803
6,11,2012,ATM Cash Withdrawal,General,20,1783
7,11,2012,Cubit and West rent,Rent,550,1233
7,11,2012,Starbucks Coffee,Eating Out,2,1231
7,11,2012,The West Cornwall Pasty Company,Eating Out,8,1223
8,11,2012,Wild Bean Cafe,Eating Out,1,1222
9,11,2012,Waitrose,Groceries,59,1163
9,11,2012,Subway,Eating Out,4,1159
9,11,2012,Pizza Express,Eating Out,26,1133
12,11,2012,South West Trains,Transport,35,1098
12,11,2012,Starbucks Coffee,Eating Out,2,1096
12,11,2012,Subway,Eating Out,6,1090
13,11,2012,Subway,Eating Out,7,1083
13,11,2012,ATM Cash Withdrawal,General,10,1073
14,11,2012,Greggs,Eating Out,4,1069
15,11,2012,BRGAS-Electricity,Bills,103,966
15,11,2012,BRGAS-Gas,Bills,32,934
15,11,2012,Costa Coffee,Eating Out,2,932
15,11,2012,The West Cornwall Pasty Company,Eating Out,8,924
16,11,2012,LBS Council Tax,Bills,50,874
16,11,2012,Tescos,Groceries,42,832
16,11,2012,Wild Bean Cafe,Eating Out,1,831
16,11,2012,Restaurant Gordon RamsayPortland Restaurant,Eating Out,24,807
18,11,2012,Scott's Restaurant,Eating Out,24,783
19,11,2012,South West Trains,Transport,38,745
19,11,2012,Wild Bean Cafe,Eating Out,2,743
19,11,2012,Subway,Eating Out,6,737
20,11,2012,VIRGIN MEDIA PYMTS,Bills,47,690
20,11,2012,Starbucks Coffee,Eating Out,1,689
20,11,2012,McDonalds,Eating Out,8,681
21,11,2012,Wild Bean Cafe,Eating Out,2,679
21,11,2012,McDonalds,Eating Out,6,673
22,11,2012,Costa Coffee,Eating Out,1,672
22,11,2012,Greggs,Eating Out,4,668
23,11,2012,Morrisons,Groceries,45,623
23,11,2012,Wild Bean Cafe,Eating Out,2,621
24,11,2012,O2,Bills,31,590
25,11,2012,Pizza Express,Eating Out,32,558
26,11,2012,South West Trains,Transport,32,526
26,11,2012,Caffe Nero,Eating Out,2,524
27,11,2012,Wild Bean Cafe,Eating Out,1,523
28,11,2012,Wild Bean Cafe,Eating Out,2,521
29,11,2012,Starbucks Coffee,Eating Out,2,519
29,11,2012,Greggs,Eating Out,7,512
29,11,2012,ATM Cash Withdrawal,General,10,502
30,11,2012,Tescos,Groceries,50,452
30,11,2012,Costa Coffee,Eating Out,2,450
30,11,2012,Dominos Pizza,Eating Out,58,392
1,12,2012,Rhino Sports salary,General,1700,2092
1,12,2012,ATM Cash Withdrawal,General,10,2082
2,12,2012,ATM Cash Withdrawal,General,20,2062
3,12,2012,South West Trains,Transport,30,2032
3,12,2012,Wild Bean Cafe,Eating Out,1,2031
3,12,2012,Chicken Cottage,Eating Out,5,2026
3,12,2012,ATM Cash Withdrawal,General,10,2016
4,12,2012,Starbucks Coffee,Eating Out,2,2014
4,12,2012,Chicken Cottage,Eating Out,5,2009
5,12,2012,Caffe Nero,Eating Out,1,2008
5,12,2012,Pret A Manger,Eating Out,8,2000
6,12,2012,Caffe Nero,Eating Out,2,1998
7,12,2012,Cubit and West rent,Rent,550,1448
7,12,2012,Morrisons,Groceries,44,1404
7,12,2012,Costa Coffee,Eating Out,1,1403
7,12,2012,McDonalds,Eating Out,5,1398
7,12,2012,Scott's Restaurant,Eating Out,31,1367
9,12,2012,Pizza Express,Eating Out,49,1318
10,12,2012,South West Trains,Transport,28,1290
10,12,2012,Wild Bean Cafe,Eating Out,2,1288
10,12,2012,McDonalds,Eating Out,8,1280
11,12,2012,Starbucks Coffee,Eating Out,1,1279
11,12,2012,The West Cornwall Pasty Company,Eating Out,4,1275
12,12,2012,Caffe Nero,Eating Out,2,1273
12,12,2012,McDonalds,Eating Out,6,1267
12,12,2012,ATM Cash Withdrawal,General,10,1257
13,12,2012,Costa Coffee,Eating Out,2,1255
13,12,2012,Greggs,Eating Out,7,1248
14,12,2012,ASDA,Groceries,50,1198
14,12,2012,Costa Coffee,Eating Out,1,1197
14,12,2012,Dominos Pizza,Eating Out,58,1139
15,12,2012,BRGAS-Electricity,Bills,24,1115
15,12,2012,BRGAS-Gas,Bills,34,1081
15,12,2012,Scott's Restaurant,Eating Out,58,1023
16,12,2012,LBS Council Tax,Bills,50,973
16,12,2012,Dominos Pizza,Eating Out,54,919
17,12,2012,South West Trains,Transport,38,881
17,12,2012,Caffe Nero,Eating Out,1,880
17,12,2012,Pret A Manger,Eating Out,5,875
18,12,2012,Wild Bean Cafe,Eating Out,1,874
19,12,2012,Caffe Nero,Eating Out,2,872
20,12,2012,VIRGIN MEDIA PYMTS,Bills,55,817
20,12,2012,Costa Coffee,Eating Out,2,815
20,12,2012,ATM Cash Withdrawal,General,20,795
21,12,2012,Tescos,Groceries,69,726
21,12,2012,Starbucks Coffee,Eating Out,2,724
21,12,2012,ATM Cash Withdrawal,General,20,704
22,12,2012,Pizza Express,Eating Out,31,673
24,12,2012,O2,Bills,30,643
24,12,2012,South West Trains,Transport,34,609
24,12,2012,Caffe Nero,Eating Out,2,607
24,12,2012,Pret A Manger,Eating Out,6,601
25,12,2012,Starbucks Coffee,Eating Out,1,600
25,12,2012,ATM Cash Withdrawal,General,10,590
26,12,2012,Wild Bean Cafe,Eating Out,2,588
27,12,2012,Chicken Cottage,Eating Out,7,581
28,12,2012,Morrisons,Groceries,57,524
28,12,2012,Caffe Nero,Eating Out,2,522
28,12,2012,Pret A Manger,Eating Out,8,514
28,12,2012,Anglo restaurant,Eating Out,46,468
29,12,2012,ATM Cash Withdrawal,General,10,458
31,12,2012,South West Trains,Transport,38,420
31,12,2012,Starbucks Coffee,Eating Out,2,418
31,12,2012,ATM Cash Withdrawal,General,10,408
1,1,2013,Rhino Sports salary,General,1700,2108
1,1,2013,Wild Bean Cafe,Eating Out,2,2106
2,1,2013,Chicken Cottage,Eating Out,5,2101
2,1,2013,ATM Cash Withdrawal,General,10,2091
3,1,2013,Wild Bean Cafe,Eating Out,1,2090
3,1,2013,The West Cornwall Pasty Company,Eating Out,7,2083
3,1,2013,ATM Cash Withdrawal,General,20,2063
4,1,2013,ASDA,Groceries,56,2007
4,1,2013,Wild Bean Cafe,Eating Out,1,2006
4,1,2013,McDonalds,Eating Out,4,2002
4,1,2013,Heaven Club,Eating Out,16,1986
4,1,2013,Heaven Club,Eating Out,9,1977
4,1,2013,Heaven Club,Eating Out,11,1966
4,1,2013,Restaurant Gordon RamsayPortland Restaurant,Eating Out,57,1909
5,1,2013,Pizza Express,Eating Out,26,1883
5,1,2013,ATM Cash Withdrawal,General,20,1863
7,1,2013,Cubit and West rent,Rent,550,1313
7,1,2013,South West Trains,Transport,29,1284
7,1,2013,Wild Bean Cafe,Eating Out,2,1282
8,1,2013,Wild Bean Cafe,Eating Out,2,1280
9,1,2013,McDonalds,Eating Out,6,1274
10,1,2013,Starbucks Coffee,Eating Out,1,1273
10,1,2013,Subway,Eating Out,7,1266
10,1,2013,ATM Cash Withdrawal,General,10,1256
11,1,2013,ASDA,Groceries,68,1188
11,1,2013,Caffe Nero,Eating Out,2,1186
11,1,2013,Pret A Manger,Eating Out,8,1178
12,1,2013,ATM Cash Withdrawal,General,10,1168
14,1,2013,South West Trains,Transport,38,1130
14,1,2013,The West Cornwall Pasty Company,Eating Out,7,1123
15,1,2013,BRGAS-Electricity,Bills,42,1081
15,1,2013,BRGAS-Gas,Bills,61,1020
15,1,2013,Starbucks Coffee,Eating Out,2,1018
16,1,2013,LBS Council Tax,Bills,50,968
16,1,2013,Costa Coffee,Eating Out,2,966
16,1,2013,McDonalds,Eating Out,4,962
16,1,2013,ATM Cash Withdrawal,General,10,952
17,1,2013,Costa Coffee,Eating Out,2,950
17,1,2013,McDonalds,Eating Out,5,945
18,1,2013,Tescos,Groceries,63,882
18,1,2013,Costa Coffee,Eating Out,2,880
18,1,2013,Chicken Cottage,Eating Out,8,872
18,1,2013,Restaurant Gordon RamsayPortland Restaurant,Eating Out,44,828
19,1,2013,Scott's Restaurant,Eating Out,40,788
20,1,2013,VIRGIN MEDIA PYMTS,Bills,30,758
20,1,2013,ATM Cash Withdrawal,General,10,748
21,1,2013,South West Trains,Transport,25,723
21,1,2013,Wild Bean Cafe,Eating Out,1,722
21,1,2013,Chicken Cottage,Eating Out,4,718
22,1,2013,Caffe Nero,Eating Out,2,716
22,1,2013,Subway,Eating Out,4,712
23,1,2013,Subway,Eating Out,7,705
23,1,2013,ATM Cash Withdrawal,General,10,695
24,1,2013,O2,Bills,35,660
24,1,2013,Wild Bean Cafe,Eating Out,1,659
25,1,2013,Morrisons,Groceries,45,614
25,1,2013,Starbucks Coffee,Eating Out,2,612
25,1,2013,The West Cornwall Pasty Company,Eating Out,6,606
25,1,2013,Fabric Club,Eating Out,7,599
25,1,2013,Fabric Club,Eating Out,10,589
25,1,2013,Fabric Club,Eating Out,9,580
25,1,2013,Fabric Club,Eating Out,13,567
25,1,2013,Fabric Club,Eating Out,9,558
25,1,2013,Fabric Club,Eating Out,11,547
25,1,2013,Dominos Pizza,Eating Out,33,514
26,1,2013,Anglo restaurant,Eating Out,48,466
28,1,2013,South West Trains,Transport,33,433
28,1,2013,Wild Bean Cafe,Eating Out,1,432
28,1,2013,The West Cornwall Pasty Company,Eating Out,7,425
28,1,2013,ATM Cash Withdrawal,General,10,415
29,1,2013,Costa Coffee,Eating Out,2,413
30,1,2013,Starbucks Coffee,Eating Out,2,411
30,1,2013,ATM Cash Withdrawal,General,20,391
31,1,2013,Starbucks Coffee,Eating Out,1,390
1,2,2013,Rhino Sports salary,General,1700,2090
1,2,2013,ASDA,Groceries,72,2018
1,2,2013,Caffe Nero,Eating Out,2,2016
1,2,2013,Pret A Manger,Eating Out,5,2011
1,2,2013,ATM Cash Withdrawal,General,20,1991
2,2,2013,Dominos Pizza,Eating Out,29,1962
3,2,2013,Pizza Express,Eating Out,39,1923
4,2,2013,South West Trains,Transport,38,1885
4,2,2013,Wild Bean Cafe,Eating Out,2,1883
5,2,2013,Caffe Nero,Eating Out,2,1881
6,2,2013,Starbucks Coffee,Eating Out,2,1879
6,2,2013,McDonalds,Eating Out,6,1873
7,2,2013,Cubit and West rent,Rent,550,1323
7,2,2013,Wild Bean Cafe,Eating Out,2,1321
7,2,2013,ATM Cash Withdrawal,General,10,1311
8,2,2013,Tescos,Groceries,87,1224
8,2,2013,Wild Bean Cafe,Eating Out,1,1223
8,2,2013,Pret A Manger,Eating Out,5,1218
10,2,2013,Anglo restaurant,Eating Out,55,1163
11,2,2013,South West Trains,Transport,34,1129
11,2,2013,Costa Coffee,Eating Out,1,1128
11,2,2013,Greggs,Eating Out,6,1122
11,2,2013,ATM Cash Withdrawal,General,10,1112
12,2,2013,Wild Bean Cafe,Eating Out,2,1110
12,2,2013,Subway,Eating Out,6,1104
13,2,2013,Costa Coffee,Eating Out,2,1102
14,2,2013,Costa Coffee,Eating Out,1,1101
15,2,2013,BRGAS-Electricity,Bills,26,1075
15,2,2013,BRGAS-Gas,Bills,36,1039
15,2,2013,Morrisons,Groceries,88,951
15,2,2013,Caffe Nero,Eating Out,1,950
15,2,2013,Greggs,Eating Out,5,945
15,2,2013,Scott's Restaurant,Eating Out,53,892
16,2,2013,LBS Council Tax,Bills,50,842
17,2,2013,Restaurant Gordon RamsayPortland Restaurant,Eating Out,54,788
17,2,2013,ATM Cash Withdrawal,General,20,768
18,2,2013,South West Trains,Transport,38,730
18,2,2013,Caffe Nero,Eating Out,2,728
19,2,2013,Starbucks Coffee,Eating Out,2,726
19,2,2013,The West Cornwall Pasty Company,Eating Out,5,721
20,2,2013,VIRGIN MEDIA PYMTS,Bills,37,684
20,2,2013,Wild Bean Cafe,Eating Out,1,683
20,2,2013,The West Cornwall Pasty Company,Eating Out,6,677
21,2,2013,Caffe Nero,Eating Out,2,675
22,2,2013,Morrisons,Groceries,77,598
22,2,2013,Costa Coffee,Eating Out,1,597
22,2,2013,ATM Cash Withdrawal,General,10,587
24,2,2013,O2,Bills,35,552
25,2,2013,South West Trains,Transport,25,527
25,2,2013,Caffe Nero,Eating Out,2,525
25,2,2013,Subway,Eating Out,5,520
25,2,2013,ATM Cash Withdrawal,General,20,500
26,2,2013,Greggs,Eating Out,7,493
27,2,2013,Wild Bean Cafe,Eating Out,1,492
27,2,2013,The West Cornwall Pasty Company,Eating Out,4,488
27,2,2013,ATM Cash Withdrawal,General,10,478
28,2,2013,Costa Coffee,Eating Out,1,477
28,2,2013,McDonalds,Eating Out,4,473
28,2,2013,ATM Cash Withdrawal,General,20,453
1,3,2013,Rhino Sports salary,General,1700,2153
1,3,2013,Sainsburys,Groceries,64,2089
1,3,2013,Wild Bean Cafe,Eating Out,2,2087
1,3,2013,Chicken Cottage,Eating Out,4,2083
1,3,2013,Pizza Express,Eating Out,25,2058
2,3,2013,Restaurant Gordon RamsayPortland Restaurant,Eating Out,40,2018
3,3,2013,Anglo restaurant,Eating Out,29,1989
4,3,2013,South West Trains,Transport,24,1965
4,3,2013,Caffe Nero,Eating Out,1,1964
5,3,2013,Subway,Eating Out,7,1957
6,3,2013,Starbucks Coffee,Eating Out,1,1956
7,3,2013,Cubit and West rent,Rent,550,1406
7,3,2013,Starbucks Coffee,Eating Out,2,1404
7,3,2013,McDonalds,Eating Out,7,1397
7,3,2013,ATM Cash Withdrawal,General,10,1387
8,3,2013,Morrisons,Groceries,67,1320
8,3,2013,Chicken Cottage,Eating Out,5,1315
8,3,2013,Scott's Restaurant,Eating Out,36,1279
9,3,2013,Restaurant Gordon RamsayPortland Restaurant,Eating Out,55,1224
10,3,2013,ATM Cash Withdrawal,General,10,1214
11,3,2013,South West Trains,Transport,34,1180
11,3,2013,Wild Bean Cafe,Eating Out,2,1178
11,3,2013,The West Cornwall Pasty Company,Eating Out,8,1170
12,3,2013,Chicken Cottage,Eating Out,8,1162
13,3,2013,Chicken Cottage,Eating Out,8,1154
14,3,2013,The West Cornwall Pasty Company,Eating Out,5,1149
14,3,2013,ATM Cash Withdrawal,General,10,1139
15,3,2013,BRGAS-Electricity,Bills,39,1100
15,3,2013,BRGAS-Gas,Bills,33,1067
15,3,2013,Tescos,Groceries,59,1008
15,3,2013,Wild Bean Cafe,Eating Out,2,1006
15,3,2013,The West Cornwall Pasty Company,Eating Out,7,999
15,3,2013,Scott's Restaurant,Eating Out,50,949
15,3,2013,ATM Cash Withdrawal,General,20,929
16,3,2013,LBS Council Tax,Bills,50,879
16,3,2013,Restaurant Gordon RamsayPortland Restaurant,Eating Out,27,852
17,3,2013,Scott's Restaurant,Eating Out,33,819
17,3,2013,ATM Cash Withdrawal,General,10,809
18,3,2013,South West Trains,Transport,34,775
18,3,2013,Caffe Nero,Eating Out,1,774
18,3,2013,Chicken Cottage,Eating Out,7,767
19,3,2013,Costa Coffee,Eating Out,2,765
19,3,2013,Chicken Cottage,Eating Out,7,758
19,3,2013,ATM Cash Withdrawal,General,10,748
20,3,2013,VIRGIN MEDIA PYMTS,Bills,29,719
20,3,2013,Caffe Nero,Eating Out,2,717
20,3,2013,Subway,Eating Out,6,711
21,3,2013,Costa Coffee,Eating Out,2,709
22,3,2013,Morrisons,Groceries,46,663
22,3,2013,Costa Coffee,Eating Out,1,662
22,3,2013,McDonalds,Eating Out,7,655
22,3,2013,ATM Cash Withdrawal,General,20,635
24,3,2013,O2,Bills,36,599
24,3,2013,ATM Cash Withdrawal,General,10,589
25,3,2013,South West Trains,Transport,31,558
25,3,2013,Costa Coffee,Eating Out,1,557
25,3,2013,Greggs,Eating Out,8,549
26,3,2013,Costa Coffee,Eating Out,2,547
26,3,2013,McDonalds,Eating Out,5,542
27,3,2013,Caffe Nero,Eating Out,1,541
28,3,2013,Costa Coffee,Eating Out,2,539
28,3,2013,Pret A Manger,Eating Out,5,534
28,3,2013,ATM Cash Withdrawal,General,10,524
29,3,2013,ASDA,Groceries,42,482
29,3,2013,Costa Coffee,Eating Out,2,480
29,3,2013,Greggs,Eating Out,7,473
29,3,2013,Pizza Express,Eating Out,46,427
29,3,2013,ATM Cash Withdrawal,General,20,407
30,3,2013,Fabric Club,Eating Out,15,392
30,3,2013,Fabric Club,Eating Out,8,384
30,3,2013,Fabric Club,Eating Out,6,378
30,3,2013,Scott's Restaurant,Eating Out,44,334
1,4,2013,Rhino Sports salary,General,1700,2034
1,4,2013,South West Trains,Transport,30,2004
1,4,2013,Caffe Nero,Eating Out,2,2002
2,4,2013,Subway,Eating Out,8,1994
2,4,2013,ATM Cash Withdrawal,General,10,1984
3,4,2013,Starbucks Coffee,Eating Out,2,1982
4,4,2013,Costa Coffee,Eating Out,1,1981
4,4,2013,ATM Cash Withdrawal,General,20,1961
5,4,2013,ASDA,Groceries,77,1884
5,4,2013,Anglo restaurant,Eating Out,37,1847
5,4,2013,ATM Cash Withdrawal,General,20,1827
7,4,2013,Cubit and West rent,Rent,550,1277
7,4,2013,Dominos Pizza,Eating Out,40,1237
8,4,2013,South West Trains,Transport,24,1213
8,4,2013,Pret A Manger,Eating Out,8,1205
8,4,2013,ATM Cash Withdrawal,General,10,1195
9,4,2013,Starbucks Coffee,Eating Out,1,1194
10,4,2013,Wild Bean Cafe,Eating Out,1,1193
10,4,2013,Pret A Manger,Eating Out,6,1187
11,4,2013,Starbucks Coffee,Eating Out,1,1186
12,4,2013,Sainsburys,Groceries,79,1107
12,4,2013,Starbucks Coffee,Eating Out,1,1106
14,4,2013,ATM Cash Withdrawal,General,10,1096
15,4,2013,BRGAS-Electricity,Bills,33,1063
15,4,2013,BRGAS-Gas,Bills,25,1038
15,4,2013,South West Trains,Transport,32,1006
15,4,2013,Wild Bean Cafe,Eating Out,2,1004
15,4,2013,Subway,Eating Out,8,996
16,4,2013,LBS Council Tax,Bills,50,946
16,4,2013,Starbucks Coffee,Eating Out,2,944
16,4,2013,The West Cornwall Pasty Company,Eating Out,8,936
16,4,2013,ATM Cash Withdrawal,General,20,916
17,4,2013,Starbucks Coffee,Eating Out,2,914
17,4,2013,McDonalds,Eating Out,7,907
17,4,2013,ATM Cash Withdrawal,General,20,887
18,4,2013,Costa Coffee,Eating Out,2,885
18,4,2013,Greggs,Eating Out,6,879
19,4,2013,Waitrose,Groceries,53,826
19,4,2013,Wild Bean Cafe,Eating Out,1,825
19,4,2013,Pret A Manger,Eating Out,5,820
20,4,2013,VIRGIN MEDIA PYMTS,Bills,55,765
20,4,2013,ATM Cash Withdrawal,General,20,745
22,4,2013,South West Trains,Transport,37,708
22,4,2013,Wild Bean Cafe,Eating Out,2,706
22,4,2013,ATM Cash Withdrawal,General,20,686
23,4,2013,Costa Coffee,Eating Out,2,684
24,4,2013,O2,Bills,35,649
24,4,2013,Starbucks Coffee,Eating Out,1,648
24,4,2013,Greggs,Eating Out,5,643
24,4,2013,ATM Cash Withdrawal,General,10,633
25,4,2013,Pret A Manger,Eating Out,7,626
26,4,2013,Sainsburys,Groceries,49,577
26,4,2013,The West Cornwall Pasty Company,Eating Out,6,571
27,4,2013,Pizza Express,Eating Out,33,538
28,4,2013,Dominos Pizza,Eating Out,32,506
29,4,2013,South West Trains,Transport,27,479
29,4,2013,Caffe Nero,Eating Out,2,477
29,4,2013,Greggs,Eating Out,7,470
30,4,2013,Caffe Nero,Eating Out,2,468
30,4,2013,ATM Cash Withdrawal,General,20,448
1,5,2013,Rhino Sports salary,General,1700,2148
1,5,2013,Costa Coffee,Eating Out,2,2146
2,5,2013,Wild Bean Cafe,Eating Out,1,2145
2,5,2013,McDonalds,Eating Out,7,2138
3,5,2013,ASDA,Groceries,88,2050
6,5,2013,South West Trains,Transport,32,2018
6,5,2013,Wild Bean Cafe,Eating Out,2,2016
6,5,2013,Pret A Manger,Eating Out,8,2008
7,5,2013,Cubit and West rent,Rent,550,1458
7,5,2013,Caffe Nero,Eating Out,2,1456
7,5,2013,ATM Cash Withdrawal,General,10,1446
9,5,2013,The West Cornwall Pasty Company,Eating Out,5,1441
10,5,2013,Morrisons,Groceries,82,1359
10,5,2013,Wild Bean Cafe,Eating Out,2,1357
10,5,2013,Heaven Club,Eating Out,5,1352
10,5,2013,Heaven Club,Eating Out,6,1346
10,5,2013,Heaven Club,Eating Out,12,1334
10,5,2013,Heaven Club,Eating Out,14,1320
10,5,2013,Anglo restaurant,Eating Out,29,1291
11,5,2013,Restaurant Gordon RamsayPortland Restaurant,Eating Out,34,1257
13,5,2013,South West Trains,Transport,35,1222
13,5,2013,Starbucks Coffee,Eating Out,2,1220
14,5,2013,Starbucks Coffee,Eating Out,2,1218
15,5,2013,BRGAS-Electricity,Bills,31,1187
15,5,2013,BRGAS-Gas,Bills,22,1165
15,5,2013,The West Cornwall Pasty Company,Eating Out,8,1157
16,5,2013,LBS Council Tax,Bills,50,1107
16,5,2013,Wild Bean Cafe,Eating Out,2,1105
16,5,2013,Subway,Eating Out,5,1100
16,5,2013,ATM Cash Withdrawal,General,10,1090
17,5,2013,Sainsburys,Groceries,75,1015
17,5,2013,Caffe Nero,Eating Out,1,1014
17,5,2013,Pret A Manger,Eating Out,7,1007
18,5,2013,ATM Cash Withdrawal,General,20,987
19,5,2013,Scott's Restaurant,Eating Out,47,940
20,5,2013,VIRGIN MEDIA PYMTS,Bills,41,899
20,5,2013,South West Trains,Transport,30,869
20,5,2013,Starbucks Coffee,Eating Out,2,867
21,5,2013,Wild Bean Cafe,Eating Out,2,865
21,5,2013,Greggs,Eating Out,5,860
22,5,2013,Greggs,Eating Out,5,855
23,5,2013,ATM Cash Withdrawal,General,10,845
24,5,2013,O2,Bills,35,810
24,5,2013,ASDA,Groceries,48,762
24,5,2013,Starbucks Coffee,Eating Out,2,760
24,5,2013,The West Cornwall Pasty Company,Eating Out,4,756
24,5,2013,Pizza Express,Eating Out,41,715
26,5,2013,Pizza Express,Eating Out,51,664
27,5,2013,South West Trains,Transport,31,633
27,5,2013,Caffe Nero,Eating Out,1,632
27,5,2013,The West Cornwall Pasty Company,Eating Out,8,624
28,5,2013,Subway,Eating Out,5,619
29,5,2013,Pret A Manger,Eating Out,4,615
29,5,2013,ATM Cash Withdrawal,General,10,605
30,5,2013,Costa Coffee,Eating Out,2,603
30,5,2013,Pret A Manger,Eating Out,6,597
30,5,2013,ATM Cash Withdrawal,General,10,587
31,5,2013,ASDA,Groceries,45,542
31,5,2013,Chicken Cottage,Eating Out,8,534
31,5,2013,Anglo restaurant,Eating Out,25,509
1,6,2013,Rhino Sports salary,General,1700,2209
2,6,2013,Dominos Pizza,Eating Out,51,2158
3,6,2013,South West Trains,Transport,29,2129
3,6,2013,Caffe Nero,Eating Out,2,2127
3,6,2013,Chicken Cottage,Eating Out,5,2122
3,6,2013,ATM Cash Withdrawal,General,10,2112
4,6,2013,Costa Coffee,Eating Out,2,2110
4,6,2013,Pret A Manger,Eating Out,4,2106
5,6,2013,Subway,Eating Out,7,2099
5,6,2013,ATM Cash Withdrawal,General,20,2079
6,6,2013,Starbucks Coffee,Eating Out,2,2077
7,6,2013,Cubit and West rent,Rent,550,1527
7,6,2013,Tescos,Groceries,77,1450
7,6,2013,Starbucks Coffee,Eating Out,2,1448
7,6,2013,McDonalds,Eating Out,5,1443
8,6,2013,Fabric Club,Eating Out,11,1432
8,6,2013,Fabric Club,Eating Out,9,1423
8,6,2013,Fabric Club,Eating Out,7,1416
8,6,2013,Fabric Club,Eating Out,15,1401
8,6,2013,Fabric Club,Eating Out,11,1390
8,6,2013,Fabric Club,Eating Out,11,1379
8,6,2013,Anglo restaurant,Eating Out,52,1327
9,6,2013,Dominos Pizza,Eating Out,30,1297
9,6,2013,ATM Cash Withdrawal,General,20,1277
10,6,2013,South West Trains,Transport,29,1248
11,6,2013,McDonalds,Eating Out,5,1243
12,6,2013,Costa Coffee,Eating Out,1,1242
12,6,2013,McDonalds,Eating Out,7,1235
13,6,2013,Costa Coffee,Eating Out,2,1233
13,6,2013,The West Cornwall Pasty Company,Eating Out,8,1225
14,6,2013,ASDA,Groceries,58,1167
14,6,2013,Caffe Nero,Eating Out,1,1166
14,6,2013,Subway,Eating Out,5,1161
14,6,2013,Pizza Express,Eating Out,36,1125
15,6,2013,BRGAS-Electricity,Bills,39,1086
15,6,2013,BRGAS-Gas,Bills,44,1042
16,6,2013,LBS Council Tax,Bills,50,992
17,6,2013,South West Trains,Transport,35,957
17,6,2013,Starbucks Coffee,Eating Out,2,955
17,6,2013,Chicken Cottage,Eating Out,6,949
18,6,2013,Costa Coffee,Eating Out,1,948
18,6,2013,Subway,Eating Out,8,940
19,6,2013,Costa Coffee,Eating Out,2,938
19,6,2013,Subway,Eating Out,8,930
20,6,2013,VIRGIN MEDIA PYMTS,Bills,43,887
20,6,2013,Wild Bean Cafe,Eating Out,2,885
21,6,2013,Tescos,Groceries,61,824
21,6,2013,Caffe Nero,Eating Out,1,823
21,6,2013,McDonalds,Eating Out,4,819
21,6,2013,Restaurant Gordon RamsayPortland Restaurant,Eating Out,24,795
22,6,2013,ATM Cash Withdrawal,General,10,785
23,6,2013,Scott's Restaurant,Eating Out,33,752
24,6,2013,O2,Bills,31,721
24,6,2013,South West Trains,Transport,30,691
24,6,2013,Caffe Nero,Eating Out,2,689
24,6,2013,Subway,Eating Out,8,681
25,6,2013,The West Cornwall Pasty Company,Eating Out,6,675
26,6,2013,Subway,Eating Out,7,668
26,6,2013,ATM Cash Withdrawal,General,20,648
27,6,2013,McDonalds,Eating Out,4,644
28,6,2013,Morrisons,Groceries,66,578
28,6,2013,Caffe Nero,Eating Out,2,576
28,6,2013,Greggs,Eating Out,4,572
28,6,2013,Anglo restaurant,Eating Out,50,522
28,6,2013,ATM Cash Withdrawal,General,20,502
29,6,2013,Scott's Restaurant,Eating Out,39,463
1,7,2013,Rhino Sports salary,General,1700,2163
1,7,2013,South West Trains,Transport,33,2130
1,7,2013,Caffe Nero,Eating Out,2,2128
1,7,2013,Chicken Cottage,Eating Out,4,2124
2,7,2013,Starbucks Coffee,Eating Out,2,2122
2,7,2013,Chicken Cottage,Eating Out,5,2117
3,7,2013,Starbucks Coffee,Eating Out,1,2116
3,7,2013,Subway,Eating Out,7,2109
4,7,2013,Costa Coffee,Eating Out,2,2107
4,7,2013,McDonalds,Eating Out,7,2100
5,7,2013,Waitrose,Groceries,71,2029
5,7,2013,Costa Coffee,Eating Out,2,2027
5,7,2013,Chicken Cottage,Eating Out,6,2021
5,7,2013,Heaven Club,Eating Out,5,2016
5,7,2013,Heaven Club,Eating Out,16,2000
5,7,2013,Heaven Club,Eating Out,12,1988
7,7,2013,Cubit and West rent,Rent,550,1438
8,7,2013,South West Trains,Transport,28,1410
8,7,2013,Caffe Nero,Eating Out,2,1408
8,7,2013,The West Cornwall Pasty Company,Eating Out,7,1401
9,7,2013,Wild Bean Cafe,Eating Out,2,1399
9,7,2013,McDonalds,Eating Out,5,1394
10,7,2013,Wild Bean Cafe,Eating Out,1,1393
11,7,2013,Costa Coffee,Eating Out,1,1392
11,7,2013,Pret A Manger,Eating Out,5,1387
12,7,2013,Sainsburys,Groceries,71,1316
12,7,2013,Starbucks Coffee,Eating Out,1,1315
12,7,2013,Chicken Cottage,Eating Out,4,1311
12,7,2013,Anglo restaurant,Eating Out,33,1278
13,7,2013,Restaurant Gordon RamsayPortland Restaurant,Eating Out,28,1250
15,7,2013,BRGAS-Electricity,Bills,34,1216
15,7,2013,BRGAS-Gas,Bills,22,1194
15,7,2013,South West Trains,Transport,31,1163
15,7,2013,Starbucks Coffee,Eating Out,1,1162
15,7,2013,Pret A Manger,Eating Out,6,1156
15,7,2013,ATM Cash Withdrawal,General,20,1136
16,7,2013,LBS Council Tax,Bills,50,1086
16,7,2013,Wild Bean Cafe,Eating Out,2,1084
17,7,2013,Wild Bean Cafe,Eating Out,1,1083
17,7,2013,The West Cornwall Pasty Company,Eating Out,8,1075
18,7,2013,Caffe Nero,Eating Out,1,1074
18,7,2013,Subway,Eating Out,4,1070
18,7,2013,ATM Cash Withdrawal,General,20,1050
19,7,2013,Morrisons,Groceries,70,980
19,7,2013,Wild Bean Cafe,Eating Out,2,978
20,7,2013,VIRGIN MEDIA PYMTS,Bills,50,928
20,7,2013,ATM Cash Withdrawal,General,10,918
21,7,2013,Dominos Pizza,Eating Out,29,889
22,7,2013,South West Trains,Transport,26,863
22,7,2013,Wild Bean Cafe,Eating Out,1,862
23,7,2013,Wild Bean Cafe,Eating Out,2,860
23,7,2013,Pret A Manger,Eating Out,6,854
23,7,2013,ATM Cash Withdrawal,General,10,844
24,7,2013,O2,Bills,32,812
24,7,2013,The West Cornwall Pasty Company,Eating Out,6,806
25,7,2013,Costa Coffee,Eating Out,2,804
25,7,2013,Pret A Manger,Eating Out,5,799
26,7,2013,Waitrose,Groceries,50,749
26,7,2013,The West Cornwall Pasty Company,Eating Out,5,744
27,7,2013,Dominos Pizza,Eating Out,41,703
27,7,2013,ATM Cash Withdrawal,General,10,693
29,7,2013,South West Trains,Transport,31,662
30,7,2013,Caffe Nero,Eating Out,1,661
30,7,2013,Chicken Cottage,Eating Out,6,655
31,7,2013,Costa Coffee,Eating Out,1,654
1,8,2013,Rhino Sports salary,General,1700,2354
1,8,2013,Starbucks Coffee,Eating Out,1,2353
1,8,2013,The West Cornwall Pasty Company,Eating Out,5,2348
2,8,2013,Morrisons,Groceries,77,2271
2,8,2013,Wild Bean Cafe,Eating Out,1,2270
2,8,2013,Pret A Manger,Eating Out,4,2266
2,8,2013,Anglo restaurant,Eating Out,25,2241
3,8,2013,ATM Cash Withdrawal,General,10,2231
4,8,2013,Anglo restaurant,Eating Out,54,2177
5,8,2013,South West Trains,Transport,29,2148
5,8,2013,Starbucks Coffee,Eating Out,2,2146
5,8,2013,The West Cornwall Pasty Company,Eating Out,6,2140
5,8,2013,ATM Cash Withdrawal,General,10,2130
6,8,2013,Costa Coffee,Eating Out,2,2128
6,8,2013,Subway,Eating Out,8,2120
7,8,2013,Cubit and West rent,Rent,550,1570
7,8,2013,Caffe Nero,Eating Out,2,1568
7,8,2013,McDonalds,Eating Out,7,1561
8,8,2013,The West Cornwall Pasty Company,Eating Out,7,1554
9,8,2013,ASDA,Groceries,84,1470
9,8,2013,Wild Bean Cafe,Eating Out,2,1468
11,8,2013,Restaurant Gordon RamsayPortland Restaurant,Eating Out,52,1416
12,8,2013,South West Trains,Transport,26,1390
12,8,2013,Wild Bean Cafe,Eating Out,2,1388
12,8,2013,McDonalds,Eating Out,7,1381
13,8,2013,Caffe Nero,Eating Out,1,1380
13,8,2013,ATM Cash Withdrawal,General,20,1360
15,8,2013,BRGAS-Electricity,Bills,24,1336
15,8,2013,BRGAS-Gas,Bills,22,1314
15,8,2013,Caffe Nero,Eating Out,1,1313
16,8,2013,LBS Council Tax,Bills,50,1263
16,8,2013,Tescos,Groceries,43,1220
16,8,2013,Caffe Nero,Eating Out,1,1219
19,8,2013,South West Trains,Transport,37,1182
19,8,2013,Wild Bean Cafe,Eating Out,1,1181
19,8,2013,McDonalds,Eating Out,5,1176
20,8,2013,VIRGIN MEDIA PYMTS,Bills,36,1140
20,8,2013,Caffe Nero,Eating Out,2,1138
21,8,2013,Caffe Nero,Eating Out,2,1136
21,8,2013,McDonalds,Eating Out,8,1128
21,8,2013,ATM Cash Withdrawal,General,20,1108
22,8,2013,Costa Coffee,Eating Out,2,1106
22,8,2013,Subway,Eating Out,8,1098
23,8,2013,Morrisons,Groceries,62,1036
23,8,2013,Wild Bean Cafe,Eating Out,2,1034
23,8,2013,The West Cornwall Pasty Company,Eating Out,4,1030
23,8,2013,ATM Cash Withdrawal,General,10,1020
24,8,2013,O2,Bills,37,983
24,8,2013,Ministry of Sound ClubXOYO Club,Eating Out,6,977
24,8,2013,Ministry of Sound ClubXOYO Club,Eating Out,16,961
24,8,2013,Ministry of Sound ClubXOYO Club,Eating Out,5,956
24,8,2013,Ministry of Sound ClubXOYO Club,Eating Out,10,946
24,8,2013,Ministry of Sound ClubXOYO Club,Eating Out,15,931
24,8,2013,Ministry of Sound ClubXOYO Club,Eating Out,12,919
24,8,2013,Restaurant Gordon RamsayPortland Restaurant,Eating Out,50,869
24,8,2013,ATM Cash Withdrawal,General,10,859
26,8,2013,South West Trains,Transport,29,830
26,8,2013,Starbucks Coffee,Eating Out,1,829
26,8,2013,ATM Cash Withdrawal,General,10,819
27,8,2013,Starbucks Coffee,Eating Out,1,818
27,8,2013,Chicken Cottage,Eating Out,4,814
28,8,2013,Wild Bean Cafe,Eating Out,1,813
28,8,2013,Pret A Manger,Eating Out,5,808
28,8,2013,ATM Cash Withdrawal,General,20,788
29,8,2013,Wild Bean Cafe,Eating Out,1,787
29,8,2013,Subway,Eating Out,6,781
29,8,2013,ATM Cash Withdrawal,General,20,761
30,8,2013,Waitrose,Groceries,67,694
30,8,2013,Wild Bean Cafe,Eating Out,2,692
30,8,2013,Greggs,Eating Out,5,687
31,8,2013,The Grand Pub,Eating Out,9,678
31,8,2013,The Grand Pub,Eating Out,10,668
31,8,2013,Pizza Express,Eating Out,41,627
1,9,2013,Rhino Sports salary,General,1700,2327
1,9,2013,Dominos Pizza,Eating Out,32,2295
2,9,2013,South West Trains,Transport,34,2261
2,9,2013,Costa Coffee,Eating Out,2,2259
2,9,2013,ATM Cash Withdrawal,General,20,2239
3,9,2013,Starbucks Coffee,Eating Out,2,2237
4,9,2013,Costa Coffee,Eating Out,1,2236
5,9,2013,Starbucks Coffee,Eating Out,2,2234
5,9,2013,Pret A Manger,Eating Out,7,2227
6,9,2013,Sainsburys,Groceries,83,2144
6,9,2013,Caffe Nero,Eating Out,2,2142
6,9,2013,McDonalds,Eating Out,6,2136
6,9,2013,The Grand Pub,Eating Out,6,2130
6,9,2013,The Grand Pub,Eating Out,6,2124
6,9,2013,The Grand Pub,Eating Out,7,2117
6,9,2013,The Grand Pub,Eating Out,11,2106
6,9,2013,The Grand Pub,Eating Out,16,2090
6,9,2013,The Grand Pub,Eating Out,11,2079
6,9,2013,Anglo restaurant,Eating Out,34,2045
7,9,2013,Cubit and West rent,Rent,550,1495
8,9,2013,Restaurant Gordon RamsayPortland Restaurant,Eating Out,32,1463
9,9,2013,South West Trains,Transport,33,1430
10,9,2013,Wild Bean Cafe,Eating Out,2,1428
10,9,2013,Pret A Manger,Eating Out,4,1424
11,9,2013,Caffe Nero,Eating Out,2,1422
11,9,2013,McDonalds,Eating Out,7,1415
11,9,2013,ATM Cash Withdrawal,General,20,1395
12,9,2013,Wild Bean Cafe,Eating Out,1,1394
13,9,2013,ASDA,Groceries,75,1319
13,9,2013,Wild Bean Cafe,Eating Out,2,1317
13,9,2013,Greggs,Eating Out,5,1312
13,9,2013,Anglo restaurant,Eating Out,26,1286
13,9,2013,ATM Cash Withdrawal,General,20,1266
14,9,2013,ATM Cash Withdrawal,General,10,1256
15,9,2013,BRGAS-Electricity,Bills,42,1214
15,9,2013,BRGAS-Gas,Bills,43,1171
16,9,2013,LBS Council Tax,Bills,50,1121
16,9,2013,South West Trains,Transport,38,1083
16,9,2013,Starbucks Coffee,Eating Out,2,1081
16,9,2013,Greggs,Eating Out,6,1075
17,9,2013,Costa Coffee,Eating Out,1,1074
17,9,2013,Subway,Eating Out,6,1068
17,9,2013,ATM Cash Withdrawal,General,20,1048
18,9,2013,ATM Cash Withdrawal,General,10,1038
19,9,2013,Caffe Nero,Eating Out,1,1037
19,9,2013,Greggs,Eating Out,5,1032
20,9,2013,VIRGIN MEDIA PYMTS,Bills,30,1002
20,9,2013,Sainsburys,Groceries,73,929
20,9,2013,Wild Bean Cafe,Eating Out,1,928
20,9,2013,McDonalds,Eating Out,6,922
20,9,2013,Anglo restaurant,Eating Out,27,895
21,9,2013,Pizza Express,Eating Out,41,854
23,9,2013,South West Trains,Transport,26,828
23,9,2013,Costa Coffee,Eating Out,1,827
23,9,2013,Greggs,Eating Out,7,820
23,9,2013,ATM Cash Withdrawal,General,10,810
24,9,2013,O2,Bills,31,779
24,9,2013,Costa Coffee,Eating Out,1,778
24,9,2013,Greggs,Eating Out,4,774
24,9,2013,ATM Cash Withdrawal,General,10,764
25,9,2013,Subway,Eating Out,8,756
26,9,2013,Caffe Nero,Eating Out,2,754
26,9,2013,The West Cornwall Pasty Company,Eating Out,4,750
26,9,2013,ATM Cash Withdrawal,General,10,740
27,9,2013,Waitrose,Groceries,80,660
27,9,2013,Costa Coffee,Eating Out,2,658
27,9,2013,Subway,Eating Out,5,653
27,9,2013,Restaurant Gordon RamsayPortland Restaurant,Eating Out,38,615
28,9,2013,Dominos Pizza,Eating Out,27,588
30,9,2013,South West Trains,Transport,27,561
30,9,2013,Starbucks Coffee,Eating Out,2,559
30,9,2013,Pret A Manger,Eating Out,4,555
30,9,2013,ATM Cash Withdrawal,General,10,545
1,10,2013,Rhino Sports salary,General,1700,2245
1,10,2013,Chicken Cottage,Eating Out,4,2241
2,10,2013,Wild Bean Cafe,Eating Out,2,2239
3,10,2013,Chicken Cottage,Eating Out,6,2233
4,10,2013,Morrisons,Groceries,75,2158
4,10,2013,Starbucks Coffee,Eating Out,1,2157
4,10,2013,McDonalds,Eating Out,4,2153
5,10,2013,Scott's Restaurant,Eating Out,51,2102
7,10,2013,Cubit and West rent,Rent,550,1552
7,10,2013,South West Trains,Transport,34,1518
7,10,2013,Caffe Nero,Eating Out,2,1516
7,10,2013,Pret A Manger,Eating Out,4,1512
8,10,2013,Subway,Eating Out,8,1504
9,10,2013,Wild Bean Cafe,Eating Out,2,1502
9,10,2013,ATM Cash Withdrawal,General,10,1492
10,10,2013,Caffe Nero,Eating Out,2,1490
10,10,2013,McDonalds,Eating Out,8,1482
11,10,2013,Waitrose,Groceries,71,1411
11,10,2013,Wild Bean Cafe,Eating Out,1,1410
11,10,2013,ATM Cash Withdrawal,General,20,1390
12,10,2013,Scott's Restaurant,Eating Out,53,1337
13,10,2013,Pizza Express,Eating Out,58,1279
14,10,2013,South West Trains,Transport,27,1252
14,10,2013,Caffe Nero,Eating Out,2,1250
15,10,2013,BRGAS-Electricity,Bills,28,1222
15,10,2013,BRGAS-Gas,Bills,32,1190
15,10,2013,Starbucks Coffee,Eating Out,2,1188
15,10,2013,The West Cornwall Pasty Company,Eating Out,8,1180
16,10,2013,LBS Council Tax,Bills,50,1130
16,10,2013,Starbucks Coffee,Eating Out,2,1128
17,10,2013,Wild Bean Cafe,Eating Out,2,1126
17,10,2013,Pret A Manger,Eating Out,4,1122
18,10,2013,Tescos,Groceries,87,1035
18,10,2013,Caffe Nero,Eating Out,1,1034
18,10,2013,McDonalds,Eating Out,5,1029
19,10,2013,ATM Cash Withdrawal,General,20,1009
20,10,2013,VIRGIN MEDIA PYMTS,Bills,48,961
20,10,2013,Scott's Restaurant,Eating Out,26,935
20,10,2013,ATM Cash Withdrawal,General,20,915
21,10,2013,South West Trains,Transport,26,889
21,10,2013,Caffe Nero,Eating Out,1,888
21,10,2013,McDonalds,Eating Out,6,882
21,10,2013,ATM Cash Withdrawal,General,20,862
22,10,2013,Caffe Nero,Eating Out,2,860
22,10,2013,Chicken Cottage,Eating Out,6,854
23,10,2013,Wild Bean Cafe,Eating Out,2,852
23,10,2013,ATM Cash Withdrawal,General,20,832
24,10,2013,O2,Bills,32,800
24,10,2013,Costa Coffee,Eating Out,2,798
24,10,2013,Chicken Cottage,Eating Out,7,791
24,10,2013,ATM Cash Withdrawal,General,10,781
25,10,2013,Morrisons,Groceries,47,734
25,10,2013,Wild Bean Cafe,Eating Out,2,732
25,10,2013,McDonalds,Eating Out,6,726
28,10,2013,South West Trains,Transport,31,695
28,10,2013,Caffe Nero,Eating Out,2,693
28,10,2013,The West Cornwall Pasty Company,Eating Out,6,687
29,10,2013,Costa Coffee,Eating Out,1,686
29,10,2013,ATM Cash Withdrawal,General,20,666
30,10,2013,Wild Bean Cafe,Eating Out,2,664
31,10,2013,Starbucks Coffee,Eating Out,2,662
1,11,2013,Rhino Sports salary,General,1700,2362
1,11,2013,Morrisons,Groceries,55,2307
1,11,2013,Wild Bean Cafe,Eating Out,2,2305
1,11,2013,Subway,Eating Out,8,2297
1,11,2013,Dominos Pizza,Eating Out,30,2267
2,11,2013,The Grand Pub,Eating Out,7,2260
2,11,2013,The Grand Pub,Eating Out,5,2255
2,11,2013,The Grand Pub,Eating Out,7,2248
2,11,2013,The Grand Pub,Eating Out,12,2236
2,11,2013,Anglo restaurant,Eating Out,50,2186
2,11,2013,ATM Cash Withdrawal,General,20,2166
4,11,2013,South West Trains,Transport,29,2137
4,11,2013,Wild Bean Cafe,Eating Out,1,2136
5,11,2013,Costa Coffee,Eating Out,2,2134
5,11,2013,The West Cornwall Pasty Company,Eating Out,7,2127
6,11,2013,Starbucks Coffee,Eating Out,1,2126
7,11,2013,Cubit and West rent,Rent,550,1576
7,11,2013,Caffe Nero,Eating Out,2,1574
8,11,2013,Tescos,Groceries,49,1525
8,11,2013,Caffe Nero,Eating Out,1,1524
8,11,2013,Restaurant Gordon RamsayPortland Restaurant,Eating Out,59,1465
11,11,2013,South West Trains,Transport,36,1429
11,11,2013,Caffe Nero,Eating Out,1,1428
12,11,2013,Costa Coffee,Eating Out,2,1426
13,11,2013,Caffe Nero,Eating Out,2,1424
14,11,2013,Starbucks Coffee,Eating Out,2,1422
14,11,2013,Subway,Eating Out,5,1417
15,11,2013,BRGAS-Electricity,Bills,43,1374
15,11,2013,BRGAS-Gas,Bills,44,1330
15,11,2013,Tescos,Groceries,77,1253
15,11,2013,The West Cornwall Pasty Company,Eating Out,6,1247
16,11,2013,LBS Council Tax,Bills,50,1197
16,11,2013,The Grand Pub,Eating Out,14,1183
16,11,2013,The Grand Pub,Eating Out,16,1167
16,11,2013,Anglo restaurant,Eating Out,34,1133
16,11,2013,ATM Cash Withdrawal,General,20,1113
17,11,2013,ATM Cash Withdrawal,General,20,1093
18,11,2013,South West Trains,Transport,34,1059
18,11,2013,Wild Bean Cafe,Eating Out,1,1058
18,11,2013,Pret A Manger,Eating Out,6,1052
19,11,2013,Costa Coffee,Eating Out,2,1050
19,11,2013,McDonalds,Eating Out,5,1045
20,11,2013,VIRGIN MEDIA PYMTS,Bills,31,1014
20,11,2013,Starbucks Coffee,Eating Out,1,1013
20,11,2013,Subway,Eating Out,4,1009
21,11,2013,Costa Coffee,Eating Out,2,1007
21,11,2013,The West Cornwall Pasty Company,Eating Out,7,1000
22,11,2013,ASDA,Groceries,45,955
22,11,2013,Chicken Cottage,Eating Out,6,949
22,11,2013,Fabric Club,Eating Out,16,933
22,11,2013,ATM Cash Withdrawal,General,10,923
23,11,2013,Restaurant Gordon RamsayPortland Restaurant,Eating Out,24,899
24,11,2013,O2,Bills,33,866
24,11,2013,ATM Cash Withdrawal,General,20,846
25,11,2013,South West Trains,Transport,30,816
25,11,2013,Caffe Nero,Eating Out,1,815
25,11,2013,Chicken Cottage,Eating Out,4,811
26,11,2013,Caffe Nero,Eating Out,2,809
26,11,2013,Chicken Cottage,Eating Out,6,803
26,11,2013,ATM Cash Withdrawal,General,10,793
27,11,2013,Caffe Nero,Eating Out,2,791
27,11,2013,Greggs,Eating Out,5,786
28,11,2013,Wild Bean Cafe,Eating Out,2,784
29,11,2013,ASDA,Groceries,76,708
29,11,2013,Costa Coffee,Eating Out,1,707
29,11,2013,Chicken Cottage,Eating Out,5,702
29,11,2013,Scott's Restaurant,Eating Out,52,650
30,11,2013,Heaven Club,Eating Out,8,642
30,11,2013,Heaven Club,Eating Out,8,634
1,12,2013,Rhino Sports salary,General,1700,2334
1,12,2013,ATM Cash Withdrawal,General,20,2314
2,12,2013,South West Trains,Transport,28,2286
2,12,2013,Starbucks Coffee,Eating Out,2,2284
2,12,2013,Greggs,Eating Out,4,2280
3,12,2013,Starbucks Coffee,Eating Out,2,2278
3,12,2013,Subway,Eating Out,8,2270
3,12,2013,ATM Cash Withdrawal,General,20,2250
4,12,2013,Costa Coffee,Eating Out,2,2248
5,12,2013,Costa Coffee,Eating Out,1,2247
5,12,2013,The West Cornwall Pasty Company,Eating Out,8,2239
6,12,2013,Morrisons,Groceries,65,2174
6,12,2013,The West Cornwall Pasty Company,Eating Out,6,2168
6,12,2013,The Grand Pub,Eating Out,6,2162
6,12,2013,The Grand Pub,Eating Out,6,2156
6,12,2013,The Grand Pub,Eating Out,6,2150
6,12,2013,The Grand Pub,Eating Out,13,2137
6,12,2013,The Grand Pub,Eating Out,9,2128
6,12,2013,The Grand Pub,Eating Out,8,2120
7,12,2013,Cubit and West rent,Rent,550,1570
8,12,2013,Anglo restaurant,Eating Out,24,1546
9,12,2013,South West Trains,Transport,33,1513
9,12,2013,Wild Bean Cafe,Eating Out,2,1511
9,12,2013,The West Cornwall Pasty Company,Eating Out,5,1506
10,12,2013,Costa Coffee,Eating Out,2,1504
10,12,2013,Pret A Manger,Eating Out,6,1498
11,12,2013,Wild Bean Cafe,Eating Out,1,1497
11,12,2013,Chicken Cottage,Eating Out,5,1492
11,12,2013,ATM Cash Withdrawal,General,20,1472
12,12,2013,Costa Coffee,Eating Out,1,1471
12,12,2013,The West Cornwall Pasty Company,Eating Out,5,1466
13,12,2013,ASDA,Groceries,53,1413
13,12,2013,Costa Coffee,Eating Out,1,1412
13,12,2013,Pret A Manger,Eating Out,8,1404
13,12,2013,Scott's Restaurant,Eating Out,34,1370
14,12,2013,Scott's Restaurant,Eating Out,56,1314
14,12,2013,ATM Cash Withdrawal,General,10,1304
15,12,2013,BRGAS-Electricity,Bills,21,1283
15,12,2013,BRGAS-Gas,Bills,29,1254
15,12,2013,ATM Cash Withdrawal,General,10,1244
16,12,2013,LBS Council Tax,Bills,50,1194
16,12,2013,South West Trains,Transport,30,1164
16,12,2013,Wild Bean Cafe,Eating Out,2,1162
16,12,2013,Chicken Cottage,Eating Out,5,1157
17,12,2013,Caffe Nero,Eating Out,1,1156
17,12,2013,Pret A Manger,Eating Out,4,1152
18,12,2013,Caffe Nero,Eating Out,2,1150
18,12,2013,ATM Cash Withdrawal,General,20,1130
19,12,2013,Costa Coffee,Eating Out,2,1128
19,12,2013,The West Cornwall Pasty Company,Eating Out,8,1120
20,12,2013,VIRGIN MEDIA PYMTS,Bills,38,1082
20,12,2013,Sainsburys,Groceries,82,1000
20,12,2013,Wild Bean Cafe,Eating Out,2,998
20,12,2013,McDonalds,Eating Out,4,994
20,12,2013,ATM Cash Withdrawal,General,20,974
21,12,2013,ATM Cash Withdrawal,General,20,954
22,12,2013,Dominos Pizza,Eating Out,53,901
23,12,2013,South West Trains,Transport,37,864
23,12,2013,Wild Bean Cafe,Eating Out,2,862
23,12,2013,Subway,Eating Out,8,854
24,12,2013,O2,Bills,36,818
25,12,2013,Wild Bean Cafe,Eating Out,1,817
26,12,2013,Starbucks Coffee,Eating Out,1,816
26,12,2013,Greggs,Eating Out,4,812
27,12,2013,Sainsburys,Groceries,63,749
27,12,2013,Starbucks Coffee,Eating Out,1,748
27,12,2013,Subway,Eating Out,5,743
28,12,2013,ATM Cash Withdrawal,General,10,733
29,12,2013,ATM Cash Withdrawal,General,20,713
30,12,2013,South West Trains,Transport,33,680
30,12,2013,Starbucks Coffee,Eating Out,1,679
31,12,2013,Subway,Eating Out,8,671
1,1,2014,Rhino Sports salary,General,1700,2371
1,1,2014,The West Cornwall Pasty Company,Eating Out,4,2367
2,1,2014,Wild Bean Cafe,Eating Out,2,2365
2,1,2014,McDonalds,Eating Out,4,2361
3,1,2014,Tescos,Groceries,64,2297
6,1,2014,South West Trains,Transport,33,2264
6,1,2014,Subway,Eating Out,8,2256
7,1,2014,Cubit and West rent,Rent,550,1706
7,1,2014,Caffe Nero,Eating Out,1,1705
7,1,2014,Subway,Eating Out,5,1700
8,1,2014,McDonalds,Eating Out,5,1695
10,1,2014,Sainsburys,Groceries,77,1618
10,1,2014,McDonalds,Eating Out,4,1614
11,1,2014,Restaurant Gordon RamsayPortland Restaurant,Eating Out,24,1590
12,1,2014,ATM Cash Withdrawal,General,20,1570
13,1,2014,South West Trains,Transport,32,1538
13,1,2014,Starbucks Coffee,Eating Out,2,1536
13,1,2014,Subway,Eating Out,4,1532
13,1,2014,ATM Cash Withdrawal,General,10,1522
14,1,2014,Wild Bean Cafe,Eating Out,2,1520
14,1,2014,Subway,Eating Out,7,1513
15,1,2014,BRGAS-Electricity,Bills,90,1423
15,1,2014,BRGAS-Gas,Bills,81,1342
15,1,2014,Wild Bean Cafe,Eating Out,1,1341
15,1,2014,McDonalds,Eating Out,8,1333
15,1,2014,ATM Cash Withdrawal,General,10,1323
16,1,2014,LBS Council Tax,Bills,50,1273
16,1,2014,Caffe Nero,Eating Out,2,1271
17,1,2014,Tescos,Groceries,42,1229
17,1,2014,Starbucks Coffee,Eating Out,1,1228
17,1,2014,Anglo restaurant,Eating Out,37,1191
18,1,2014,Fabric Club,Eating Out,11,1180
18,1,2014,Fabric Club,Eating Out,9,1171
20,1,2014,VIRGIN MEDIA PYMTS,Bills,57,1114
20,1,2014,South West Trains,Transport,31,1083
20,1,2014,Caffe Nero,Eating Out,1,1082
21,1,2014,Wild Bean Cafe,Eating Out,1,1081
22,1,2014,Starbucks Coffee,Eating Out,1,1080
22,1,2014,The West Cornwall Pasty Company,Eating Out,6,1074
22,1,2014,ATM Cash Withdrawal,General,20,1054
23,1,2014,Wild Bean Cafe,Eating Out,2,1052
23,1,2014,The West Cornwall Pasty Company,Eating Out,7,1045
24,1,2014,O2,Bills,37,1008
24,1,2014,ASDA,Groceries,56,952
24,1,2014,Costa Coffee,Eating Out,2,950
24,1,2014,Greggs,Eating Out,6,944
25,1,2014,The Grand Pub,Eating Out,16,928
25,1,2014,The Grand Pub,Eating Out,11,917
25,1,2014,The Grand Pub,Eating Out,9,908
25,1,2014,The Grand Pub,Eating Out,9,899
25,1,2014,The Grand Pub,Eating Out,8,891
25,1,2014,Scott's Restaurant,Eating Out,52,839
26,1,2014,Pizza Express,Eating Out,46,793
27,1,2014,South West Trains,Transport,38,755
27,1,2014,Starbucks Coffee,Eating Out,2,753
27,1,2014,ATM Cash Withdrawal,General,10,743
28,1,2014,Starbucks Coffee,Eating Out,2,741
28,1,2014,Pret A Manger,Eating Out,4,737
29,1,2014,Costa Coffee,Eating Out,2,735
29,1,2014,Pret A Manger,Eating Out,8,727
30,1,2014,Wild Bean Cafe,Eating Out,2,725
30,1,2014,McDonalds,Eating Out,7,718
31,1,2014,Sainsburys,Groceries,66,652
31,1,2014,Starbucks Coffee,Eating Out,2,650
31,1,2014,Chicken Cottage,Eating Out,4,646
31,1,2014,Fabric Club,Eating Out,14,632
31,1,2014,Fabric Club,Eating Out,11,621
31,1,2014,Fabric Club,Eating Out,5,616
31,1,2014,Anglo restaurant,Eating Out,44,572
1,2,2014,Rhino Sports salary,General,1700,2272
1,2,2014,Ministry of Sound ClubXOYO Club,Eating Out,16,2256
1,2,2014,Ministry of Sound ClubXOYO Club,Eating Out,16,2240
1,2,2014,Ministry of Sound ClubXOYO Club,Eating Out,14,2226
1,2,2014,Ministry of Sound ClubXOYO Club,Eating Out,12,2214
1,2,2014,Ministry of Sound ClubXOYO Club,Eating Out,8,2206
1,2,2014,Ministry of Sound ClubXOYO Club,Eating Out,7,2199
2,2,2014,Scott's Restaurant,Eating Out,37,2162
3,2,2014,South West Trains,Transport,29,2133
3,2,2014,Costa Coffee,Eating Out,1,2132
3,2,2014,ATM Cash Withdrawal,General,10,2122
4,2,2014,Costa Coffee,Eating Out,2,2120
5,2,2014,Wild Bean Cafe,Eating Out,2,2118
6,2,2014,Wild Bean Cafe,Eating Out,2,2116
7,2,2014,Cubit and West rent,Rent,550,1566
7,2,2014,ASDA,Groceries,87,1479
7,2,2014,Costa Coffee,Eating Out,2,1477
7,2,2014,McDonalds,Eating Out,6,1471
8,2,2014,ATM Cash Withdrawal,General,10,1461
10,2,2014,South West Trains,Transport,26,1435
10,2,2014,Starbucks Coffee,Eating Out,2,1433
11,2,2014,Costa Coffee,Eating Out,1,1432
12,2,2014,Starbucks Coffee,Eating Out,2,1430
13,2,2014,Chicken Cottage,Eating Out,5,1425
14,2,2014,Sainsburys,Groceries,45,1380
15,2,2014,BRGAS-Electricity,Bills,28,1352
15,2,2014,BRGAS-Gas,Bills,34,1318
15,2,2014,Fabric Club,Eating Out,15,1303
15,2,2014,Fabric Club,Eating Out,5,1298
15,2,2014,Fabric Club,Eating Out,6,1292
15,2,2014,Fabric Club,Eating Out,5,1287
16,2,2014,LBS Council Tax,Bills,50,1237
17,2,2014,South West Trains,Transport,25,1212
18,2,2014,Greggs,Eating Out,5,1207
19,2,2014,Starbucks Coffee,Eating Out,1,1206
19,2,2014,Chicken Cottage,Eating Out,8,1198
20,2,2014,VIRGIN MEDIA PYMTS,Bills,36,1162
20,2,2014,ATM Cash Withdrawal,General,20,1142
21,2,2014,Morrisons,Groceries,77,1065
21,2,2014,Costa Coffee,Eating Out,2,1063
21,2,2014,The Grand Pub,Eating Out,7,1056
21,2,2014,The Grand Pub,Eating Out,13,1043
21,2,2014,The Grand Pub,Eating Out,6,1037
21,2,2014,The Grand Pub,Eating Out,6,1031
21,2,2014,The Grand Pub,Eating Out,16,1015
21,2,2014,Scott's Restaurant,Eating Out,52,963
21,2,2014,ATM Cash Withdrawal,General,10,953
22,2,2014,Heaven Club,Eating Out,15,938
22,2,2014,Heaven Club,Eating Out,7,931
22,2,2014,Anglo restaurant,Eating Out,35,896
22,2,2014,ATM Cash Withdrawal,General,20,876
23,2,2014,Pizza Express,Eating Out,28,848
23,2,2014,ATM Cash Withdrawal,General,10,838
24,2,2014,O2,Bills,32,806
24,2,2014,South West Trains,Transport,29,777
24,2,2014,Caffe Nero,Eating Out,2,775
24,2,2014,Chicken Cottage,Eating Out,6,769
25,2,2014,The West Cornwall Pasty Company,Eating Out,5,764
26,2,2014,Wild Bean Cafe,Eating Out,2,762
26,2,2014,Chicken Cottage,Eating Out,7,755
27,2,2014,Costa Coffee,Eating Out,1,754
28,2,2014,ASDA,Groceries,84,670
28,2,2014,Starbucks Coffee,Eating Out,2,668
28,2,2014,Subway,Eating Out,7,661
28,2,2014,Ministry of Sound ClubXOYO Club,Eating Out,7,654
28,2,2014,Ministry of Sound ClubXOYO Club,Eating Out,10,644
28,2,2014,Ministry of Sound ClubXOYO Club,Eating Out,16,628
28,2,2014,Ministry of Sound ClubXOYO Club,Eating Out,10,618
1,3,2014,Rhino Sports salary,General,1700,2318
1,3,2014,ATM Cash Withdrawal,General,10,2308
2,3,2014,ATM Cash Withdrawal,General,20,2288
3,3,2014,South West Trains,Transport,33,2255
3,3,2014,Chicken Cottage,Eating Out,5,2250
4,3,2014,Caffe Nero,Eating Out,2,2248
4,3,2014,Pret A Manger,Eating Out,6,2242
5,3,2014,Caffe Nero,Eating Out,1,2241
5,3,2014,The West Cornwall Pasty Company,Eating Out,6,2235
6,3,2014,Caffe Nero,Eating Out,1,2234
6,3,2014,McDonalds,Eating Out,6,2228
7,3,2014,Cubit and West rent,Rent,550,1678
7,3,2014,ASDA,Groceries,78,1600
7,3,2014,Costa Coffee,Eating Out,1,1599
7,3,2014,Greggs,Eating Out,6,1593
7,3,2014,Fabric Club,Eating Out,9,1584
7,3,2014,ATM Cash Withdrawal,General,20,1564
8,3,2014,Ministry of Sound ClubXOYO Club,Eating Out,14,1550
8,3,2014,Ministry of Sound ClubXOYO Club,Eating Out,7,1543
8,3,2014,Ministry of Sound ClubXOYO Club,Eating Out,12,1531
8,3,2014,Ministry of Sound ClubXOYO Club,Eating Out,5,1526
8,3,2014,ATM Cash Withdrawal,General,20,1506
9,3,2014,Scott's Restaurant,Eating Out,41,1465
10,3,2014,South West Trains,Transport,28,1437
10,3,2014,McDonalds,Eating Out,5,1432
11,3,2014,McDonalds,Eating Out,7,1425
12,3,2014,Wild Bean Cafe,Eating Out,2,1423
12,3,2014,Subway,Eating Out,4,1419
12,3,2014,ATM Cash Withdrawal,General,10,1409
13,3,2014,Starbucks Coffee,Eating Out,1,1408
13,3,2014,McDonalds,Eating Out,8,1400
13,3,2014,ATM Cash Withdrawal,General,20,1380
14,3,2014,Sainsburys,Groceries,48,1332
14,3,2014,Costa Coffee,Eating Out,2,1330
15,3,2014,BRGAS-Electricity,Bills,23,1307
15,3,2014,BRGAS-Gas,Bills,23,1284
16,3,2014,LBS Council Tax,Bills,50,1234
16,3,2014,ATM Cash Withdrawal,General,10,1224
17,3,2014,South West Trains,Transport,34,1190
17,3,2014,McDonalds,Eating Out,7,1183
18,3,2014,Costa Coffee,Eating Out,2,1181
19,3,2014,Wild Bean Cafe,Eating Out,2,1179
19,3,2014,ATM Cash Withdrawal,General,20,1159
20,3,2014,VIRGIN MEDIA PYMTS,Bills,33,1126
20,3,2014,Chicken Cottage,Eating Out,5,1121
20,3,2014,ATM Cash Withdrawal,General,20,1101
21,3,2014,Morrisons,Groceries,74,1027
21,3,2014,McDonalds,Eating Out,5,1022
21,3,2014,ATM Cash Withdrawal,General,20,1002
24,3,2014,O2,Bills,31,971
24,3,2014,South West Trains,Transport,29,942
24,3,2014,Starbucks Coffee,Eating Out,2,940
25,3,2014,Caffe Nero,Eating Out,1,939
25,3,2014,Pret A Manger,Eating Out,7,932
25,3,2014,ATM Cash Withdrawal,General,10,922
26,3,2014,Chicken Cottage,Eating Out,4,918
27,3,2014,Starbucks Coffee,Eating Out,2,916
27,3,2014,Pret A Manger,Eating Out,5,911
28,3,2014,Morrisons,Groceries,79,832
28,3,2014,Wild Bean Cafe,Eating Out,2,830
28,3,2014,Greggs,Eating Out,5,825
29,3,2014,Pizza Express,Eating Out,58,767
30,3,2014,ATM Cash Withdrawal,General,10,757
31,3,2014,South West Trains,Transport,26,731
31,3,2014,Costa Coffee,Eating Out,2,729
31,3,2014,Pret A Manger,Eating Out,6,723
31,3,2014,ATM Cash Withdrawal,General,10,713
1,4,2014,Rhino Sports salary,General,1700,2413
1,4,2014,Greggs,Eating Out,4,2409
2,4,2014,Caffe Nero,Eating Out,2,2407
2,4,2014,Chicken Cottage,Eating Out,7,2400
3,4,2014,ATM Cash Withdrawal,General,20,2380
4,4,2014,ASDA,Groceries,70,2310
4,4,2014,Restaurant Gordon RamsayPortland Restaurant,Eating Out,48,2262
5,4,2014,Fabric Club,Eating Out,9,2253
5,4,2014,Fabric Club,Eating Out,15,2238
5,4,2014,Fabric Club,Eating Out,12,2226
5,4,2014,Scott's Restaurant,Eating Out,52,2174
7,4,2014,Cubit and West rent,Rent,550,1624
7,4,2014,South West Trains,Transport,32,1592
7,4,2014,Caffe Nero,Eating Out,1,1591
7,4,2014,Pret A Manger,Eating Out,8,1583
8,4,2014,McDonalds,Eating Out,4,1579
9,4,2014,Caffe Nero,Eating Out,2,1577
9,4,2014,The West Cornwall Pasty Company,Eating Out,5,1572
10,4,2014,Costa Coffee,Eating Out,2,1570
10,4,2014,Subway,Eating Out,7,1563
11,4,2014,Tescos,Groceries,64,1499
11,4,2014,Caffe Nero,Eating Out,2,1497
11,4,2014,Subway,Eating Out,6,1491
11,4,2014,ATM Cash Withdrawal,General,20,1471
12,4,2014,Scott's Restaurant,Eating Out,26,1445
12,4,2014,ATM Cash Withdrawal,General,20,1425
13,4,2014,ATM Cash Withdrawal,General,10,1415
14,4,2014,South West Trains,Transport,24,1391
14,4,2014,Starbucks Coffee,Eating Out,1,1390
14,4,2014,Subway,Eating Out,6,1384
15,4,2014,BRGAS-Electricity,Bills,37,1347
15,4,2014,BRGAS-Gas,Bills,43,1304
15,4,2014,Greggs,Eating Out,4,1300
15,4,2014,ATM Cash Withdrawal,General,10,1290
16,4,2014,LBS Council Tax,Bills,50,1240
16,4,2014,Caffe Nero,Eating Out,1,1239
16,4,2014,Chicken Cottage,Eating Out,5,1234
17,4,2014,Starbucks Coffee,Eating Out,1,1233
17,4,2014,Subway,Eating Out,4,1229
18,4,2014,Tescos,Groceries,77,1152
18,4,2014,Starbucks Coffee,Eating Out,2,1150
18,4,2014,Pret A Manger,Eating Out,8,1142
19,4,2014,The Grand Pub,Eating Out,13,1129
19,4,2014,The Grand Pub,Eating Out,10,1119
19,4,2014,The Grand Pub,Eating Out,15,1104
19,4,2014,The Grand Pub,Eating Out,9,1095
19,4,2014,The Grand Pub,Eating Out,12,1083
19,4,2014,The Grand Pub,Eating Out,5,1078
20,4,2014,VIRGIN MEDIA PYMTS,Bills,42,1036
20,4,2014,Dominos Pizza,Eating Out,41,995
21,4,2014,South West Trains,Transport,28,967
21,4,2014,Caffe Nero,Eating Out,1,966
21,4,2014,Subway,Eating Out,8,958
22,4,2014,Wild Bean Cafe,Eating Out,2,956
22,4,2014,Subway,Eating Out,5,951
23,4,2014,Caffe Nero,Eating Out,2,949
24,4,2014,O2,Bills,35,914
24,4,2014,Starbucks Coffee,Eating Out,2,912
24,4,2014,Greggs,Eating Out,8,904
25,4,2014,ASDA,Groceries,61,843
25,4,2014,Subway,Eating Out,8,835
25,4,2014,Scott's Restaurant,Eating Out,24,811
28,4,2014,South West Trains,Transport,30,781
28,4,2014,ATM Cash Withdrawal,General,20,761
29,4,2014,Greggs,Eating Out,5,756
30,4,2014,Greggs,Eating Out,5,751
1,5,2014,Rhino Sports salary,General,1700,2451
1,5,2014,Starbucks Coffee,Eating Out,2,2449
1,5,2014,Subway,Eating Out,8,2441
2,5,2014,Tescos,Groceries,85,2356
2,5,2014,Starbucks Coffee,Eating Out,2,2354
2,5,2014,McDonalds,Eating Out,5,2349
2,5,2014,Pizza Express,Eating Out,57,2292
4,5,2014,ATM Cash Withdrawal,General,20,2272
5,5,2014,South West Trains,Transport,32,2240
5,5,2014,Starbucks Coffee,Eating Out,2,2238
6,5,2014,Caffe Nero,Eating Out,1,2237
6,5,2014,Greggs,Eating Out,5,2232
7,5,2014,Cubit and West rent,Rent,550,1682
7,5,2014,Wild Bean Cafe,Eating Out,2,1680
7,5,2014,McDonalds,Eating Out,6,1674
8,5,2014,Costa Coffee,Eating Out,2,1672
8,5,2014,ATM Cash Withdrawal,General,10,1662
9,5,2014,Sainsburys,Groceries,70,1592
9,5,2014,Costa Coffee,Eating Out,1,1591
9,5,2014,Subway,Eating Out,8,1583
9,5,2014,Dominos Pizza,Eating Out,32,1551
10,5,2014,The Grand Pub,Eating Out,15,1536
10,5,2014,The Grand Pub,Eating Out,16,1520
10,5,2014,The Grand Pub,Eating Out,15,1505
10,5,2014,The Grand Pub,Eating Out,9,1496
12,5,2014,South West Trains,Transport,30,1466
12,5,2014,Starbucks Coffee,Eating Out,1,1465
12,5,2014,ATM Cash Withdrawal,General,10,1455
13,5,2014,Caffe Nero,Eating Out,2,1453
13,5,2014,Pret A Manger,Eating Out,5,1448
14,5,2014,Costa Coffee,Eating Out,2,1446
15,5,2014,BRGAS-Electricity,Bills,30,1416
15,5,2014,BRGAS-Gas,Bills,42,1374
15,5,2014,Costa Coffee,Eating Out,2,1372
15,5,2014,Chicken Cottage,Eating Out,6,1366
16,5,2014,LBS Council Tax,Bills,50,1316
16,5,2014,Sainsburys,Groceries,85,1231
16,5,2014,Starbucks Coffee,Eating Out,1,1230
16,5,2014,Pret A Manger,Eating Out,7,1223
16,5,2014,Restaurant Gordon RamsayPortland Restaurant,Eating Out,25,1198
17,5,2014,ATM Cash Withdrawal,General,10,1188
19,5,2014,South West Trains,Transport,31,1157
19,5,2014,Pret A Manger,Eating Out,8,1149
20,5,2014,VIRGIN MEDIA PYMTS,Bills,52,1097
20,5,2014,Caffe Nero,Eating Out,1,1096
21,5,2014,Wild Bean Cafe,Eating Out,1,1095
21,5,2014,Chicken Cottage,Eating Out,8,1087
21,5,2014,ATM Cash Withdrawal,General,10,1077
22,5,2014,Wild Bean Cafe,Eating Out,2,1075
22,5,2014,Subway,Eating Out,7,1068
22,5,2014,ATM Cash Withdrawal,General,10,1058
23,5,2014,Tescos,Groceries,53,1005
23,5,2014,Wild Bean Cafe,Eating Out,2,1003
23,5,2014,Pret A Manger,Eating Out,5,998
23,5,2014,Dominos Pizza,Eating Out,33,965
24,5,2014,O2,Bills,38,927
25,5,2014,Dominos Pizza,Eating Out,36,891
26,5,2014,South West Trains,Transport,30,861
26,5,2014,Starbucks Coffee,Eating Out,2,859
26,5,2014,McDonalds,Eating Out,6,853
26,5,2014,ATM Cash Withdrawal,General,20,833
27,5,2014,Costa Coffee,Eating Out,2,831
28,5,2014,Costa Coffee,Eating Out,1,830
28,5,2014,Chicken Cottage,Eating Out,5,825
29,5,2014,Wild Bean Cafe,Eating Out,2,823
29,5,2014,Greggs,Eating Out,5,818
30,5,2014,ASDA,Groceries,82,736
30,5,2014,Greggs,Eating Out,4,732
31,5,2014,Restaurant Gordon RamsayPortland Restaurant,Eating Out,56,676
1,6,2014,Rhino Sports salary,General,1700,2376
1,6,2014,Scott's Restaurant,Eating Out,55,2321
1,6,2014,ATM Cash Withdrawal,General,20,2301
2,6,2014,South West Trains,Transport,37,2264
2,6,2014,Wild Bean Cafe,Eating Out,2,2262
2,6,2014,McDonalds,Eating Out,5,2257
3,6,2014,Starbucks Coffee,Eating Out,2,2255
3,6,2014,McDonalds,Eating Out,5,2250
5,6,2014,ATM Cash Withdrawal,General,10,2240
6,6,2014,Tescos,Groceries,84,2156
6,6,2014,Costa Coffee,Eating Out,2,2154
7,6,2014,Cubit and West rent,Rent,550,1604
7,6,2014,Restaurant Gordon RamsayPortland Restaurant,Eating Out,55,1549
8,6,2014,ATM Cash Withdrawal,General,10,1539
9,6,2014,South West Trains,Transport,36,1503
9,6,2014,Subway,Eating Out,8,1495
9,6,2014,ATM Cash Withdrawal,General,20,1475
10,6,2014,Starbucks Coffee,Eating Out,2,1473
10,6,2014,Chicken Cottage,Eating Out,5,1468
11,6,2014,Starbucks Coffee,Eating Out,2,1466
11,6,2014,The West Cornwall Pasty Company,Eating Out,6,1460
12,6,2014,Starbucks Coffee,Eating Out,2,1458
13,6,2014,Tescos,Groceries,69,1389
13,6,2014,Wild Bean Cafe,Eating Out,1,1388
13,6,2014,Subway,Eating Out,6,1382
14,6,2014,Fabric Club,Eating Out,5,1377
14,6,2014,Fabric Club,Eating Out,7,1370
14,6,2014,Fabric Club,Eating Out,12,1358
15,6,2014,BRGAS-Electricity,Bills,41,1317
15,6,2014,BRGAS-Gas,Bills,26,1291
15,6,2014,Scott's Restaurant,Eating Out,59,1232
16,6,2014,LBS Council Tax,Bills,50,1182
16,6,2014,South West Trains,Transport,25,1157
16,6,2014,Wild Bean Cafe,Eating Out,1,1156
16,6,2014,The West Cornwall Pasty Company,Eating Out,5,1151
17,6,2014,Costa Coffee,Eating Out,2,1149
17,6,2014,McDonalds,Eating Out,7,1142
18,6,2014,Wild Bean Cafe,Eating Out,1,1141
19,6,2014,Chicken Cottage,Eating Out,7,1134
20,6,2014,VIRGIN MEDIA PYMTS,Bills,57,1077
20,6,2014,Morrisons,Groceries,66,1011
20,6,2014,Caffe Nero,Eating Out,1,1010
20,6,2014,McDonalds,Eating Out,6,1004
21,6,2014,The Grand Pub,Eating Out,15,989
21,6,2014,The Grand Pub,Eating Out,8,981
21,6,2014,The Grand Pub,Eating Out,13,968
21,6,2014,The Grand Pub,Eating Out,6,962
21,6,2014,The Grand Pub,Eating Out,16,946
21,6,2014,The Grand Pub,Eating Out,7,939
23,6,2014,South West Trains,Transport,38,901
23,6,2014,Wild Bean Cafe,Eating Out,2,899
24,6,2014,O2,Bills,35,864
24,6,2014,Chicken Cottage,Eating Out,5,859
25,6,2014,Pret A Manger,Eating Out,5,854
25,6,2014,ATM Cash Withdrawal,General,20,834
26,6,2014,Greggs,Eating Out,8,826
27,6,2014,Waitrose,Groceries,62,764
27,6,2014,Starbucks Coffee,Eating Out,1,763
27,6,2014,The West Cornwall Pasty Company,Eating Out,6,757
27,6,2014,Dominos Pizza,Eating Out,30,727
27,6,2014,ATM Cash Withdrawal,General,20,707
28,6,2014,ATM Cash Withdrawal,General,10,697
29,6,2014,ATM Cash Withdrawal,General,20,677
30,6,2014,South West Trains,Transport,38,639
30,6,2014,Costa Coffee,Eating Out,2,637
30,6,2014,The West Cornwall Pasty Company,Eating Out,5,632
1,7,2014,Rhino Sports salary,General,1700,2332
1,7,2014,Caffe Nero,Eating Out,1,2331
2,7,2014,Caffe Nero,Eating Out,2,2329
2,7,2014,McDonalds,Eating Out,7,2322
3,7,2014,Caffe Nero,Eating Out,1,2321
3,7,2014,ATM Cash Withdrawal,General,20,2301
4,7,2014,Tescos,Groceries,60,2241
4,7,2014,Caffe Nero,Eating Out,1,2240
4,7,2014,The West Cornwall Pasty Company,Eating Out,6,2234
5,7,2014,The Grand Pub,Eating Out,14,2220
5,7,2014,The Grand Pub,Eating Out,15,2205
5,7,2014,The Grand Pub,Eating Out,6,2199
5,7,2014,The Grand Pub,Eating Out,16,2183
5,7,2014,Dominos Pizza,Eating Out,50,2133
6,7,2014,ATM Cash Withdrawal,General,10,2123
7,7,2014,Cubit and West rent,Rent,550,1573
7,7,2014,South West Trains,Transport,27,1546
7,7,2014,Chicken Cottage,Eating Out,8,1538
8,7,2014,Costa Coffee,Eating Out,2,1536
8,7,2014,Pret A Manger,Eating Out,5,1531
8,7,2014,ATM Cash Withdrawal,General,20,1511
9,7,2014,Costa Coffee,Eating Out,1,1510
10,7,2014,The West Cornwall Pasty Company,Eating Out,8,1502
11,7,2014,Tescos,Groceries,72,1430
11,7,2014,Greggs,Eating Out,7,1423
11,7,2014,Dominos Pizza,Eating Out,37,1386
11,7,2014,ATM Cash Withdrawal,General,10,1376
12,7,2014,Restaurant Gordon RamsayPortland Restaurant,Eating Out,51,1325
14,7,2014,South West Trains,Transport,35,1290
14,7,2014,Wild Bean Cafe,Eating Out,2,1288
14,7,2014,Greggs,Eating Out,5,1283
15,7,2014,BRGAS-Electricity,Bills,22,1261
15,7,2014,BRGAS-Gas,Bills,38,1223
15,7,2014,Wild Bean Cafe,Eating Out,2,1221
15,7,2014,Subway,Eating Out,8,1213
15,7,2014,ATM Cash Withdrawal,General,20,1193
16,7,2014,LBS Council Tax,Bills,50,1143
16,7,2014,Costa Coffee,Eating Out,2,1141
17,7,2014,Caffe Nero,Eating Out,2,1139
17,7,2014,McDonalds,Eating Out,8,1131
18,7,2014,Tescos,Groceries,66,1065
18,7,2014,Wild Bean Cafe,Eating Out,2,1063
20,7,2014,VIRGIN MEDIA PYMTS,Bills,38,1025
21,7,2014,South West Trains,Transport,37,988
22,7,2014,Wild Bean Cafe,Eating Out,2,986
24,7,2014,O2,Bills,33,953
24,7,2014,Starbucks Coffee,Eating Out,2,951
24,7,2014,ATM Cash Withdrawal,General,20,931
25,7,2014,Sainsburys,Groceries,42,889
25,7,2014,Starbucks Coffee,Eating Out,1,888
25,7,2014,The Grand Pub,Eating Out,10,878
25,7,2014,The Grand Pub,Eating Out,7,871
25,7,2014,The Grand Pub,Eating Out,11,860
25,7,2014,The Grand Pub,Eating Out,7,853
27,7,2014,Pizza Express,Eating Out,57,796
28,7,2014,South West Trains,Transport,33,763
28,7,2014,Subway,Eating Out,5,758
28,7,2014,ATM Cash Withdrawal,General,20,738
29,7,2014,Costa Coffee,Eating Out,2,736
29,7,2014,Pret A Manger,Eating Out,6,730
30,7,2014,Caffe Nero,Eating Out,2,728
30,7,2014,ATM Cash Withdrawal,General,20,708
31,7,2014,Wild Bean Cafe,Eating Out,2,706
31,7,2014,McDonalds,Eating Out,8,698
31,7,2014,ATM Cash Withdrawal,General,10,688
1,8,2014,Rhino Sports salary,General,1700,2388
1,8,2014,Morrisons,Groceries,80,2308
1,8,2014,Costa Coffee,Eating Out,2,2306
1,8,2014,Restaurant Gordon RamsayPortland Restaurant,Eating Out,40,2266
2,8,2014,ATM Cash Withdrawal,General,20,2246
3,8,2014,Scott's Restaurant,Eating Out,38,2208
3,8,2014,ATM Cash Withdrawal,General,10,2198
4,8,2014,South West Trains,Transport,35,2163
4,8,2014,Starbucks Coffee,Eating Out,2,2161
5,8,2014,Costa Coffee,Eating Out,2,2159
6,8,2014,Costa Coffee,Eating Out,2,2157
6,8,2014,The West Cornwall Pasty Company,Eating Out,8,2149
6,8,2014,ATM Cash Withdrawal,General,10,2139
7,8,2014,Cubit and West rent,Rent,550,1589
7,8,2014,Starbucks Coffee,Eating Out,2,1587
7,8,2014,McDonalds,Eating Out,8,1579
8,8,2014,Sainsburys,Groceries,59,1520
8,8,2014,Costa Coffee,Eating Out,1,1519
8,8,2014,Fabric Club,Eating Out,15,1504
8,8,2014,Fabric Club,Eating Out,9,1495
8,8,2014,Fabric Club,Eating Out,11,1484
8,8,2014,Fabric Club,Eating Out,5,1479
9,8,2014,ATM Cash Withdrawal,General,10,1469
10,8,2014,Dominos Pizza,Eating Out,34,1435
11,8,2014,South West Trains,Transport,30,1405
12,8,2014,Wild Bean Cafe,Eating Out,1,1404
12,8,2014,The West Cornwall Pasty Company,Eating Out,6,1398
13,8,2014,Wild Bean Cafe,Eating Out,1,1397
13,8,2014,Chicken Cottage,Eating Out,8,1389
13,8,2014,ATM Cash Withdrawal,General,10,1379
14,8,2014,Costa Coffee,Eating Out,2,1377
14,8,2014,ATM Cash Withdrawal,General,10,1367
15,8,2014,BRGAS-Electricity,Bills,27,1340
15,8,2014,BRGAS-Gas,Bills,22,1318
15,8,2014,Sainsburys,Groceries,47,1271
15,8,2014,McDonalds,Eating Out,8,1263
15,8,2014,Restaurant Gordon RamsayPortland Restaurant,Eating Out,56,1207
16,8,2014,LBS Council Tax,Bills,50,1157
16,8,2014,Ministry of Sound ClubXOYO Club,Eating Out,16,1141
16,8,2014,Ministry of Sound ClubXOYO Club,Eating Out,14,1127
16,8,2014,Ministry of Sound ClubXOYO Club,Eating Out,8,1119
16,8,2014,Ministry of Sound ClubXOYO Club,Eating Out,12,1107
16,8,2014,Ministry of Sound ClubXOYO Club,Eating Out,14,1093
16,8,2014,Dominos Pizza,Eating Out,36,1057
18,8,2014,South West Trains,Transport,38,1019
19,8,2014,ATM Cash Withdrawal,General,20,999
20,8,2014,VIRGIN MEDIA PYMTS,Bills,33,966
20,8,2014,Wild Bean Cafe,Eating Out,2,964
20,8,2014,The West Cornwall Pasty Company,Eating Out,4,960
20,8,2014,ATM Cash Withdrawal,General,20,940
21,8,2014,Chicken Cottage,Eating Out,7,933
22,8,2014,Waitrose,Groceries,69,864
22,8,2014,Costa Coffee,Eating Out,2,862
22,8,2014,The West Cornwall Pasty Company,Eating Out,5,857
22,8,2014,The Grand Pub,Eating Out,13,844
22,8,2014,The Grand Pub,Eating Out,5,839
22,8,2014,The Grand Pub,Eating Out,8,831
22,8,2014,The Grand Pub,Eating Out,12,819
22,8,2014,The Grand Pub,Eating Out,9,810
22,8,2014,The Grand Pub,Eating Out,16,794
23,8,2014,ATM Cash Withdrawal,General,10,784
24,8,2014,O2,Bills,33,751
24,8,2014,Restaurant Gordon RamsayPortland Restaurant,Eating Out,53,698
25,8,2014,South West Trains,Transport,30,668
25,8,2014,Wild Bean Cafe,Eating Out,2,666
25,8,2014,Pret A Manger,Eating Out,5,661
25,8,2014,ATM Cash Withdrawal,General,10,651
26,8,2014,Caffe Nero,Eating Out,2,649
26,8,2014,Subway,Eating Out,7,642
27,8,2014,Subway,Eating Out,6,636
28,8,2014,Caffe Nero,Eating Out,2,634
28,8,2014,Chicken Cottage,Eating Out,7,627
29,8,2014,Morrisons,Groceries,70,557
29,8,2014,Wild Bean Cafe,Eating Out,2,555
29,8,2014,McDonalds,Eating Out,4,551
29,8,2014,ATM Cash Withdrawal,General,20,531
1,9,2014,Rhino Sports salary,General,1700,2231
1,9,2014,South West Trains,Transport,34,2197
1,9,2014,Starbucks Coffee,Eating Out,1,2196
1,9,2014,McDonalds,Eating Out,6,2190
1,9,2014,ATM Cash Withdrawal,General,10,2180
2,9,2014,Greggs,Eating Out,6,2174
3,9,2014,Wild Bean Cafe,Eating Out,1,2173
3,9,2014,ATM Cash Withdrawal,General,10,2163
4,9,2014,Starbucks Coffee,Eating Out,2,2161
4,9,2014,Pret A Manger,Eating Out,7,2154
4,9,2014,ATM Cash Withdrawal,General,10,2144
5,9,2014,Sainsburys,Groceries,50,2094
5,9,2014,Wild Bean Cafe,Eating Out,1,2093
5,9,2014,Chicken Cottage,Eating Out,5,2088
5,9,2014,ATM Cash Withdrawal,General,20,2068
7,9,2014,Cubit and West rent,Rent,550,1518
7,9,2014,Restaurant Gordon RamsayPortland Restaurant,Eating Out,46,1472
7,9,2014,ATM Cash Withdrawal,General,20,1452
8,9,2014,South West Trains,Transport,35,1417
8,9,2014,Subway,Eating Out,7,1410
8,9,2014,ATM Cash Withdrawal,General,20,1390
9,9,2014,Wild Bean Cafe,Eating Out,2,1388
9,9,2014,ATM Cash Withdrawal,General,20,1368
10,9,2014,Caffe Nero,Eating Out,2,1366
10,9,2014,McDonalds,Eating Out,4,1362
11,9,2014,Caffe Nero,Eating Out,2,1360
11,9,2014,Greggs,Eating Out,7,1353
11,9,2014,ATM Cash Withdrawal,General,10,1343
12,9,2014,Waitrose,Groceries,74,1269
12,9,2014,Caffe Nero,Eating Out,2,1267
12,9,2014,Chicken Cottage,Eating Out,5,1262
12,9,2014,Fabric Club,Eating Out,16,1246
12,9,2014,Fabric Club,Eating Out,12,1234
12,9,2014,Fabric Club,Eating Out,7,1227
12,9,2014,Fabric Club,Eating Out,12,1215
12,9,2014,Restaurant Gordon RamsayPortland Restaurant,Eating Out,30,1185
14,9,2014,Dominos Pizza,Eating Out,44,1141
15,9,2014,BRGAS-Electricity,Bills,32,1109
15,9,2014,BRGAS-Gas,Bills,42,1067
15,9,2014,South West Trains,Transport,35,1032
15,9,2014,Costa Coffee,Eating Out,2,1030
16,9,2014,LBS Council Tax,Bills,50,980
16,9,2014,Costa Coffee,Eating Out,2,978
16,9,2014,The West Cornwall Pasty Company,Eating Out,6,972
17,9,2014,Caffe Nero,Eating Out,2,970
17,9,2014,Pret A Manger,Eating Out,5,965
18,9,2014,Starbucks Coffee,Eating Out,1,964
19,9,2014,ASDA,Groceries,86,878
19,9,2014,Starbucks Coffee,Eating Out,2,876
19,9,2014,Chicken Cottage,Eating Out,8,868
20,9,2014,VIRGIN MEDIA PYMTS,Bills,37,831
20,9,2014,Pizza Express,Eating Out,58,773
21,9,2014,ATM Cash Withdrawal,General,20,753
22,9,2014,South West Trains,Transport,25,728
23,9,2014,Starbucks Coffee,Eating Out,2,726
23,9,2014,Pret A Manger,Eating Out,5,721
24,9,2014,O2,Bills,32,689
24,9,2014,Costa Coffee,Eating Out,2,687
24,9,2014,Chicken Cottage,Eating Out,6,681
25,9,2014,Caffe Nero,Eating Out,1,680
25,9,2014,Greggs,Eating Out,8,672
25,9,2014,ATM Cash Withdrawal,General,20,652
26,9,2014,Waitrose,Groceries,47,605
26,9,2014,Chicken Cottage,Eating Out,8,597
26,9,2014,Dominos Pizza,Eating Out,56,541
27,9,2014,Anglo restaurant,Eating Out,42,499
28,9,2014,Restaurant Gordon RamsayPortland Restaurant,Eating Out,59,440
28,9,2014,ATM Cash Withdrawal,General,10,430
29,9,2014,South West Trains,Transport,32,398
29,9,2014,Costa Coffee,Eating Out,1,397
29,9,2014,Pret A Manger,Eating Out,8,389
29,9,2014,ATM Cash Withdrawal,General,20,369
30,9,2014,Starbucks Coffee,Eating Out,2,367
1,10,2014,Rhino Sports salary,General,1700,2067
1,10,2014,Wild Bean Cafe,Eating Out,2,2065
1,10,2014,Subway,Eating Out,8,2057
2,10,2014,Wild Bean Cafe,Eating Out,2,2055
2,10,2014,Greggs,Eating Out,8,2047
3,10,2014,Tescos,Groceries,47,2000
3,10,2014,Starbucks Coffee,Eating Out,2,1998
3,10,2014,Pizza Express,Eating Out,35,1963
4,10,2014,ATM Cash Withdrawal,General,10,1953
6,10,2014,South West Trains,Transport,33,1920
6,10,2014,Starbucks Coffee,Eating Out,2,1918
6,10,2014,Chicken Cottage,Eating Out,7,1911
6,10,2014,ATM Cash Withdrawal,General,10,1901
7,10,2014,Cubit and West rent,Rent,550,1351
7,10,2014,Starbucks Coffee,Eating Out,1,1350
7,10,2014,McDonalds,Eating Out,6,1344
8,10,2014,Starbucks Coffee,Eating Out,2,1342
8,10,2014,The West Cornwall Pasty Company,Eating Out,7,1335
9,10,2014,Pret A Manger,Eating Out,8,1327
9,10,2014,ATM Cash Withdrawal,General,10,1317
10,10,2014,Waitrose,Groceries,56,1261
10,10,2014,Costa Coffee,Eating Out,2,1259
11,10,2014,ATM Cash Withdrawal,General,10,1249
12,10,2014,ATM Cash Withdrawal,General,20,1229
13,10,2014,South West Trains,Transport,38,1191
13,10,2014,Wild Bean Cafe,Eating Out,2,1189
13,10,2014,Greggs,Eating Out,8,1181
14,10,2014,Starbucks Coffee,Eating Out,1,1180
14,10,2014,Subway,Eating Out,7,1173
15,10,2014,BRGAS-Electricity,Bills,38,1135
15,10,2014,BRGAS-Gas,Bills,35,1100
15,10,2014,Caffe Nero,Eating Out,2,1098
16,10,2014,LBS Council Tax,Bills,50,1048
16,10,2014,Costa Coffee,Eating Out,2,1046
16,10,2014,The West Cornwall Pasty Company,Eating Out,5,1041
16,10,2014,ATM Cash Withdrawal,General,20,1021
17,10,2014,ASDA,Groceries,74,947
17,10,2014,ATM Cash Withdrawal,General,20,927
18,10,2014,Anglo restaurant,Eating Out,52,875
19,10,2014,Scott's Restaurant,Eating Out,43,832
20,10,2014,VIRGIN MEDIA PYMTS,Bills,36,796
20,10,2014,South West Trains,Transport,31,765
20,10,2014,Caffe Nero,Eating Out,2,763
20,10,2014,Subway,Eating Out,6,757
21,10,2014,Wild Bean Cafe,Eating Out,2,755
21,10,2014,ATM Cash Withdrawal,General,20,735
22,10,2014,Costa Coffee,Eating Out,1,734
23,10,2014,Caffe Nero,Eating Out,1,733
23,10,2014,The West Cornwall Pasty Company,Eating Out,7,726
23,10,2014,ATM Cash Withdrawal,General,10,716
24,10,2014,O2,Bills,33,683
24,10,2014,ASDA,Groceries,81,602
24,10,2014,Pizza Express,Eating Out,26,576
25,10,2014,Ministry of Sound ClubXOYO Club,Eating Out,13,563
25,10,2014,ATM Cash Withdrawal,General,10,553
26,10,2014,ATM Cash Withdrawal,General,10,543
27,10,2014,South West Trains,Transport,37,506
27,10,2014,Costa Coffee,Eating Out,1,505
27,10,2014,Greggs,Eating Out,6,499
28,10,2014,Caffe Nero,Eating Out,2,497
28,10,2014,Subway,Eating Out,5,492
28,10,2014,ATM Cash Withdrawal,General,10,482
29,10,2014,Costa Coffee,Eating Out,2,480
29,10,2014,ATM Cash Withdrawal,General,20,460
30,10,2014,Pret A Manger,Eating Out,7,453
30,10,2014,ATM Cash Withdrawal,General,20,433
31,10,2014,Tescos,Groceries,86,347
31,10,2014,Starbucks Coffee,Eating Out,1,346
31,10,2014,Pizza Express,Eating Out,31,315
1,11,2014,Rhino Sports salary,General,1700,2015
1,11,2014,Restaurant Gordon RamsayPortland Restaurant,Eating Out,39,1976
1,11,2014,ATM Cash Withdrawal,General,10,1966
2,11,2014,Anglo restaurant,Eating Out,33,1933
2,11,2014,ATM Cash Withdrawal,General,20,1913
3,11,2014,South West Trains,Transport,35,1878
3,11,2014,Starbucks Coffee,Eating Out,2,1876
4,11,2014,Starbucks Coffee,Eating Out,2,1874
4,11,2014,ATM Cash Withdrawal,General,20,1854
5,11,2014,Chicken Cottage,Eating Out,5,1849
6,11,2014,Wild Bean Cafe,Eating Out,2,1847
6,11,2014,The West Cornwall Pasty Company,Eating Out,4,1843
7,11,2014,Cubit and West rent,Rent,550,1293
7,11,2014,Tescos,Groceries,68,1225
7,11,2014,Costa Coffee,Eating Out,1,1224
7,11,2014,Heaven Club,Eating Out,15,1209
7,11,2014,Heaven Club,Eating Out,7,1202
7,11,2014,Heaven Club,Eating Out,14,1188
7,11,2014,Heaven Club,Eating Out,14,1174
7,11,2014,Dominos Pizza,Eating Out,56,1118
8,11,2014,Restaurant Gordon RamsayPortland Restaurant,Eating Out,56,1062
9,11,2014,Pizza Express,Eating Out,31,1031
10,11,2014,South West Trains,Transport,31,1000
10,11,2014,Starbucks Coffee,Eating Out,2,998
10,11,2014,Chicken Cottage,Eating Out,8,990
11,11,2014,Caffe Nero,Eating Out,1,989
11,11,2014,The West Cornwall Pasty Company,Eating Out,4,985
12,11,2014,Pret A Manger,Eating Out,5,980
12,11,2014,ATM Cash Withdrawal,General,20,960
13,11,2014,Starbucks Coffee,Eating Out,1,959
13,11,2014,Pret A Manger,Eating Out,6,953
14,11,2014,Morrisons,Groceries,88,865
14,11,2014,Wild Bean Cafe,Eating Out,1,864
15,11,2014,BRGAS-Electricity,Bills,29,835
15,11,2014,BRGAS-Gas,Bills,62,773
15,11,2014,ATM Cash Withdrawal,General,20,753
16,11,2014,LBS Council Tax,Bills,50,703
16,11,2014,Scott's Restaurant,Eating Out,35,668
17,11,2014,South West Trains,Transport,35,633
17,11,2014,Starbucks Coffee,Eating Out,1,632
17,11,2014,Chicken Cottage,Eating Out,6,626
17,11,2014,ATM Cash Withdrawal,General,10,616
18,11,2014,Costa Coffee,Eating Out,2,614
18,11,2014,Subway,Eating Out,4,610
19,11,2014,Costa Coffee,Eating Out,1,609
19,11,2014,The West Cornwall Pasty Company,Eating Out,5,604
20,11,2014,VIRGIN MEDIA PYMTS,Bills,38,566
20,11,2014,Caffe Nero,Eating Out,2,564
20,11,2014,Chicken Cottage,Eating Out,7,557
20,11,2014,ATM Cash Withdrawal,General,20,537
21,11,2014,Sainsburys,Groceries,73,464
22,11,2014,Anglo restaurant,Eating Out,59,405
23,11,2014,ATM Cash Withdrawal,General,10,395
24,11,2014,O2,Bills,34,361
24,11,2014,South West Trains,Transport,25,336
24,11,2014,Caffe Nero,Eating Out,1,335
24,11,2014,Subway,Eating Out,7,328
25,11,2014,Costa Coffee,Eating Out,2,326
25,11,2014,McDonalds,Eating Out,8,318
26,11,2014,Wild Bean Cafe,Eating Out,2,316
26,11,2014,Chicken Cottage,Eating Out,4,312
26,11,2014,ATM Cash Withdrawal,General,10,302
28,11,2014,Sainsburys,Groceries,70,232
28,11,2014,Starbucks Coffee,Eating Out,2,230
28,11,2014,Subway,Eating Out,6,224
28,11,2014,Restaurant Gordon RamsayPortland Restaurant,Eating Out,58,166
29,11,2014,Scott's Restaurant,Eating Out,31,135
29,11,2014,ATM Cash Withdrawal,General,10,125
1,12,2014,Rhino Sports salary,General,1700,1825
1,12,2014,South West Trains,Transport,29,1796
1,12,2014,Caffe Nero,Eating Out,1,1795
2,12,2014,Subway,Eating Out,7,1788
3,12,2014,Starbucks Coffee,Eating Out,2,1786
3,12,2014,Chicken Cottage,Eating Out,6,1780
4,12,2014,Starbucks Coffee,Eating Out,2,1778
5,12,2014,Tescos,Groceries,86,1692
5,12,2014,Costa Coffee,Eating Out,2,1690
5,12,2014,Subway,Eating Out,8,1682
5,12,2014,ATM Cash Withdrawal,General,10,1672
6,12,2014,ATM Cash Withdrawal,General,10,1662
7,12,2014,Cubit and West rent,Rent,550,1112
7,12,2014,Pizza Express,Eating Out,44,1068
8,12,2014,South West Trains,Transport,24,1044
10,12,2014,Starbucks Coffee,Eating Out,1,1043
10,12,2014,Subway,Eating Out,5,1038
10,12,2014,ATM Cash Withdrawal,General,20,1018
11,12,2014,Subway,Eating Out,5,1013
12,12,2014,ASDA,Groceries,43,970
12,12,2014,Costa Coffee,Eating Out,2,968
12,12,2014,Scott's Restaurant,Eating Out,52,916
15,12,2014,BRGAS-Electricity,Bills,21,895
15,12,2014,BRGAS-Gas,Bills,42,853
15,12,2014,South West Trains,Transport,27,826
15,12,2014,Wild Bean Cafe,Eating Out,2,824
15,12,2014,McDonalds,Eating Out,7,817
15,12,2014,ATM Cash Withdrawal,General,10,807
16,12,2014,LBS Council Tax,Bills,50,757
16,12,2014,Caffe Nero,Eating Out,2,755
17,12,2014,Wild Bean Cafe,Eating Out,2,753
17,12,2014,ATM Cash Withdrawal,General,10,743
18,12,2014,Wild Bean Cafe,Eating Out,1,742
18,12,2014,Pret A Manger,Eating Out,5,737
19,12,2014,Tescos,Groceries,82,655
19,12,2014,Wild Bean Cafe,Eating Out,2,653
19,12,2014,ATM Cash Withdrawal,General,10,643
20,12,2014,VIRGIN MEDIA PYMTS,Bills,52,591
20,12,2014,Dominos Pizza,Eating Out,54,537
22,12,2014,South West Trains,Transport,27,510
22,12,2014,Caffe Nero,Eating Out,2,508
22,12,2014,ATM Cash Withdrawal,General,20,488
23,12,2014,Starbucks Coffee,Eating Out,1,487
23,12,2014,ATM Cash Withdrawal,General,10,477
24,12,2014,O2,Bills,35,442
25,12,2014,Wild Bean Cafe,Eating Out,2,440
25,12,2014,Greggs,Eating Out,5,435
26,12,2014,Sainsburys,Groceries,58,377
26,12,2014,Costa Coffee,Eating Out,2,375
26,12,2014,Dominos Pizza,Eating Out,41,334
27,12,2014,Heaven Club,Eating Out,11,323
27,12,2014,Heaven Club,Eating Out,15,308
28,12,2014,ATM Cash Withdrawal,General,10,298
29,12,2014,South West Trains,Transport,26,272
29,12,2014,Starbucks Coffee,Eating Out,2,270
29,12,2014,The West Cornwall Pasty Company,Eating Out,6,264
30,12,2014,Costa Coffee,Eating Out,1,263
30,12,2014,McDonalds,Eating Out,5,258
31,12,2014,Costa Coffee,Eating Out,1,257
31,12,2014,Greggs,Eating Out,4,253
31,12,2014,ATM Cash Withdrawal,General,10,243
1,1,2015,Rhino Sports salary,General,1700,1943
1,1,2015,Costa Coffee,Eating Out,2,1941
1,1,2015,Pret A Manger,Eating Out,8,1933
2,1,2015,Sainsburys,Groceries,87,1846
3,1,2015,Fabric Club,Eating Out,14,1832
3,1,2015,Fabric Club,Eating Out,10,1822
3,1,2015,Fabric Club,Eating Out,15,1807
3,1,2015,ATM Cash Withdrawal,General,20,1787
5,1,2015,South West Trains,Transport,32,1755
5,1,2015,Costa Coffee,Eating Out,1,1754
5,1,2015,Greggs,Eating Out,5,1749
6,1,2015,Wild Bean Cafe,Eating Out,2,1747
6,1,2015,The West Cornwall Pasty Company,Eating Out,8,1739
7,1,2015,Cubit and West rent,Rent,550,1189
7,1,2015,Wild Bean Cafe,Eating Out,1,1188
8,1,2015,Caffe Nero,Eating Out,2,1186
8,1,2015,Greggs,Eating Out,7,1179
9,1,2015,Morrisons,Groceries,88,1091
9,1,2015,Costa Coffee,Eating Out,1,1090
9,1,2015,Subway,Eating Out,8,1082
9,1,2015,Restaurant Gordon RamsayPortland Restaurant,Eating Out,33,1049
9,1,2015,ATM Cash Withdrawal,General,20,1029
10,1,2015,ATM Cash Withdrawal,General,20,1009
12,1,2015,South West Trains,Transport,34,975
12,1,2015,ATM Cash Withdrawal,General,20,955
13,1,2015,Starbucks Coffee,Eating Out,2,953
14,1,2015,Starbucks Coffee,Eating Out,2,951
14,1,2015,McDonalds,Eating Out,6,945
14,1,2015,ATM Cash Withdrawal,General,10,935
15,1,2015,BRGAS-Electricity,Bills,67,868
15,1,2015,BRGAS-Gas,Bills,50,818
15,1,2015,Starbucks Coffee,Eating Out,1,817
15,1,2015,McDonalds,Eating Out,7,810
15,1,2015,ATM Cash Withdrawal,General,20,790
16,1,2015,LBS Council Tax,Bills,50,740
16,1,2015,Sainsburys,Groceries,76,664
16,1,2015,Caffe Nero,Eating Out,2,662
17,1,2015,Restaurant Gordon RamsayPortland Restaurant,Eating Out,46,616
19,1,2015,South West Trains,Transport,25,591
19,1,2015,Costa Coffee,Eating Out,2,589
19,1,2015,Chicken Cottage,Eating Out,4,585
20,1,2015,VIRGIN MEDIA PYMTS,Bills,51,534
20,1,2015,Costa Coffee,Eating Out,2,532
20,1,2015,Subway,Eating Out,4,528
21,1,2015,The West Cornwall Pasty Company,Eating Out,4,524
22,1,2015,Wild Bean Cafe,Eating Out,2,522
22,1,2015,ATM Cash Withdrawal,General,10,512
23,1,2015,Tescos,Groceries,75,437
23,1,2015,McDonalds,Eating Out,7,430
23,1,2015,ATM Cash Withdrawal,General,20,410
24,1,2015,O2,Bills,33,377
24,1,2015,Fabric Club,Eating Out,15,362
24,1,2015,Fabric Club,Eating Out,10,352
24,1,2015,Fabric Club,Eating Out,7,345
24,1,2015,Fabric Club,Eating Out,9,336
26,1,2015,South West Trains,Transport,37,299
26,1,2015,Greggs,Eating Out,8,291
27,1,2015,Costa Coffee,Eating Out,2,289
27,1,2015,ATM Cash Withdrawal,General,20,269
28,1,2015,Caffe Nero,Eating Out,2,267
29,1,2015,Wild Bean Cafe,Eating Out,1,266
29,1,2015,ATM Cash Withdrawal,General,20,246
30,1,2015,Morrisons,Groceries,66,180
30,1,2015,Costa Coffee,Eating Out,2,178
30,1,2015,Subway,Eating Out,8,170
30,1,2015,ATM Cash Withdrawal,General,10,160
31,1,2015,Scott's Restaurant,Eating Out,53,107
1,2,2015,Rhino Sports salary,General,1700,1807
2,2,2015,South West Trains,Transport,36,1771
2,2,2015,Costa Coffee,Eating Out,2,1769
3,2,2015,Caffe Nero,Eating Out,1,1768
3,2,2015,ATM Cash Withdrawal,General,10,1758
4,2,2015,Wild Bean Cafe,Eating Out,2,1756
4,2,2015,Pret A Manger,Eating Out,6,1750
5,2,2015,Caffe Nero,Eating Out,2,1748
5,2,2015,The West Cornwall Pasty Company,Eating Out,4,1744
5,2,2015,ATM Cash Withdrawal,General,20,1724
6,2,2015,Morrisons,Groceries,70,1654
6,2,2015,Caffe Nero,Eating Out,2,1652
7,2,2015,Cubit and West rent,Rent,550,1102
7,2,2015,Scott's Restaurant,Eating Out,25,1077
9,2,2015,South West Trains,Transport,33,1044
9,2,2015,Wild Bean Cafe,Eating Out,2,1042
9,2,2015,Subway,Eating Out,7,1035
10,2,2015,Caffe Nero,Eating Out,2,1033
10,2,2015,McDonalds,Eating Out,4,1029
11,2,2015,Wild Bean Cafe,Eating Out,1,1028
11,2,2015,Pret A Manger,Eating Out,7,1021
11,2,2015,ATM Cash Withdrawal,General,20,1001
12,2,2015,Pret A Manger,Eating Out,5,996
13,2,2015,Waitrose,Groceries,65,931
13,2,2015,Greggs,Eating Out,4,927
14,2,2015,ATM Cash Withdrawal,General,10,917
15,2,2015,BRGAS-Electricity,Bills,39,878
15,2,2015,BRGAS-Gas,Bills,42,836
16,2,2015,LBS Council Tax,Bills,50,786
16,2,2015,South West Trains,Transport,30,756
16,2,2015,Caffe Nero,Eating Out,1,755
16,2,2015,ATM Cash Withdrawal,General,20,735
17,2,2015,Chicken Cottage,Eating Out,6,729
18,2,2015,Starbucks Coffee,Eating Out,2,727
18,2,2015,ATM Cash Withdrawal,General,20,707
19,2,2015,Wild Bean Cafe,Eating Out,2,705
19,2,2015,The West Cornwall Pasty Company,Eating Out,8,697
20,2,2015,VIRGIN MEDIA PYMTS,Bills,41,656
20,2,2015,Waitrose,Groceries,82,574
20,2,2015,Caffe Nero,Eating Out,2,572
20,2,2015,Fabric Club,Eating Out,5,567
20,2,2015,Fabric Club,Eating Out,14,553
20,2,2015,Fabric Club,Eating Out,9,544
20,2,2015,ATM Cash Withdrawal,General,20,524
23,2,2015,South West Trains,Transport,36,488
23,2,2015,ATM Cash Withdrawal,General,20,468
24,2,2015,O2,Bills,37,431
24,2,2015,Starbucks Coffee,Eating Out,2,429
26,2,2015,Subway,Eating Out,6,423
27,2,2015,Tescos,Groceries,86,337
27,2,2015,Costa Coffee,Eating Out,1,336
27,2,2015,The West Cornwall Pasty Company,Eating Out,5,331
1,3,2015,Rhino Sports salary,General,1700,2031
1,3,2015,Pizza Express,Eating Out,43,1988
2,3,2015,South West Trains,Transport,25,1963
2,3,2015,Costa Coffee,Eating Out,2,1961
2,3,2015,Subway,Eating Out,5,1956
2,3,2015,ATM Cash Withdrawal,General,20,1936
3,3,2015,Pret A Manger,Eating Out,7,1929
4,3,2015,Caffe Nero,Eating Out,1,1928
4,3,2015,ATM Cash Withdrawal,General,20,1908
5,3,2015,Caffe Nero,Eating Out,2,1906
5,3,2015,ATM Cash Withdrawal,General,20,1886
6,3,2015,Tescos,Groceries,54,1832
6,3,2015,Caffe Nero,Eating Out,1,1831
6,3,2015,Pizza Express,Eating Out,25,1806
7,3,2015,Cubit and West rent,Rent,550,1256
7,3,2015,ATM Cash Withdrawal,General,20,1236
8,3,2015,Scott's Restaurant,Eating Out,55,1181
8,3,2015,ATM Cash Withdrawal,General,10,1171
9,3,2015,South West Trains,Transport,24,1147
9,3,2015,Starbucks Coffee,Eating Out,1,1146
9,3,2015,Chicken Cottage,Eating Out,4,1142
10,3,2015,Wild Bean Cafe,Eating Out,2,1140
10,3,2015,The West Cornwall Pasty Company,Eating Out,6,1134
11,3,2015,Wild Bean Cafe,Eating Out,2,1132
11,3,2015,Greggs,Eating Out,5,1127
12,3,2015,Starbucks Coffee,Eating Out,1,1126
12,3,2015,Greggs,Eating Out,7,1119
12,3,2015,ATM Cash Withdrawal,General,10,1109
13,3,2015,Sainsburys,Groceries,51,1058
13,3,2015,Greggs,Eating Out,6,1052
13,3,2015,ATM Cash Withdrawal,General,20,1032
15,3,2015,BRGAS-Electricity,Bills,28,1004
15,3,2015,BRGAS-Gas,Bills,21,983
15,3,2015,ATM Cash Withdrawal,General,20,963
16,3,2015,LBS Council Tax,Bills,50,913
16,3,2015,South West Trains,Transport,33,880
16,3,2015,Costa Coffee,Eating Out,1,879
16,3,2015,ATM Cash Withdrawal,General,10,869
17,3,2015,Pret A Manger,Eating Out,8,861
17,3,2015,ATM Cash Withdrawal,General,10,851
18,3,2015,Starbucks Coffee,Eating Out,2,849
18,3,2015,Pret A Manger,Eating Out,8,841
18,3,2015,ATM Cash Withdrawal,General,20,821
19,3,2015,Wild Bean Cafe,Eating Out,2,819
20,3,2015,VIRGIN MEDIA PYMTS,Bills,32,787
20,3,2015,Sainsburys,Groceries,63,724
20,3,2015,Starbucks Coffee,Eating Out,2,722
20,3,2015,Chicken Cottage,Eating Out,4,718
21,3,2015,Heaven Club,Eating Out,15,703
21,3,2015,Heaven Club,Eating Out,9,694
21,3,2015,Heaven Club,Eating Out,13,681
21,3,2015,ATM Cash Withdrawal,General,20,661
22,3,2015,ATM Cash Withdrawal,General,10,651
23,3,2015,South West Trains,Transport,32,619
23,3,2015,McDonalds,Eating Out,7,612
23,3,2015,ATM Cash Withdrawal,General,10,602
24,3,2015,O2,Bills,37,565
24,3,2015,Starbucks Coffee,Eating Out,2,563
25,3,2015,Costa Coffee,Eating Out,2,561
26,3,2015,Wild Bean Cafe,Eating Out,2,559
27,3,2015,Tescos,Groceries,79,480
27,3,2015,Wild Bean Cafe,Eating Out,2,478
27,3,2015,McDonalds,Eating Out,6,472
27,3,2015,Ministry of Sound ClubXOYO Club,Eating Out,15,457
27,3,2015,Ministry of Sound ClubXOYO Club,Eating Out,9,448
27,3,2015,Ministry of Sound ClubXOYO Club,Eating Out,11,437
27,3,2015,Ministry of Sound ClubXOYO Club,Eating Out,5,432
27,3,2015,Scott's Restaurant,Eating Out,51,381
30,3,2015,South West Trains,Transport,25,356
30,3,2015,Caffe Nero,Eating Out,2,354
31,3,2015,Caffe Nero,Eating Out,1,353
31,3,2015,Subway,Eating Out,5,348
1,4,2015,Rhino Sports salary,General,1700,2048
1,4,2015,Wild Bean Cafe,Eating Out,1,2047
1,4,2015,Chicken Cottage,Eating Out,4,2043
2,4,2015,Starbucks Coffee,Eating Out,2,2041
2,4,2015,Subway,Eating Out,8,2033
3,4,2015,ASDA,Groceries,85,1948
3,4,2015,Wild Bean Cafe,Eating Out,2,1946
3,4,2015,ATM Cash Withdrawal,General,20,1926
6,4,2015,South West Trains,Transport,35,1891
6,4,2015,Caffe Nero,Eating Out,2,1889
6,4,2015,ATM Cash Withdrawal,General,20,1869
7,4,2015,Cubit and West rent,Rent,550,1319
7,4,2015,Costa Coffee,Eating Out,2,1317
8,4,2015,Caffe Nero,Eating Out,2,1315
8,4,2015,Subway,Eating Out,5,1310
8,4,2015,ATM Cash Withdrawal,General,20,1290
9,4,2015,Caffe Nero,Eating Out,2,1288
9,4,2015,Subway,Eating Out,4,1284
10,4,2015,Tescos,Groceries,48,1236
10,4,2015,Starbucks Coffee,Eating Out,1,1235
11,4,2015,ATM Cash Withdrawal,General,10,1225
12,4,2015,Anglo restaurant,Eating Out,59,1166
13,4,2015,South West Trains,Transport,31,1135
13,4,2015,Subway,Eating Out,4,1131
13,4,2015,ATM Cash Withdrawal,General,20,1111
14,4,2015,Caffe Nero,Eating Out,2,1109
14,4,2015,Subway,Eating Out,8,1101
15,4,2015,BRGAS-Electricity,Bills,43,1058
15,4,2015,BRGAS-Gas,Bills,22,1036
15,4,2015,Starbucks Coffee,Eating Out,1,1035
15,4,2015,McDonalds,Eating Out,5,1030
16,4,2015,LBS Council Tax,Bills,50,980
16,4,2015,ATM Cash Withdrawal,General,20,960
17,4,2015,Morrisons,Groceries,79,881
17,4,2015,Wild Bean Cafe,Eating Out,2,879
17,4,2015,Chicken Cottage,Eating Out,4,875
17,4,2015,Anglo restaurant,Eating Out,59,816
18,4,2015,ATM Cash Withdrawal,General,10,806
20,4,2015,VIRGIN MEDIA PYMTS,Bills,46,760
20,4,2015,South West Trains,Transport,28,732
21,4,2015,Costa Coffee,Eating Out,2,730
22,4,2015,Subway,Eating Out,6,724
22,4,2015,ATM Cash Withdrawal,General,10,714
23,4,2015,Starbucks Coffee,Eating Out,2,712
23,4,2015,The West Cornwall Pasty Company,Eating Out,4,708
24,4,2015,O2,Bills,37,671
24,4,2015,Tescos,Groceries,63,608
24,4,2015,Costa Coffee,Eating Out,1,607
24,4,2015,Greggs,Eating Out,6,601
24,4,2015,Heaven Club,Eating Out,5,596
24,4,2015,Heaven Club,Eating Out,11,585
24,4,2015,Heaven Club,Eating Out,5,580
24,4,2015,Heaven Club,Eating Out,16,564
24,4,2015,Dominos Pizza,Eating Out,56,508
25,4,2015,The Grand Pub,Eating Out,9,499
25,4,2015,ATM Cash Withdrawal,General,10,489
26,4,2015,Pizza Express,Eating Out,36,453
27,4,2015,South West Trains,Transport,35,418
27,4,2015,Costa Coffee,Eating Out,2,416
27,4,2015,The West Cornwall Pasty Company,Eating Out,4,412
28,4,2015,Caffe Nero,Eating Out,2,410
28,4,2015,Chicken Cottage,Eating Out,5,405
28,4,2015,ATM Cash Withdrawal,General,10,395
29,4,2015,Costa Coffee,Eating Out,2,393
29,4,2015,Greggs,Eating Out,4,389
30,4,2015,Wild Bean Cafe,Eating Out,1,388
30,4,2015,McDonalds,Eating Out,4,384
1,5,2015,Rhino Sports salary,General,1700,2084
1,5,2015,Waitrose,Groceries,61,2023
1,5,2015,Chicken Cottage,Eating Out,7,2016
1,5,2015,Pizza Express,Eating Out,33,1983
1,5,2015,ATM Cash Withdrawal,General,10,1973
4,5,2015,South West Trains,Transport,30,1943
5,5,2015,Costa Coffee,Eating Out,1,1942
6,5,2015,Caffe Nero,Eating Out,2,1940
6,5,2015,ATM Cash Withdrawal,General,10,1930
7,5,2015,Cubit and West rent,Rent,550,1380
7,5,2015,Wild Bean Cafe,Eating Out,1,1379
7,5,2015,The West Cornwall Pasty Company,Eating Out,8,1371
8,5,2015,Morrisons,Groceries,87,1284
8,5,2015,Costa Coffee,Eating Out,2,1282
8,5,2015,McDonalds,Eating Out,8,1274
9,5,2015,Pizza Express,Eating Out,55,1219
10,5,2015,ATM Cash Withdrawal,General,20,1199
11,5,2015,South West Trains,Transport,24,1175
11,5,2015,Caffe Nero,Eating Out,1,1174
11,5,2015,Pret A Manger,Eating Out,7,1167
12,5,2015,Wild Bean Cafe,Eating Out,1,1166
12,5,2015,Subway,Eating Out,4,1162
13,5,2015,Starbucks Coffee,Eating Out,2,1160
13,5,2015,Chicken Cottage,Eating Out,6,1154
14,5,2015,Wild Bean Cafe,Eating Out,1,1153
14,5,2015,Subway,Eating Out,7,1146
15,5,2015,BRGAS-Electricity,Bills,27,1119
15,5,2015,BRGAS-Gas,Bills,37,1082
15,5,2015,ASDA,Groceries,87,995
15,5,2015,Starbucks Coffee,Eating Out,1,994
15,5,2015,Pret A Manger,Eating Out,4,990
15,5,2015,Pizza Express,Eating Out,52,938
15,5,2015,ATM Cash Withdrawal,General,10,928
16,5,2015,LBS Council Tax,Bills,50,878
18,5,2015,South West Trains,Transport,38,840
18,5,2015,Caffe Nero,Eating Out,2,838
18,5,2015,Chicken Cottage,Eating Out,7,831
18,5,2015,ATM Cash Withdrawal,General,20,811
19,5,2015,Costa Coffee,Eating Out,1,810
20,5,2015,VIRGIN MEDIA PYMTS,Bills,34,776
20,5,2015,The West Cornwall Pasty Company,Eating Out,8,768
21,5,2015,Wild Bean Cafe,Eating Out,1,767
21,5,2015,Subway,Eating Out,6,761
22,5,2015,Sainsburys,Groceries,79,682
22,5,2015,Chicken Cottage,Eating Out,8,674
24,5,2015,O2,Bills,37,637
25,5,2015,South West Trains,Transport,35,602
25,5,2015,Costa Coffee,Eating Out,2,600
26,5,2015,Caffe Nero,Eating Out,1,599
26,5,2015,Greggs,Eating Out,7,592
26,5,2015,ATM Cash Withdrawal,General,20,572
27,5,2015,The West Cornwall Pasty Company,Eating Out,7,565
28,5,2015,Costa Coffee,Eating Out,1,564
29,5,2015,Tescos,Groceries,68,496
29,5,2015,Greggs,Eating Out,4,492
29,5,2015,Dominos Pizza,Eating Out,34,458
1,6,2015,Rhino Sports salary,General,1700,2158
1,6,2015,South West Trains,Transport,31,2127
2,6,2015,Starbucks Coffee,Eating Out,1,2126
2,6,2015,Subway,Eating Out,8,2118
3,6,2015,Wild Bean Cafe,Eating Out,1,2117
4,6,2015,Starbucks Coffee,Eating Out,2,2115
5,6,2015,Morrisons,Groceries,71,2044
5,6,2015,Costa Coffee,Eating Out,1,2043
5,6,2015,The West Cornwall Pasty Company,Eating Out,5,2038
5,6,2015,Pizza Express,Eating Out,37,2001
6,6,2015,ATM Cash Withdrawal,General,10,1991
7,6,2015,Cubit and West rent,Rent,550,1441
8,6,2015,South West Trains,Transport,31,1410
8,6,2015,Caffe Nero,Eating Out,1,1409
8,6,2015,ATM Cash Withdrawal,General,10,1399
9,6,2015,Chicken Cottage,Eating Out,7,1392
10,6,2015,Starbucks Coffee,Eating Out,2,1390
10,6,2015,The West Cornwall Pasty Company,Eating Out,8,1382
10,6,2015,ATM Cash Withdrawal,General,10,1372
11,6,2015,Caffe Nero,Eating Out,1,1371
11,6,2015,Chicken Cottage,Eating Out,6,1365
12,6,2015,Tescos,Groceries,63,1302
12,6,2015,Caffe Nero,Eating Out,2,1300
12,6,2015,Greggs,Eating Out,7,1293
15,6,2015,BRGAS-Electricity,Bills,37,1256
15,6,2015,BRGAS-Gas,Bills,42,1214
15,6,2015,South West Trains,Transport,38,1176
15,6,2015,Subway,Eating Out,8,1168
16,6,2015,LBS Council Tax,Bills,50,1118
16,6,2015,Subway,Eating Out,5,1113
16,6,2015,ATM Cash Withdrawal,General,10,1103
17,6,2015,Wild Bean Cafe,Eating Out,1,1102
18,6,2015,Costa Coffee,Eating Out,2,1100
18,6,2015,Subway,Eating Out,5,1095
19,6,2015,Morrisons,Groceries,80,1015
19,6,2015,Caffe Nero,Eating Out,2,1013
19,6,2015,Chicken Cottage,Eating Out,8,1005
20,6,2015,VIRGIN MEDIA PYMTS,Bills,51,954
20,6,2015,ATM Cash Withdrawal,General,20,934
21,6,2015,ATM Cash Withdrawal,General,10,924
22,6,2015,South West Trains,Transport,31,893
23,6,2015,Starbucks Coffee,Eating Out,2,891
24,6,2015,O2,Bills,34,857
24,6,2015,Starbucks Coffee,Eating Out,2,855
24,6,2015,Chicken Cottage,Eating Out,7,848
25,6,2015,Wild Bean Cafe,Eating Out,1,847
25,6,2015,Greggs,Eating Out,8,839
25,6,2015,ATM Cash Withdrawal,General,10,829
26,6,2015,ASDA,Groceries,89,740
26,6,2015,Caffe Nero,Eating Out,1,739
26,6,2015,Fabric Club,Eating Out,12,727
26,6,2015,ATM Cash Withdrawal,General,10,717
27,6,2015,The Grand Pub,Eating Out,15,702
27,6,2015,The Grand Pub,Eating Out,5,697
27,6,2015,Pizza Express,Eating Out,51,646
27,6,2015,ATM Cash Withdrawal,General,10,636
28,6,2015,Restaurant Gordon RamsayPortland Restaurant,Eating Out,38,598
29,6,2015,South West Trains,Transport,37,561
29,6,2015,Wild Bean Cafe,Eating Out,2,559
29,6,2015,Subway,Eating Out,6,553
30,6,2015,Caffe Nero,Eating Out,2,551
30,6,2015,ATM Cash Withdrawal,General,20,531
1,7,2015,Rhino Sports salary,General,1700,2231
1,7,2015,Caffe Nero,Eating Out,1,2230
1,7,2015,Pret A Manger,Eating Out,6,2224
2,7,2015,Caffe Nero,Eating Out,2,2222
2,7,2015,Greggs,Eating Out,4,2218
3,7,2015,Morrisons,Groceries,68,2150
3,7,2015,Caffe Nero,Eating Out,2,2148
3,7,2015,McDonalds,Eating Out,4,2144
3,7,2015,Anglo restaurant,Eating Out,45,2099
4,7,2015,Dominos Pizza,Eating Out,42,2057
4,7,2015,ATM Cash Withdrawal,General,20,2037
6,7,2015,South West Trains,Transport,33,2004
6,7,2015,Pret A Manger,Eating Out,6,1998
7,7,2015,Cubit and West rent,Rent,550,1448
7,7,2015,Starbucks Coffee,Eating Out,2,1446
7,7,2015,Pret A Manger,Eating Out,6,1440
8,7,2015,Starbucks Coffee,Eating Out,2,1438
8,7,2015,ATM Cash Withdrawal,General,10,1428
9,7,2015,Pret A Manger,Eating Out,8,1420
10,7,2015,ASDA,Groceries,74,1346
10,7,2015,Costa Coffee,Eating Out,2,1344
10,7,2015,Greggs,Eating Out,5,1339
10,7,2015,ATM Cash Withdrawal,General,20,1319
11,7,2015,Dominos Pizza,Eating Out,53,1266
11,7,2015,ATM Cash Withdrawal,General,20,1246
12,7,2015,Anglo restaurant,Eating Out,36,1210
13,7,2015,South West Trains,Transport,30,1180
13,7,2015,Greggs,Eating Out,6,1174
13,7,2015,ATM Cash Withdrawal,General,10,1164
14,7,2015,Costa Coffee,Eating Out,2,1162
15,7,2015,BRGAS-Electricity,Bills,29,1133
15,7,2015,BRGAS-Gas,Bills,29,1104
15,7,2015,Costa Coffee,Eating Out,2,1102
15,7,2015,Chicken Cottage,Eating Out,7,1095
16,7,2015,LBS Council Tax,Bills,50,1045
16,7,2015,Starbucks Coffee,Eating Out,1,1044
17,7,2015,Morrisons,Groceries,56,988
17,7,2015,Costa Coffee,Eating Out,2,986
19,7,2015,Scott's Restaurant,Eating Out,30,956
20,7,2015,VIRGIN MEDIA PYMTS,Bills,39,917
20,7,2015,South West Trains,Transport,37,880
20,7,2015,Costa Coffee,Eating Out,2,878
21,7,2015,Greggs,Eating Out,8,870
22,7,2015,Starbucks Coffee,Eating Out,2,868
22,7,2015,Chicken Cottage,Eating Out,5,863
23,7,2015,Caffe Nero,Eating Out,1,862
24,7,2015,O2,Bills,34,828
24,7,2015,Tescos,Groceries,89,739
24,7,2015,Chicken Cottage,Eating Out,6,733
24,7,2015,Dominos Pizza,Eating Out,31,702
25,7,2015,ATM Cash Withdrawal,General,10,692
27,7,2015,South West Trains,Transport,29,663
27,7,2015,Subway,Eating Out,8,655
27,7,2015,ATM Cash Withdrawal,General,10,645
28,7,2015,Chicken Cottage,Eating Out,5,640
28,7,2015,ATM Cash Withdrawal,General,20,620
29,7,2015,Caffe Nero,Eating Out,2,618
29,7,2015,Subway,Eating Out,5,613
30,7,2015,Starbucks Coffee,Eating Out,2,611
30,7,2015,Chicken Cottage,Eating Out,7,604
31,7,2015,ASDA,Groceries,70,534
31,7,2015,Starbucks Coffee,Eating Out,1,533
31,7,2015,Chicken Cottage,Eating Out,7,526
31,7,2015,ATM Cash Withdrawal,General,20,506
1,8,2015,Rhino Sports salary,General,1700,2206
1,8,2015,ATM Cash Withdrawal,General,10,2196
2,8,2015,ATM Cash Withdrawal,General,20,2176
3,8,2015,South West Trains,Transport,35,2141
3,8,2015,Costa Coffee,Eating Out,2,2139
3,8,2015,McDonalds,Eating Out,5,2134
4,8,2015,Wild Bean Cafe,Eating Out,1,2133
4,8,2015,Chicken Cottage,Eating Out,6,2127
5,8,2015,Wild Bean Cafe,Eating Out,1,2126
6,8,2015,Costa Coffee,Eating Out,2,2124
6,8,2015,Chicken Cottage,Eating Out,4,2120
7,8,2015,Cubit and West rent,Rent,550,1570
7,8,2015,ASDA,Groceries,70,1500
7,8,2015,Caffe Nero,Eating Out,2,1498
7,8,2015,ATM Cash Withdrawal,General,10,1488
8,8,2015,Scott's Restaurant,Eating Out,52,1436
8,8,2015,ATM Cash Withdrawal,General,10,1426
10,8,2015,South West Trains,Transport,34,1392
10,8,2015,Subway,Eating Out,8,1384
11,8,2015,Wild Bean Cafe,Eating Out,1,1383
11,8,2015,Pret A Manger,Eating Out,7,1376
12,8,2015,Costa Coffee,Eating Out,1,1375
12,8,2015,Greggs,Eating Out,7,1368
13,8,2015,Wild Bean Cafe,Eating Out,2,1366
13,8,2015,Subway,Eating Out,6,1360
14,8,2015,Waitrose,Groceries,49,1311
14,8,2015,Costa Coffee,Eating Out,1,1310
14,8,2015,Subway,Eating Out,7,1303
15,8,2015,BRGAS-Electricity,Bills,33,1270
15,8,2015,BRGAS-Gas,Bills,37,1233
16,8,2015,LBS Council Tax,Bills,50,1183
16,8,2015,ATM Cash Withdrawal,General,10,1173
17,8,2015,South West Trains,Transport,32,1141
17,8,2015,Chicken Cottage,Eating Out,7,1134
18,8,2015,The West Cornwall Pasty Company,Eating Out,4,1130
18,8,2015,ATM Cash Withdrawal,General,20,1110
19,8,2015,Starbucks Coffee,Eating Out,2,1108
19,8,2015,McDonalds,Eating Out,7,1101
20,8,2015,VIRGIN MEDIA PYMTS,Bills,50,1051
20,8,2015,Starbucks Coffee,Eating Out,2,1049
21,8,2015,Tescos,Groceries,49,1000
21,8,2015,McDonalds,Eating Out,4,996
21,8,2015,Ministry of Sound ClubXOYO Club,Eating Out,9,987
22,8,2015,Ministry of Sound ClubXOYO Club,Eating Out,7,980
23,8,2015,Dominos Pizza,Eating Out,38,942
24,8,2015,O2,Bills,33,909
24,8,2015,South West Trains,Transport,34,875
24,8,2015,Starbucks Coffee,Eating Out,2,873
24,8,2015,McDonalds,Eating Out,8,865
25,8,2015,Caffe Nero,Eating Out,1,864
26,8,2015,Caffe Nero,Eating Out,2,862
27,8,2015,Wild Bean Cafe,Eating Out,1,861
27,8,2015,Pret A Manger,Eating Out,5,856
28,8,2015,Waitrose,Groceries,76,780
28,8,2015,Costa Coffee,Eating Out,1,779
28,8,2015,Chicken Cottage,Eating Out,4,775
28,8,2015,Restaurant Gordon RamsayPortland Restaurant,Eating Out,27,748
29,8,2015,Pizza Express,Eating Out,25,723
31,8,2015,South West Trains,Transport,31,692
31,8,2015,Costa Coffee,Eating Out,2,690
31,8,2015,Greggs,Eating Out,6,684
1,9,2015,Rhino Sports salary,General,1700,2384
1,9,2015,Wild Bean Cafe,Eating Out,2,2382
1,9,2015,McDonalds,Eating Out,5,2377
1,9,2015,ATM Cash Withdrawal,General,10,2367
2,9,2015,Wild Bean Cafe,Eating Out,2,2365
2,9,2015,Pret A Manger,Eating Out,8,2357
3,9,2015,Starbucks Coffee,Eating Out,2,2355
3,9,2015,McDonalds,Eating Out,5,2350
4,9,2015,Morrisons,Groceries,76,2274
4,9,2015,Wild Bean Cafe,Eating Out,2,2272
4,9,2015,ATM Cash Withdrawal,General,20,2252
7,9,2015,Cubit and West rent,Rent,550,1702
7,9,2015,South West Trains,Transport,27,1675
7,9,2015,Pret A Manger,Eating Out,5,1670
8,9,2015,Starbucks Coffee,Eating Out,2,1668
8,9,2015,ATM Cash Withdrawal,General,10,1658
9,9,2015,Chicken Cottage,Eating Out,6,1652
10,9,2015,Starbucks Coffee,Eating Out,2,1650
11,9,2015,Waitrose,Groceries,75,1575
11,9,2015,Anglo restaurant,Eating Out,54,1521
11,9,2015,ATM Cash Withdrawal,General,10,1511
12,9,2015,Anglo restaurant,Eating Out,53,1458
12,9,2015,ATM Cash Withdrawal,General,10,1448
13,9,2015,Anglo restaurant,Eating Out,26,1422
14,9,2015,South West Trains,Transport,30,1392
14,9,2015,Caffe Nero,Eating Out,1,1391
14,9,2015,ATM Cash Withdrawal,General,20,1371
15,9,2015,BRGAS-Electricity,Bills,43,1328
15,9,2015,BRGAS-Gas,Bills,32,1296
15,9,2015,Starbucks Coffee,Eating Out,2,1294
15,9,2015,Subway,Eating Out,5,1289
16,9,2015,LBS Council Tax,Bills,50,1239
16,9,2015,Starbucks Coffee,Eating Out,1,1238
16,9,2015,The West Cornwall Pasty Company,Eating Out,4,1234
17,9,2015,Starbucks Coffee,Eating Out,1,1233
17,9,2015,Chicken Cottage,Eating Out,4,1229
18,9,2015,Waitrose,Groceries,54,1175
18,9,2015,Caffe Nero,Eating Out,1,1174
19,9,2015,Pizza Express,Eating Out,26,1148
19,9,2015,ATM Cash Withdrawal,General,20,1128
20,9,2015,VIRGIN MEDIA PYMTS,Bills,56,1072
20,9,2015,ATM Cash Withdrawal,General,20,1052
21,9,2015,South West Trains,Transport,26,1026
21,9,2015,Caffe Nero,Eating Out,1,1025
21,9,2015,The West Cornwall Pasty Company,Eating Out,6,1019
22,9,2015,Wild Bean Cafe,Eating Out,2,1017
22,9,2015,Pret A Manger,Eating Out,5,1012
22,9,2015,ATM Cash Withdrawal,General,20,992
23,9,2015,Starbucks Coffee,Eating Out,2,990
23,9,2015,Greggs,Eating Out,5,985
23,9,2015,ATM Cash Withdrawal,General,20,965
24,9,2015,O2,Bills,30,935
24,9,2015,Wild Bean Cafe,Eating Out,1,934
24,9,2015,Subway,Eating Out,8,926
25,9,2015,Sainsburys,Groceries,61,865
25,9,2015,Wild Bean Cafe,Eating Out,2,863
25,9,2015,Chicken Cottage,Eating Out,8,855
27,9,2015,Restaurant Gordon RamsayPortland Restaurant,Eating Out,50,805
28,9,2015,South West Trains,Transport,38,767
28,9,2015,Costa Coffee,Eating Out,2,765
28,9,2015,Pret A Manger,Eating Out,5,760
28,9,2015,ATM Cash Withdrawal,General,10,750
29,9,2015,Starbucks Coffee,Eating Out,1,749
29,9,2015,Subway,Eating Out,8,741
1,10,2015,Rhino Sports salary,General,1700,2441
1,10,2015,Caffe Nero,Eating Out,2,2439
1,10,2015,Greggs,Eating Out,8,2431
2,10,2015,ASDA,Groceries,70,2361
2,10,2015,Costa Coffee,Eating Out,1,2360
2,10,2015,Heaven Club,Eating Out,16,2344
2,10,2015,Heaven Club,Eating Out,10,2334
2,10,2015,Heaven Club,Eating Out,8,2326
2,10,2015,Heaven Club,Eating Out,5,2321
2,10,2015,Dominos Pizza,Eating Out,43,2278
5,10,2015,South West Trains,Transport,24,2254
5,10,2015,Pret A Manger,Eating Out,6,2248
6,10,2015,Wild Bean Cafe,Eating Out,2,2246
6,10,2015,ATM Cash Withdrawal,General,10,2236
7,10,2015,Cubit and West rent,Rent,550,1686
7,10,2015,Pret A Manger,Eating Out,6,1680
8,10,2015,Wild Bean Cafe,Eating Out,2,1678
8,10,2015,McDonalds,Eating Out,7,1671
8,10,2015,ATM Cash Withdrawal,General,10,1661
9,10,2015,Sainsburys,Groceries,44,1617
9,10,2015,Costa Coffee,Eating Out,1,1616
9,10,2015,Pret A Manger,Eating Out,7,1609
10,10,2015,Dominos Pizza,Eating Out,27,1582
11,10,2015,Scott's Restaurant,Eating Out,30,1552
11,10,2015,ATM Cash Withdrawal,General,10,1542
12,10,2015,South West Trains,Transport,30,1512
12,10,2015,ATM Cash Withdrawal,General,10,1502
13,10,2015,Caffe Nero,Eating Out,1,1501
13,10,2015,McDonalds,Eating Out,4,1497
14,10,2015,Wild Bean Cafe,Eating Out,2,1495
14,10,2015,ATM Cash Withdrawal,General,20,1475
15,10,2015,BRGAS-Electricity,Bills,35,1440
15,10,2015,BRGAS-Gas,Bills,21,1419
15,10,2015,Costa Coffee,Eating Out,2,1417
15,10,2015,McDonalds,Eating Out,8,1409
16,10,2015,LBS Council Tax,Bills,50,1359
16,10,2015,ASDA,Groceries,68,1291
16,10,2015,Pret A Manger,Eating Out,7,1284
16,10,2015,ATM Cash Withdrawal,General,10,1274
17,10,2015,ATM Cash Withdrawal,General,10,1264
19,10,2015,South West Trains,Transport,27,1237
19,10,2015,Caffe Nero,Eating Out,2,1235
20,10,2015,VIRGIN MEDIA PYMTS,Bills,46,1189
20,10,2015,Wild Bean Cafe,Eating Out,1,1188
21,10,2015,Costa Coffee,Eating Out,1,1187
22,10,2015,Costa Coffee,Eating Out,2,1185
22,10,2015,Greggs,Eating Out,8,1177
23,10,2015,ASDA,Groceries,49,1128
23,10,2015,Subway,Eating Out,8,1120
24,10,2015,O2,Bills,34,1086
24,10,2015,Pizza Express,Eating Out,32,1054
25,10,2015,Dominos Pizza,Eating Out,50,1004
25,10,2015,ATM Cash Withdrawal,General,20,984
26,10,2015,South West Trains,Transport,36,948
26,10,2015,Costa Coffee,Eating Out,2,946
26,10,2015,Pret A Manger,Eating Out,8,938
27,10,2015,Caffe Nero,Eating Out,2,936
28,10,2015,Wild Bean Cafe,Eating Out,2,934
28,10,2015,The West Cornwall Pasty Company,Eating Out,6,928
29,10,2015,Caffe Nero,Eating Out,2,926
30,10,2015,Morrisons,Groceries,86,840
30,10,2015,McDonalds,Eating Out,4,836
30,10,2015,Restaurant Gordon RamsayPortland Restaurant,Eating Out,34,802
31,10,2015,Dominos Pizza,Eating Out,56,746
1,11,2015,Rhino Sports salary,General,1700,2446
1,11,2015,Restaurant Gordon RamsayPortland Restaurant,Eating Out,30,2416
1,11,2015,ATM Cash Withdrawal,General,10,2406
2,11,2015,South West Trains,Transport,25,2381
2,11,2015,Caffe Nero,Eating Out,1,2380
2,11,2015,The West Cornwall Pasty Company,Eating Out,7,2373
2,11,2015,ATM Cash Withdrawal,General,20,2353
3,11,2015,Wild Bean Cafe,Eating Out,2,2351
4,11,2015,Caffe Nero,Eating Out,1,2350
4,11,2015,The West Cornwall Pasty Company,Eating Out,6,2344
5,11,2015,Caffe Nero,Eating Out,1,2343
5,11,2015,McDonalds,Eating Out,8,2335
6,11,2015,Waitrose,Groceries,44,2291
6,11,2015,Wild Bean Cafe,Eating Out,1,2290
6,11,2015,Pret A Manger,Eating Out,7,2283
6,11,2015,ATM Cash Withdrawal,General,20,2263
7,11,2015,Cubit and West rent,Rent,550,1713
8,11,2015,ATM Cash Withdrawal,General,10,1703
9,11,2015,South West Trains,Transport,35,1668
9,11,2015,Starbucks Coffee,Eating Out,2,1666
10,11,2015,ATM Cash Withdrawal,General,10,1656
11,11,2015,Caffe Nero,Eating Out,1,1655
11,11,2015,Subway,Eating Out,7,1648
11,11,2015,ATM Cash Withdrawal,General,20,1628
12,11,2015,Costa Coffee,Eating Out,1,1627
12,11,2015,ATM Cash Withdrawal,General,10,1617
13,11,2015,Sainsburys,Groceries,63,1554
13,11,2015,Wild Bean Cafe,Eating Out,2,1552
15,11,2015,BRGAS-Electricity,Bills,96,1456
15,11,2015,BRGAS-Gas,Bills,68,1388
16,11,2015,LBS Council Tax,Bills,50,1338
16,11,2015,South West Trains,Transport,38,1300
16,11,2015,McDonalds,Eating Out,7,1293
17,11,2015,Costa Coffee,Eating Out,2,1291
17,11,2015,The West Cornwall Pasty Company,Eating Out,7,1284
19,11,2015,Caffe Nero,Eating Out,1,1283
19,11,2015,McDonalds,Eating Out,6,1277
20,11,2015,VIRGIN MEDIA PYMTS,Bills,34,1243
20,11,2015,Waitrose,Groceries,44,1199
20,11,2015,Fabric Club,Eating Out,15,1184
20,11,2015,Fabric Club,Eating Out,5,1179
20,11,2015,Fabric Club,Eating Out,10,1169
22,11,2015,Restaurant Gordon RamsayPortland Restaurant,Eating Out,39,1130
23,11,2015,South West Trains,Transport,32,1098
23,11,2015,Wild Bean Cafe,Eating Out,1,1097
23,11,2015,ATM Cash Withdrawal,General,20,1077
24,11,2015,O2,Bills,34,1043
25,11,2015,Starbucks Coffee,Eating Out,2,1041
25,11,2015,Pret A Manger,Eating Out,7,1034
26,11,2015,Starbucks Coffee,Eating Out,1,1033
26,11,2015,Pret A Manger,Eating Out,8,1025
27,11,2015,Sainsburys,Groceries,61,964
27,11,2015,Costa Coffee,Eating Out,2,962
27,11,2015,Anglo restaurant,Eating Out,38,924
29,11,2015,Restaurant Gordon RamsayPortland Restaurant,Eating Out,58,866
30,11,2015,South West Trains,Transport,36,830
30,11,2015,Caffe Nero,Eating Out,2,828
30,11,2015,The West Cornwall Pasty Company,Eating Out,7,821
30,11,2015,ATM Cash Withdrawal,General,20,801
1,12,2015,Rhino Sports salary,General,1700,2501
1,12,2015,Costa Coffee,Eating Out,1,2500
1,12,2015,The West Cornwall Pasty Company,Eating Out,5,2495
2,12,2015,Wild Bean Cafe,Eating Out,2,2493
3,12,2015,Starbucks Coffee,Eating Out,1,2492
3,12,2015,Greggs,Eating Out,7,2485
4,12,2015,Waitrose,Groceries,65,2420
4,12,2015,Subway,Eating Out,7,2413
4,12,2015,ATM Cash Withdrawal,General,10,2403
5,12,2015,Scott's Restaurant,Eating Out,52,2351
6,12,2015,Pizza Express,Eating Out,40,2311
7,12,2015,Cubit and West rent,Rent,550,1761
7,12,2015,South West Trains,Transport,24,1737
7,12,2015,Costa Coffee,Eating Out,2,1735
7,12,2015,Subway,Eating Out,6,1729
8,12,2015,ATM Cash Withdrawal,General,20,1709
9,12,2015,Wild Bean Cafe,Eating Out,1,1708
10,12,2015,Costa Coffee,Eating Out,2,1706
10,12,2015,McDonalds,Eating Out,8,1698
11,12,2015,Waitrose,Groceries,43,1655
11,12,2015,Starbucks Coffee,Eating Out,2,1653
11,12,2015,Anglo restaurant,Eating Out,34,1619
11,12,2015,ATM Cash Withdrawal,General,20,1599
12,12,2015,Dominos Pizza,Eating Out,29,1570
13,12,2015,ATM Cash Withdrawal,General,20,1550
14,12,2015,South West Trains,Transport,33,1517
14,12,2015,Caffe Nero,Eating Out,1,1516
14,12,2015,Greggs,Eating Out,7,1509
15,12,2015,BRGAS-Electricity,Bills,37,1472
15,12,2015,BRGAS-Gas,Bills,21,1451
15,12,2015,Wild Bean Cafe,Eating Out,2,1449
15,12,2015,Subway,Eating Out,6,1443
16,12,2015,LBS Council Tax,Bills,50,1393
16,12,2015,Wild Bean Cafe,Eating Out,2,1391
16,12,2015,Greggs,Eating Out,5,1386
17,12,2015,Caffe Nero,Eating Out,1,1385
17,12,2015,ATM Cash Withdrawal,General,20,1365
18,12,2015,Sainsburys,Groceries,83,1282
18,12,2015,Costa Coffee,Eating Out,1,1281
20,12,2015,VIRGIN MEDIA PYMTS,Bills,31,1250
20,12,2015,Pizza Express,Eating Out,39,1211
21,12,2015,South West Trains,Transport,35,1176
21,12,2015,Wild Bean Cafe,Eating Out,2,1174
21,12,2015,Greggs,Eating Out,7,1167
22,12,2015,Greggs,Eating Out,4,1163
24,12,2015,O2,Bills,31,1132
24,12,2015,Caffe Nero,Eating Out,1,1131
24,12,2015,ATM Cash Withdrawal,General,10,1121
25,12,2015,Sainsburys,Groceries,52,1069
25,12,2015,Wild Bean Cafe,Eating Out,2,1067
26,12,2015,The Grand Pub,Eating Out,5,1062
26,12,2015,The Grand Pub,Eating Out,8,1054
26,12,2015,The Grand Pub,Eating Out,12,1042
26,12,2015,The Grand Pub,Eating Out,15,1027
26,12,2015,The Grand Pub,Eating Out,9,1018
26,12,2015,The Grand Pub,Eating Out,6,1012
26,12,2015,Scott's Restaurant,Eating Out,52,960
26,12,2015,ATM Cash Withdrawal,General,20,940
28,12,2015,South West Trains,Transport,35,905
28,12,2015,Caffe Nero,Eating Out,2,903
28,12,2015,Subway,Eating Out,6,897
29,12,2015,Caffe Nero,Eating Out,1,896
29,12,2015,Chicken Cottage,Eating Out,4,892
29,12,2015,ATM Cash Withdrawal,General,10,882
30,12,2015,Costa Coffee,Eating Out,2,880
30,12,2015,ATM Cash Withdrawal,General,20,860
31,12,2015,Costa Coffee,Eating Out,2,858
1,1,2016,Rhino Sports salary,General,1700,2558
1,1,2016,Waitrose,Groceries,50,2508
1,1,2016,The West Cornwall Pasty Company,Eating Out,4,2504
1,1,2016,The Grand Pub,Eating Out,13,2491
1,1,2016,Dominos Pizza,Eating Out,36,2455
3,1,2016,Scott's Restaurant,Eating Out,44,2411
3,1,2016,ATM Cash Withdrawal,General,20,2391
4,1,2016,South West Trains,Transport,35,2356
4,1,2016,Starbucks Coffee,Eating Out,2,2354
4,1,2016,McDonalds,Eating Out,8,2346
5,1,2016,Starbucks Coffee,Eating Out,1,2345
5,1,2016,Pret A Manger,Eating Out,4,2341
6,1,2016,Wild Bean Cafe,Eating Out,1,2340
6,1,2016,ATM Cash Withdrawal,General,10,2330
7,1,2016,Cubit and West rent,Rent,550,1780
7,1,2016,Wild Bean Cafe,Eating Out,2,1778
7,1,2016,Pret A Manger,Eating Out,8,1770
8,1,2016,Tescos,Groceries,62,1708
8,1,2016,Starbucks Coffee,Eating Out,1,1707
8,1,2016,Subway,Eating Out,6,1701
8,1,2016,Dominos Pizza,Eating Out,32,1669
8,1,2016,ATM Cash Withdrawal,General,20,1649
9,1,2016,Anglo restaurant,Eating Out,38,1611
9,1,2016,ATM Cash Withdrawal,General,10,1601
10,1,2016,Scott's Restaurant,Eating Out,37,1564
11,1,2016,South West Trains,Transport,31,1533
11,1,2016,Costa Coffee,Eating Out,2,1531
11,1,2016,Pret A Manger,Eating Out,6,1525
12,1,2016,Wild Bean Cafe,Eating Out,2,1523
12,1,2016,Subway,Eating Out,6,1517
13,1,2016,Wild Bean Cafe,Eating Out,1,1516
13,1,2016,Subway,Eating Out,5,1511
14,1,2016,Costa Coffee,Eating Out,2,1509
15,1,2016,BRGAS-Electricity,Bills,57,1452
15,1,2016,BRGAS-Gas,Bills,50,1402
15,1,2016,Tescos,Groceries,88,1314
15,1,2016,Caffe Nero,Eating Out,1,1313
15,1,2016,The West Cornwall Pasty Company,Eating Out,7,1306
15,1,2016,Pizza Express,Eating Out,27,1279
16,1,2016,LBS Council Tax,Bills,50,1229
16,1,2016,ATM Cash Withdrawal,General,20,1209
18,1,2016,South West Trains,Transport,30,1179
18,1,2016,Starbucks Coffee,Eating Out,2,1177
18,1,2016,Greggs,Eating Out,4,1173
20,1,2016,VIRGIN MEDIA PYMTS,Bills,51,1122
20,1,2016,Caffe Nero,Eating Out,1,1121
20,1,2016,Pret A Manger,Eating Out,7,1114
20,1,2016,ATM Cash Withdrawal,General,10,1104
21,1,2016,Caffe Nero,Eating Out,1,1103
21,1,2016,The West Cornwall Pasty Company,Eating Out,6,1097
22,1,2016,Sainsburys,Groceries,70,1027
22,1,2016,Pret A Manger,Eating Out,4,1023
22,1,2016,Pizza Express,Eating Out,54,969
24,1,2016,O2,Bills,30,939
25,1,2016,South West Trains,Transport,32,907
25,1,2016,Starbucks Coffee,Eating Out,2,905
25,1,2016,Pret A Manger,Eating Out,4,901
26,1,2016,Starbucks Coffee,Eating Out,1,900
27,1,2016,Wild Bean Cafe,Eating Out,1,899
27,1,2016,Pret A Manger,Eating Out,6,893
28,1,2016,Subway,Eating Out,7,886
29,1,2016,ASDA,Groceries,60,826
29,1,2016,Subway,Eating Out,7,819
29,1,2016,Pizza Express,Eating Out,29,790
29,1,2016,ATM Cash Withdrawal,General,10,780
30,1,2016,The Grand Pub,Eating Out,13,767
1,2,2016,Rhino Sports salary,General,1700,2467
1,2,2016,South West Trains,Transport,33,2434
1,2,2016,Starbucks Coffee,Eating Out,2,2432
2,2,2016,Chicken Cottage,Eating Out,4,2428
2,2,2016,ATM Cash Withdrawal,General,20,2408
3,2,2016,McDonalds,Eating Out,6,2402
4,2,2016,Costa Coffee,Eating Out,2,2400
4,2,2016,McDonalds,Eating Out,7,2393
5,2,2016,Sainsburys,Groceries,54,2339
5,2,2016,Anglo restaurant,Eating Out,57,2282
6,2,2016,ATM Cash Withdrawal,General,10,2272
7,2,2016,Cubit and West rent,Rent,550,1722
7,2,2016,Restaurant Gordon RamsayPortland Restaurant,Eating Out,28,1694
7,2,2016,ATM Cash Withdrawal,General,20,1674
8,2,2016,South West Trains,Transport,37,1637
8,2,2016,Wild Bean Cafe,Eating Out,2,1635
8,2,2016,Pret A Manger,Eating Out,4,1631
9,2,2016,Caffe Nero,Eating Out,2,1629
9,2,2016,Greggs,Eating Out,6,1623
10,2,2016,McDonalds,Eating Out,8,1615
10,2,2016,ATM Cash Withdrawal,General,20,1595
11,2,2016,Wild Bean Cafe,Eating Out,2,1593
11,2,2016,Pret A Manger,Eating Out,7,1586
12,2,2016,Tescos,Groceries,48,1538
12,2,2016,Starbucks Coffee,Eating Out,2,1536
12,2,2016,Pret A Manger,Eating Out,7,1529
12,2,2016,Restaurant Gordon RamsayPortland Restaurant,Eating Out,48,1481
12,2,2016,ATM Cash Withdrawal,General,20,1461
14,2,2016,Dominos Pizza,Eating Out,50,1411
15,2,2016,BRGAS-Electricity,Bills,35,1376
15,2,2016,BRGAS-Gas,Bills,31,1345
15,2,2016,South West Trains,Transport,37,1308
15,2,2016,Wild Bean Cafe,Eating Out,1,1307
15,2,2016,Subway,Eating Out,6,1301
16,2,2016,LBS Council Tax,Bills,50,1251
16,2,2016,Pret A Manger,Eating Out,5,1246
17,2,2016,Caffe Nero,Eating Out,1,1245
17,2,2016,Subway,Eating Out,7,1238
18,2,2016,Costa Coffee,Eating Out,2,1236
18,2,2016,ATM Cash Withdrawal,General,20,1216
19,2,2016,Morrisons,Groceries,56,1160
19,2,2016,Greggs,Eating Out,4,1156
20,2,2016,VIRGIN MEDIA PYMTS,Bills,28,1128
20,2,2016,The Grand Pub,Eating Out,8,1120
20,2,2016,The Grand Pub,Eating Out,15,1105
20,2,2016,The Grand Pub,Eating Out,13,1092
20,2,2016,The Grand Pub,Eating Out,10,1082
20,2,2016,The Grand Pub,Eating Out,14,1068
20,2,2016,The Grand Pub,Eating Out,9,1059
21,2,2016,ATM Cash Withdrawal,General,20,1039
22,2,2016,South West Trains,Transport,29,1010
22,2,2016,Wild Bean Cafe,Eating Out,1,1009
22,2,2016,McDonalds,Eating Out,7,1002
23,2,2016,Starbucks Coffee,Eating Out,2,1000
23,2,2016,Greggs,Eating Out,4,996
23,2,2016,ATM Cash Withdrawal,General,10,986
24,2,2016,O2,Bills,31,955
24,2,2016,Caffe Nero,Eating Out,2,953
24,2,2016,The West Cornwall Pasty Company,Eating Out,6,947
25,2,2016,Subway,Eating Out,7,940
26,2,2016,Waitrose,Groceries,67,873
26,2,2016,Costa Coffee,Eating Out,2,871
26,2,2016,The West Cornwall Pasty Company,Eating Out,6,865
26,2,2016,Fabric Club,Eating Out,14,851
26,2,2016,Fabric Club,Eating Out,9,842
26,2,2016,Fabric Club,Eating Out,13,829
26,2,2016,Fabric Club,Eating Out,14,815
26,2,2016,Fabric Club,Eating Out,9,806
26,2,2016,Fabric Club,Eating Out,5,801
27,2,2016,ATM Cash Withdrawal,General,20,781
28,2,2016,Anglo restaurant,Eating Out,24,757
29,2,2016,South West Trains,Transport,36,721
29,2,2016,Costa Coffee,Eating Out,1,720
29,2,2016,Subway,Eating Out,8,712
29,2,2016,ATM Cash Withdrawal,General,20,692
1,3,2016,Rhino Sports salary,General,1700,2392
1,3,2016,Wild Bean Cafe,Eating Out,2,2390
1,3,2016,Chicken Cottage,Eating Out,7,2383
2,3,2016,Caffe Nero,Eating Out,1,2382
3,3,2016,Caffe Nero,Eating Out,1,2381
3,3,2016,ATM Cash Withdrawal,General,20,2361
4,3,2016,Sainsburys,Groceries,76,2285
4,3,2016,Costa Coffee,Eating Out,2,2283
4,3,2016,The West Cornwall Pasty Company,Eating Out,6,2277
4,3,2016,Scott's Restaurant,Eating Out,37,2240
6,3,2016,ATM Cash Withdrawal,General,20,2220
7,3,2016,Cubit and West rent,Rent,550,1670
7,3,2016,South West Trains,Transport,27,1643
7,3,2016,Pret A Manger,Eating Out,4,1639
8,3,2016,Costa Coffee,Eating Out,2,1637
9,3,2016,Costa Coffee,Eating Out,2,1635
9,3,2016,Subway,Eating Out,8,1627
10,3,2016,Pret A Manger,Eating Out,7,1620
11,3,2016,Tescos,Groceries,88,1532
11,3,2016,Caffe Nero,Eating Out,2,1530
13,3,2016,Dominos Pizza,Eating Out,37,1493
14,3,2016,South West Trains,Transport,32,1461
14,3,2016,Caffe Nero,Eating Out,2,1459
14,3,2016,Chicken Cottage,Eating Out,4,1455
15,3,2016,BRGAS-Electricity,Bills,28,1427
15,3,2016,BRGAS-Gas,Bills,27,1400
15,3,2016,Wild Bean Cafe,Eating Out,2,1398
16,3,2016,LBS Council Tax,Bills,50,1348
16,3,2016,Caffe Nero,Eating Out,2,1346
17,3,2016,Wild Bean Cafe,Eating Out,2,1344
17,3,2016,ATM Cash Withdrawal,General,20,1324
18,3,2016,Sainsburys,Groceries,77,1247
18,3,2016,Caffe Nero,Eating Out,1,1246
18,3,2016,ATM Cash Withdrawal,General,20,1226
19,3,2016,Pizza Express,Eating Out,59,1167
19,3,2016,ATM Cash Withdrawal,General,10,1157
20,3,2016,VIRGIN MEDIA PYMTS,Bills,35,1122
21,3,2016,South West Trains,Transport,32,1090
21,3,2016,Caffe Nero,Eating Out,1,1089
21,3,2016,McDonalds,Eating Out,4,1085
21,3,2016,ATM Cash Withdrawal,General,10,1075
22,3,2016,Wild Bean Cafe,Eating Out,2,1073
22,3,2016,Greggs,Eating Out,5,1068
23,3,2016,McDonalds,Eating Out,4,1064
24,3,2016,O2,Bills,38,1026
25,3,2016,Tescos,Groceries,60,966
25,3,2016,Caffe Nero,Eating Out,2,964
28,3,2016,South West Trains,Transport,26,938
28,3,2016,McDonalds,Eating Out,4,934
28,3,2016,ATM Cash Withdrawal,General,20,914
29,3,2016,Wild Bean Cafe,Eating Out,2,912
30,3,2016,Wild Bean Cafe,Eating Out,1,911
31,3,2016,Wild Bean Cafe,Eating Out,2,909
31,3,2016,Pret A Manger,Eating Out,7,902
1,4,2016,Rhino Sports salary,General,1700,2602
1,4,2016,Tescos,Groceries,61,2541
1,4,2016,Caffe Nero,Eating Out,2,2539
1,4,2016,Restaurant Gordon RamsayPortland Restaurant,Eating Out,38,2501
2,4,2016,Pizza Express,Eating Out,51,2450
3,4,2016,Dominos Pizza,Eating Out,42,2408
4,4,2016,South West Trains,Transport,37,2371
5,4,2016,Costa Coffee,Eating Out,2,2369
5,4,2016,The West Cornwall Pasty Company,Eating Out,8,2361
5,4,2016,ATM Cash Withdrawal,General,20,2341
6,4,2016,McDonalds,Eating Out,6,2335
7,4,2016,Cubit and West rent,Rent,550,1785
8,4,2016,Waitrose,Groceries,53,1732
8,4,2016,Wild Bean Cafe,Eating Out,1,1731
9,4,2016,Pizza Express,Eating Out,25,1706
11,4,2016,South West Trains,Transport,31,1675
11,4,2016,Caffe Nero,Eating Out,1,1674
11,4,2016,Chicken Cottage,Eating Out,5,1669
12,4,2016,Caffe Nero,Eating Out,2,1667
12,4,2016,The West Cornwall Pasty Company,Eating Out,6,1661
13,4,2016,Starbucks Coffee,Eating Out,2,1659
13,4,2016,The West Cornwall Pasty Company,Eating Out,8,1651
14,4,2016,Greggs,Eating Out,4,1647
15,4,2016,BRGAS-Electricity,Bills,37,1610
15,4,2016,BRGAS-Gas,Bills,28,1582
15,4,2016,ASDA,Groceries,81,1501
15,4,2016,Costa Coffee,Eating Out,1,1500
15,4,2016,ATM Cash Withdrawal,General,10,1490
16,4,2016,LBS Council Tax,Bills,50,1440
17,4,2016,ATM Cash Withdrawal,General,10,1430
18,4,2016,South West Trains,Transport,24,1406
18,4,2016,Wild Bean Cafe,Eating Out,2,1404
18,4,2016,Pret A Manger,Eating Out,5,1399
19,4,2016,Wild Bean Cafe,Eating Out,2,1397
19,4,2016,Pret A Manger,Eating Out,6,1391
20,4,2016,VIRGIN MEDIA PYMTS,Bills,28,1363
20,4,2016,Pret A Manger,Eating Out,4,1359
21,4,2016,Wild Bean Cafe,Eating Out,1,1358
22,4,2016,ASDA,Groceries,52,1306
22,4,2016,Wild Bean Cafe,Eating Out,2,1304
22,4,2016,Ministry of Sound ClubXOYO Club,Eating Out,10,1294
22,4,2016,Restaurant Gordon RamsayPortland Restaurant,Eating Out,33,1261
22,4,2016,ATM Cash Withdrawal,General,20,1241
23,4,2016,ATM Cash Withdrawal,General,20,1221
24,4,2016,O2,Bills,32,1189
24,4,2016,Dominos Pizza,Eating Out,41,1148
24,4,2016,ATM Cash Withdrawal,General,20,1128
25,4,2016,South West Trains,Transport,33,1095
25,4,2016,Starbucks Coffee,Eating Out,1,1094
25,4,2016,Greggs,Eating Out,5,1089
25,4,2016,ATM Cash Withdrawal,General,20,1069
26,4,2016,Caffe Nero,Eating Out,2,1067
26,4,2016,ATM Cash Withdrawal,General,20,1047
29,4,2016,Waitrose,Groceries,85,962
29,4,2016,Wild Bean Cafe,Eating Out,2,960
29,4,2016,Subway,Eating Out,5,955
30,4,2016,Pizza Express,Eating Out,55,900
1,5,2016,Rhino Sports salary,General,1700,2600
2,5,2016,South West Trains,Transport,33,2567
3,5,2016,Costa Coffee,Eating Out,1,2566
3,5,2016,Pret A Manger,Eating Out,7,2559
3,5,2016,ATM Cash Withdrawal,General,10,2549
5,5,2016,Costa Coffee,Eating Out,1,2548
5,5,2016,Chicken Cottage,Eating Out,8,2540
6,5,2016,Waitrose,Groceries,50,2490
6,5,2016,Caffe Nero,Eating Out,1,2489
6,5,2016,Chicken Cottage,Eating Out,8,2481
6,5,2016,Heaven Club,Eating Out,7,2474
6,5,2016,Heaven Club,Eating Out,9,2465
6,5,2016,Heaven Club,Eating Out,6,2459
7,5,2016,Cubit and West rent,Rent,550,1909
7,5,2016,ATM Cash Withdrawal,General,20,1889
8,5,2016,ATM Cash Withdrawal,General,10,1879
9,5,2016,South West Trains,Transport,29,1850
9,5,2016,Costa Coffee,Eating Out,2,1848
9,5,2016,The West Cornwall Pasty Company,Eating Out,5,1843
10,5,2016,The West Cornwall Pasty Company,Eating Out,7,1836
10,5,2016,ATM Cash Withdrawal,General,20,1816
11,5,2016,Subway,Eating Out,6,1810
12,5,2016,Starbucks Coffee,Eating Out,2,1808
12,5,2016,The West Cornwall Pasty Company,Eating Out,6,1802
12,5,2016,ATM Cash Withdrawal,General,20,1782
13,5,2016,ASDA,Groceries,86,1696
13,5,2016,Costa Coffee,Eating Out,2,1694
13,5,2016,Pret A Manger,Eating Out,4,1690
14,5,2016,ATM Cash Withdrawal,General,10,1680
15,5,2016,BRGAS-Electricity,Bills,33,1647
15,5,2016,BRGAS-Gas,Bills,22,1625
15,5,2016,Pizza Express,Eating Out,38,1587
16,5,2016,LBS Council Tax,Bills,50,1537
16,5,2016,South West Trains,Transport,27,1510
16,5,2016,Caffe Nero,Eating Out,1,1509
16,5,2016,Pret A Manger,Eating Out,5,1504
16,5,2016,ATM Cash Withdrawal,General,10,1494
17,5,2016,Caffe Nero,Eating Out,2,1492
17,5,2016,McDonalds,Eating Out,7,1485
18,5,2016,Caffe Nero,Eating Out,2,1483
18,5,2016,Chicken Cottage,Eating Out,4,1479
18,5,2016,ATM Cash Withdrawal,General,10,1469
19,5,2016,Costa Coffee,Eating Out,2,1467
20,5,2016,VIRGIN MEDIA PYMTS,Bills,40,1427
20,5,2016,Tescos,Groceries,77,1350
20,5,2016,Caffe Nero,Eating Out,2,1348
20,5,2016,ATM Cash Withdrawal,General,10,1338
21,5,2016,Restaurant Gordon RamsayPortland Restaurant,Eating Out,45,1293
22,5,2016,Anglo restaurant,Eating Out,50,1243
23,5,2016,South West Trains,Transport,31,1212
23,5,2016,Starbucks Coffee,Eating Out,2,1210
24,5,2016,O2,Bills,34,1176
24,5,2016,Wild Bean Cafe,Eating Out,1,1175
24,5,2016,The West Cornwall Pasty Company,Eating Out,4,1171
25,5,2016,Wild Bean Cafe,Eating Out,2,1169
25,5,2016,McDonalds,Eating Out,5,1164
26,5,2016,Wild Bean Cafe,Eating Out,1,1163
26,5,2016,Pret A Manger,Eating Out,7,1156
27,5,2016,Waitrose,Groceries,50,1106
27,5,2016,Costa Coffee,Eating Out,1,1105
27,5,2016,McDonalds,Eating Out,4,1101
29,5,2016,Scott's Restaurant,Eating Out,48,1053
30,5,2016,South West Trains,Transport,31,1022
30,5,2016,Starbucks Coffee,Eating Out,1,1021
30,5,2016,Subway,Eating Out,8,1013
31,5,2016,Starbucks Coffee,Eating Out,1,1012
1,6,2016,Rhino Sports salary,General,1700,2712
1,6,2016,Caffe Nero,Eating Out,1,2711
1,6,2016,Greggs,Eating Out,5,2706
1,6,2016,ATM Cash Withdrawal,General,20,2686
2,6,2016,Pret A Manger,Eating Out,6,2680
3,6,2016,Tescos,Groceries,72,2608
3,6,2016,Caffe Nero,Eating Out,2,2606
3,6,2016,Chicken Cottage,Eating Out,7,2599
3,6,2016,Scott's Restaurant,Eating Out,31,2568
4,6,2016,Dominos Pizza,Eating Out,52,2516
4,6,2016,ATM Cash Withdrawal,General,10,2506
5,6,2016,Pizza Express,Eating Out,43,2463
5,6,2016,ATM Cash Withdrawal,General,10,2453
6,6,2016,South West Trains,Transport,36,2417
6,6,2016,Greggs,Eating Out,4,2413
7,6,2016,Cubit and West rent,Rent,550,1863
7,6,2016,Costa Coffee,Eating Out,2,1861
7,6,2016,Pret A Manger,Eating Out,5,1856
9,6,2016,Chicken Cottage,Eating Out,4,1852
9,6,2016,ATM Cash Withdrawal,General,20,1832
10,6,2016,ASDA,Groceries,52,1780
10,6,2016,Costa Coffee,Eating Out,2,1778
10,6,2016,Greggs,Eating Out,5,1773
10,6,2016,ATM Cash Withdrawal,General,20,1753
11,6,2016,Heaven Club,Eating Out,16,1737
11,6,2016,Heaven Club,Eating Out,14,1723
11,6,2016,Heaven Club,Eating Out,16,1707
11,6,2016,Heaven Club,Eating Out,13,1694
11,6,2016,Heaven Club,Eating Out,8,1686
13,6,2016,South West Trains,Transport,27,1659
13,6,2016,Costa Coffee,Eating Out,2,1657
13,6,2016,Chicken Cottage,Eating Out,7,1650
14,6,2016,Starbucks Coffee,Eating Out,2,1648
14,6,2016,McDonalds,Eating Out,8,1640
15,6,2016,BRGAS-Electricity,Bills,36,1604
15,6,2016,BRGAS-Gas,Bills,22,1582
15,6,2016,Starbucks Coffee,Eating Out,2,1580
15,6,2016,ATM Cash Withdrawal,General,20,1560
16,6,2016,LBS Council Tax,Bills,50,1510
16,6,2016,Costa Coffee,Eating Out,1,1509
16,6,2016,The West Cornwall Pasty Company,Eating Out,6,1503
17,6,2016,Morrisons,Groceries,70,1433
17,6,2016,Costa Coffee,Eating Out,2,1431
17,6,2016,Chicken Cottage,Eating Out,7,1424
17,6,2016,ATM Cash Withdrawal,General,20,1404
18,6,2016,Ministry of Sound ClubXOYO Club,Eating Out,11,1393
18,6,2016,Ministry of Sound ClubXOYO Club,Eating Out,11,1382
18,6,2016,Ministry of Sound ClubXOYO Club,Eating Out,8,1374
18,6,2016,Ministry of Sound ClubXOYO Club,Eating Out,9,1365
18,6,2016,Ministry of Sound ClubXOYO Club,Eating Out,10,1355
18,6,2016,Ministry of Sound ClubXOYO Club,Eating Out,14,1341
19,6,2016,Dominos Pizza,Eating Out,45,1296
19,6,2016,ATM Cash Withdrawal,General,10,1286
20,6,2016,VIRGIN MEDIA PYMTS,Bills,41,1245
20,6,2016,South West Trains,Transport,33,1212
20,6,2016,Costa Coffee,Eating Out,2,1210
20,6,2016,ATM Cash Withdrawal,General,10,1200
21,6,2016,Wild Bean Cafe,Eating Out,1,1199
21,6,2016,ATM Cash Withdrawal,General,20,1179
22,6,2016,Caffe Nero,Eating Out,2,1177
22,6,2016,Subway,Eating Out,8,1169
22,6,2016,ATM Cash Withdrawal,General,20,1149
23,6,2016,Subway,Eating Out,6,1143
24,6,2016,O2,Bills,30,1113
24,6,2016,Sainsburys,Groceries,57,1056
24,6,2016,Costa Coffee,Eating Out,1,1055
24,6,2016,McDonalds,Eating Out,5,1050
24,6,2016,Scott's Restaurant,Eating Out,53,997
24,6,2016,ATM Cash Withdrawal,General,20,977
25,6,2016,ATM Cash Withdrawal,General,10,967
27,6,2016,South West Trains,Transport,26,941
27,6,2016,Starbucks Coffee,Eating Out,2,939
27,6,2016,Greggs,Eating Out,7,932
28,6,2016,Costa Coffee,Eating Out,2,930
29,6,2016,The West Cornwall Pasty Company,Eating Out,4,926
30,6,2016,Greggs,Eating Out,6,920
1,7,2016,Rhino Sports salary,General,1700,2620
1,7,2016,Waitrose,Groceries,82,2538
1,7,2016,Caffe Nero,Eating Out,1,2537
1,7,2016,The West Cornwall Pasty Company,Eating Out,4,2533
1,7,2016,ATM Cash Withdrawal,General,10,2523
2,7,2016,ATM Cash Withdrawal,General,10,2513
3,7,2016,Anglo restaurant,Eating Out,27,2486
3,7,2016,ATM Cash Withdrawal,General,10,2476
4,7,2016,South West Trains,Transport,38,2438
4,7,2016,Caffe Nero,Eating Out,2,2436
4,7,2016,Greggs,Eating Out,6,2430
4,7,2016,ATM Cash Withdrawal,General,10,2420
5,7,2016,Greggs,Eating Out,6,2414
6,7,2016,Costa Coffee,Eating Out,1,2413
6,7,2016,ATM Cash Withdrawal,General,20,2393
7,7,2016,Cubit and West rent,Rent,550,1843
7,7,2016,Starbucks Coffee,Eating Out,2,1841
8,7,2016,ASDA,Groceries,84,1757
10,7,2016,ATM Cash Withdrawal,General,10,1747
11,7,2016,South West Trains,Transport,34,1713
11,7,2016,Starbucks Coffee,Eating Out,2,1711
11,7,2016,The West Cornwall Pasty Company,Eating Out,8,1703
11,7,2016,ATM Cash Withdrawal,General,20,1683
12,7,2016,Caffe Nero,Eating Out,2,1681
12,7,2016,Pret A Manger,Eating Out,8,1673
13,7,2016,Chicken Cottage,Eating Out,7,1666
14,7,2016,Caffe Nero,Eating Out,2,1664
15,7,2016,BRGAS-Electricity,Bills,28,1636
15,7,2016,BRGAS-Gas,Bills,32,1604
15,7,2016,Waitrose,Groceries,69,1535
15,7,2016,Wild Bean Cafe,Eating Out,2,1533
16,7,2016,LBS Council Tax,Bills,50,1483
16,7,2016,Scott's Restaurant,Eating Out,40,1443
18,7,2016,South West Trains,Transport,35,1408
18,7,2016,Caffe Nero,Eating Out,1,1407
18,7,2016,Pret A Manger,Eating Out,8,1399
18,7,2016,ATM Cash Withdrawal,General,10,1389
19,7,2016,Wild Bean Cafe,Eating Out,2,1387
19,7,2016,The West Cornwall Pasty Company,Eating Out,4,1383
19,7,2016,ATM Cash Withdrawal,General,10,1373
20,7,2016,VIRGIN MEDIA PYMTS,Bills,39,1334
20,7,2016,The West Cornwall Pasty Company,Eating Out,6,1328
21,7,2016,Costa Coffee,Eating Out,2,1326
21,7,2016,Subway,Eating Out,7,1319
22,7,2016,Sainsburys,Groceries,45,1274
22,7,2016,Pizza Express,Eating Out,59,1215
23,7,2016,Dominos Pizza,Eating Out,52,1163
24,7,2016,O2,Bills,35,1128
25,7,2016,South West Trains,Transport,29,1099
25,7,2016,Wild Bean Cafe,Eating Out,2,1097
25,7,2016,McDonalds,Eating Out,8,1089
26,7,2016,Costa Coffee,Eating Out,2,1087
26,7,2016,ATM Cash Withdrawal,General,10,1077
27,7,2016,Caffe Nero,Eating Out,2,1075
27,7,2016,Subway,Eating Out,6,1069
28,7,2016,Wild Bean Cafe,Eating Out,1,1068
28,7,2016,ATM Cash Withdrawal,General,10,1058
29,7,2016,Morrisons,Groceries,87,971
29,7,2016,Caffe Nero,Eating Out,1,970
31,7,2016,Dominos Pizza,Eating Out,51,919
1,8,2016,Rhino Sports salary,General,1700,2619
1,8,2016,South West Trains,Transport,26,2593
1,8,2016,Wild Bean Cafe,Eating Out,2,2591
1,8,2016,Subway,Eating Out,5,2586
2,8,2016,Caffe Nero,Eating Out,1,2585
2,8,2016,McDonalds,Eating Out,6,2579
3,8,2016,Starbucks Coffee,Eating Out,2,2577
3,8,2016,Subway,Eating Out,7,2570
4,8,2016,Caffe Nero,Eating Out,1,2569
4,8,2016,ATM Cash Withdrawal,General,20,2549
5,8,2016,Morrisons,Groceries,62,2487
5,8,2016,Wild Bean Cafe,Eating Out,2,2485
5,8,2016,Chicken Cottage,Eating Out,7,2478
6,8,2016,ATM Cash Withdrawal,General,20,2458
7,8,2016,Cubit and West rent,Rent,550,1908
8,8,2016,South West Trains,Transport,29,1879
8,8,2016,The West Cornwall Pasty Company,Eating Out,6,1873
8,8,2016,ATM Cash Withdrawal,General,10,1863
9,8,2016,Starbucks Coffee,Eating Out,1,1862
9,8,2016,Pret A Manger,Eating Out,7,1855
9,8,2016,ATM Cash Withdrawal,General,10,1845
10,8,2016,Wild Bean Cafe,Eating Out,1,1844
10,8,2016,ATM Cash Withdrawal,General,20,1824
11,8,2016,Starbucks Coffee,Eating Out,1,1823
12,8,2016,ASDA,Groceries,66,1757
12,8,2016,Costa Coffee,Eating Out,2,1755
12,8,2016,Scott's Restaurant,Eating Out,59,1696
13,8,2016,Heaven Club,Eating Out,16,1680
13,8,2016,Heaven Club,Eating Out,15,1665
15,8,2016,BRGAS-Electricity,Bills,30,1635
15,8,2016,BRGAS-Gas,Bills,28,1607
15,8,2016,South West Trains,Transport,37,1570
15,8,2016,ATM Cash Withdrawal,General,20,1550
16,8,2016,LBS Council Tax,Bills,50,1500
16,8,2016,Costa Coffee,Eating Out,2,1498
17,8,2016,Wild Bean Cafe,Eating Out,2,1496
18,8,2016,Costa Coffee,Eating Out,2,1494
18,8,2016,Pret A Manger,Eating Out,4,1490
19,8,2016,ASDA,Groceries,77,1413
19,8,2016,Wild Bean Cafe,Eating Out,1,1412
19,8,2016,Subway,Eating Out,5,1407
19,8,2016,Ministry of Sound ClubXOYO Club,Eating Out,9,1398
19,8,2016,Ministry of Sound ClubXOYO Club,Eating Out,12,1386
19,8,2016,Ministry of Sound ClubXOYO Club,Eating Out,13,1373
19,8,2016,Ministry of Sound ClubXOYO Club,Eating Out,9,1364
19,8,2016,Ministry of Sound ClubXOYO Club,Eating Out,8,1356
19,8,2016,Ministry of Sound ClubXOYO Club,Eating Out,7,1349
20,8,2016,VIRGIN MEDIA PYMTS,Bills,55,1294
21,8,2016,Restaurant Gordon RamsayPortland Restaurant,Eating Out,27,1267
21,8,2016,ATM Cash Withdrawal,General,10,1257
22,8,2016,South West Trains,Transport,28,1229
22,8,2016,Wild Bean Cafe,Eating Out,2,1227
22,8,2016,McDonalds,Eating Out,7,1220
23,8,2016,Wild Bean Cafe,Eating Out,2,1218
23,8,2016,Chicken Cottage,Eating Out,7,1211
23,8,2016,ATM Cash Withdrawal,General,10,1201
24,8,2016,O2,Bills,31,1170
24,8,2016,Starbucks Coffee,Eating Out,1,1169
24,8,2016,Greggs,Eating Out,6,1163
25,8,2016,Costa Coffee,Eating Out,1,1162
25,8,2016,Subway,Eating Out,8,1154
26,8,2016,Sainsburys,Groceries,45,1109
26,8,2016,Costa Coffee,Eating Out,2,1107
26,8,2016,McDonalds,Eating Out,6,1101
26,8,2016,Pizza Express,Eating Out,33,1068
26,8,2016,ATM Cash Withdrawal,General,10,1058
27,8,2016,ATM Cash Withdrawal,General,10,1048
29,8,2016,South West Trains,Transport,33,1015
29,8,2016,Wild Bean Cafe,Eating Out,2,1013
29,8,2016,Greggs,Eating Out,5,1008
30,8,2016,Starbucks Coffee,Eating Out,2,1006
30,8,2016,Subway,Eating Out,7,999
30,8,2016,ATM Cash Withdrawal,General,10,989
31,8,2016,Wild Bean Cafe,Eating Out,2,987
31,8,2016,Chicken Cottage,Eating Out,6,981
1,9,2016,Rhino Sports salary,General,1700,2681
2,9,2016,Tescos,Groceries,78,2603
2,9,2016,Wild Bean Cafe,Eating Out,2,2601
2,9,2016,Greggs,Eating Out,7,2594
3,9,2016,ATM Cash Withdrawal,General,20,2574
4,9,2016,Dominos Pizza,Eating Out,38,2536
4,9,2016,ATM Cash Withdrawal,General,20,2516
5,9,2016,South West Trains,Transport,38,2478
5,9,2016,Wild Bean Cafe,Eating Out,2,2476
5,9,2016,McDonalds,Eating Out,6,2470
5,9,2016,ATM Cash Withdrawal,General,10,2460
6,9,2016,Starbucks Coffee,Eating Out,2,2458
6,9,2016,McDonalds,Eating Out,8,2450
6,9,2016,ATM Cash Withdrawal,General,10,2440
7,9,2016,Cubit and West rent,Rent,550,1890
7,9,2016,Starbucks Coffee,Eating Out,2,1888
7,9,2016,Subway,Eating Out,8,1880
8,9,2016,Caffe Nero,Eating Out,2,1878
8,9,2016,The West Cornwall Pasty Company,Eating Out,5,1873
9,9,2016,Waitrose,Groceries,71,1802
9,9,2016,Caffe Nero,Eating Out,2,1800
9,9,2016,Subway,Eating Out,7,1793
11,9,2016,Anglo restaurant,Eating Out,25,1768
12,9,2016,South West Trains,Transport,31,1737
12,9,2016,Starbucks Coffee,Eating Out,2,1735
12,9,2016,Greggs,Eating Out,5,1730
13,9,2016,The West Cornwall Pasty Company,Eating Out,7,1723
13,9,2016,ATM Cash Withdrawal,General,10,1713
14,9,2016,Chicken Cottage,Eating Out,8,1705
15,9,2016,BRGAS-Electricity,Bills,30,1675
15,9,2016,BRGAS-Gas,Bills,31,1644
15,9,2016,Costa Coffee,Eating Out,2,1642
15,9,2016,Greggs,Eating Out,4,1638
16,9,2016,LBS Council Tax,Bills,50,1588
16,9,2016,Sainsburys,Groceries,74,1514
16,9,2016,Anglo restaurant,Eating Out,53,1461
18,9,2016,Restaurant Gordon RamsayPortland Restaurant,Eating Out,32,1429
19,9,2016,South West Trains,Transport,29,1400
19,9,2016,Starbucks Coffee,Eating Out,1,1399
19,9,2016,The West Cornwall Pasty Company,Eating Out,8,1391
20,9,2016,VIRGIN MEDIA PYMTS,Bills,42,1349
20,9,2016,Wild Bean Cafe,Eating Out,1,1348
20,9,2016,McDonalds,Eating Out,6,1342
21,9,2016,Wild Bean Cafe,Eating Out,1,1341
21,9,2016,The West Cornwall Pasty Company,Eating Out,5,1336
22,9,2016,Starbucks Coffee,Eating Out,2,1334
23,9,2016,Waitrose,Groceries,52,1282
23,9,2016,Caffe Nero,Eating Out,2,1280
23,9,2016,The West Cornwall Pasty Company,Eating Out,8,1272
24,9,2016,O2,Bills,37,1235
24,9,2016,Dominos Pizza,Eating Out,27,1208
24,9,2016,ATM Cash Withdrawal,General,10,1198
25,9,2016,Scott's Restaurant,Eating Out,45,1153
26,9,2016,South West Trains,Transport,31,1122
26,9,2016,Subway,Eating Out,8,1114
27,9,2016,Wild Bean Cafe,Eating Out,2,1112
27,9,2016,ATM Cash Withdrawal,General,10,1102
28,9,2016,The West Cornwall Pasty Company,Eating Out,5,1097
28,9,2016,ATM Cash Withdrawal,General,20,1077
29,9,2016,Wild Bean Cafe,Eating Out,2,1075
29,9,2016,McDonalds,Eating Out,7,1068
30,9,2016,Morrisons,Groceries,71,997
30,9,2016,Wild Bean Cafe,Eating Out,2,995
30,9,2016,Dominos Pizza,Eating Out,33,962
1,10,2016,Rhino Sports salary,General,1700,2662
1,10,2016,Restaurant Gordon RamsayPortland Restaurant,Eating Out,43,2619
1,10,2016,ATM Cash Withdrawal,General,20,2599
2,10,2016,Scott's Restaurant,Eating Out,52,2547
2,10,2016,ATM Cash Withdrawal,General,10,2537
3,10,2016,South West Trains,Transport,37,2500
3,10,2016,Wild Bean Cafe,Eating Out,2,2498
3,10,2016,Chicken Cottage,Eating Out,8,2490
4,10,2016,Pret A Manger,Eating Out,5,2485
4,10,2016,ATM Cash Withdrawal,General,10,2475
5,10,2016,McDonalds,Eating Out,5,2470
6,10,2016,Wild Bean Cafe,Eating Out,2,2468
6,10,2016,Pret A Manger,Eating Out,6,2462
6,10,2016,ATM Cash Withdrawal,General,10,2452
7,10,2016,Cubit and West rent,Rent,550,1902
7,10,2016,ASDA,Groceries,64,1838
7,10,2016,Starbucks Coffee,Eating Out,2,1836
7,10,2016,Pret A Manger,Eating Out,7,1829
10,10,2016,South West Trains,Transport,25,1804
10,10,2016,Wild Bean Cafe,Eating Out,1,1803
10,10,2016,Pret A Manger,Eating Out,4,1799
11,10,2016,Costa Coffee,Eating Out,1,1798
11,10,2016,Greggs,Eating Out,5,1793
12,10,2016,Costa Coffee,Eating Out,2,1791
12,10,2016,Chicken Cottage,Eating Out,5,1786
13,10,2016,Wild Bean Cafe,Eating Out,2,1784
14,10,2016,Sainsburys,Groceries,54,1730
14,10,2016,Starbucks Coffee,Eating Out,2,1728
14,10,2016,Pizza Express,Eating Out,57,1671
15,10,2016,BRGAS-Electricity,Bills,44,1627
15,10,2016,BRGAS-Gas,Bills,44,1583
16,10,2016,LBS Council Tax,Bills,50,1533
17,10,2016,South West Trains,Transport,25,1508
17,10,2016,Chicken Cottage,Eating Out,4,1504
18,10,2016,Costa Coffee,Eating Out,2,1502
19,10,2016,Costa Coffee,Eating Out,2,1500
19,10,2016,ATM Cash Withdrawal,General,10,1490
20,10,2016,VIRGIN MEDIA PYMTS,Bills,39,1451
20,10,2016,Caffe Nero,Eating Out,2,1449
20,10,2016,Subway,Eating Out,5,1444
21,10,2016,Sainsburys,Groceries,44,1400
21,10,2016,Caffe Nero,Eating Out,1,1399
21,10,2016,Subway,Eating Out,8,1391
21,10,2016,Heaven Club,Eating Out,12,1379
21,10,2016,Heaven Club,Eating Out,8,1371
21,10,2016,Heaven Club,Eating Out,6,1365
21,10,2016,Anglo restaurant,Eating Out,25,1340
24,10,2016,O2,Bills,34,1306
24,10,2016,South West Trains,Transport,33,1273
24,10,2016,Starbucks Coffee,Eating Out,2,1271
24,10,2016,Chicken Cottage,Eating Out,6,1265
25,10,2016,Wild Bean Cafe,Eating Out,1,1264
26,10,2016,Starbucks Coffee,Eating Out,1,1263
27,10,2016,Costa Coffee,Eating Out,2,1261
28,10,2016,ASDA,Groceries,68,1193
28,10,2016,Starbucks Coffee,Eating Out,1,1192
28,10,2016,The West Cornwall Pasty Company,Eating Out,7,1185
28,10,2016,Heaven Club,Eating Out,15,1170
28,10,2016,Heaven Club,Eating Out,8,1162
28,10,2016,Heaven Club,Eating Out,16,1146
28,10,2016,Heaven Club,Eating Out,16,1130
28,10,2016,Scott's Restaurant,Eating Out,36,1094
29,10,2016,ATM Cash Withdrawal,General,10,1084
30,10,2016,ATM Cash Withdrawal,General,20,1064
31,10,2016,South West Trains,Transport,37,1027
31,10,2016,Wild Bean Cafe,Eating Out,2,1025
31,10,2016,Greggs,Eating Out,4,1021
1,11,2016,Rhino Sports salary,General,1700,2721
1,11,2016,Wild Bean Cafe,Eating Out,2,2719
1,11,2016,Greggs,Eating Out,7,2712
2,11,2016,Pret A Manger,Eating Out,6,2706
3,11,2016,Costa Coffee,Eating Out,1,2705
4,11,2016,Sainsburys,Groceries,55,2650
4,11,2016,ATM Cash Withdrawal,General,10,2640
6,11,2016,Restaurant Gordon RamsayPortland Restaurant,Eating Out,25,2615
6,11,2016,ATM Cash Withdrawal,General,20,2595
7,11,2016,Cubit and West rent,Rent,550,2045
7,11,2016,South West Trains,Transport,29,2016
7,11,2016,Caffe Nero,Eating Out,2,2014
7,11,2016,Greggs,Eating Out,7,2007
7,11,2016,ATM Cash Withdrawal,General,20,1987
8,11,2016,Starbucks Coffee,Eating Out,1,1986
8,11,2016,ATM Cash Withdrawal,General,10,1976
9,11,2016,Caffe Nero,Eating Out,2,1974
9,11,2016,ATM Cash Withdrawal,General,10,1964
10,11,2016,Greggs,Eating Out,5,1959
11,11,2016,Waitrose,Groceries,69,1890
11,11,2016,Costa Coffee,Eating Out,1,1889
11,11,2016,Subway,Eating Out,6,1883
11,11,2016,Dominos Pizza,Eating Out,55,1828
11,11,2016,ATM Cash Withdrawal,General,10,1818
12,11,2016,Fabric Club,Eating Out,9,1809
12,11,2016,Fabric Club,Eating Out,14,1795
12,11,2016,Fabric Club,Eating Out,16,1779
12,11,2016,ATM Cash Withdrawal,General,20,1759
14,11,2016,South West Trains,Transport,26,1733
14,11,2016,Starbucks Coffee,Eating Out,2,1731
14,11,2016,McDonalds,Eating Out,5,1726
14,11,2016,ATM Cash Withdrawal,General,20,1706
15,11,2016,BRGAS-Electricity,Bills,55,1651
15,11,2016,BRGAS-Gas,Bills,34,1617
15,11,2016,Starbucks Coffee,Eating Out,2,1615
15,11,2016,Chicken Cottage,Eating Out,4,1611
16,11,2016,LBS Council Tax,Bills,50,1561
16,11,2016,Caffe Nero,Eating Out,1,1560
16,11,2016,Greggs,Eating Out,4,1556
16,11,2016,ATM Cash Withdrawal,General,10,1546
17,11,2016,Wild Bean Cafe,Eating Out,1,1545
17,11,2016,McDonalds,Eating Out,5,1540
18,11,2016,Tescos,Groceries,79,1461
18,11,2016,Starbucks Coffee,Eating Out,2,1459
18,11,2016,Pret A Manger,Eating Out,4,1455
20,11,2016,VIRGIN MEDIA PYMTS,Bills,52,1403
20,11,2016,ATM Cash Withdrawal,General,20,1383
21,11,2016,South West Trains,Transport,30,1353
21,11,2016,Starbucks Coffee,Eating Out,1,1352
21,11,2016,The West Cornwall Pasty Company,Eating Out,5,1347
22,11,2016,Starbucks Coffee,Eating Out,1,1346
22,11,2016,The West Cornwall Pasty Company,Eating Out,6,1340
23,11,2016,McDonalds,Eating Out,8,1332
23,11,2016,ATM Cash Withdrawal,General,20,1312
24,11,2016,O2,Bills,34,1278
24,11,2016,Costa Coffee,Eating Out,2,1276
24,11,2016,Subway,Eating Out,7,1269
25,11,2016,Morrisons,Groceries,56,1213
25,11,2016,Wild Bean Cafe,Eating Out,2,1211
25,11,2016,Restaurant Gordon RamsayPortland Restaurant,Eating Out,24,1187
26,11,2016,Pizza Express,Eating Out,29,1158
28,11,2016,South West Trains,Transport,37,1121
28,11,2016,Caffe Nero,Eating Out,1,1120
28,11,2016,Greggs,Eating Out,5,1115
29,11,2016,Costa Coffee,Eating Out,2,1113
30,11,2016,Caffe Nero,Eating Out,2,1111
30,11,2016,Greggs,Eating Out,4,1107
30,11,2016,ATM Cash Withdrawal,General,20,1087
1,12,2016,Rhino Sports salary,General,1700,2787
2,12,2016,Tescos,Groceries,64,2723
2,12,2016,Caffe Nero,Eating Out,1,2722
2,12,2016,Chicken Cottage,Eating Out,5,2717
2,12,2016,Pizza Express,Eating Out,32,2685
2,12,2016,ATM Cash Withdrawal,General,20,2665
3,12,2016,ATM Cash Withdrawal,General,20,2645
5,12,2016,South West Trains,Transport,34,2611
5,12,2016,Caffe Nero,Eating Out,2,2609
5,12,2016,Chicken Cottage,Eating Out,4,2605
6,12,2016,Caffe Nero,Eating Out,2,2603
6,12,2016,Pret A Manger,Eating Out,5,2598
7,12,2016,Cubit and West rent,Rent,550,2048
7,12,2016,Caffe Nero,Eating Out,2,2046
7,12,2016,Subway,Eating Out,6,2040
8,12,2016,Costa Coffee,Eating Out,1,2039
9,12,2016,ASDA,Groceries,80,1959
9,12,2016,Pret A Manger,Eating Out,5,1954
9,12,2016,ATM Cash Withdrawal,General,20,1934
10,12,2016,ATM Cash Withdrawal,General,20,1914
11,12,2016,Scott's Restaurant,Eating Out,25,1889
12,12,2016,South West Trains,Transport,38,1851
12,12,2016,Caffe Nero,Eating Out,2,1849
13,12,2016,Costa Coffee,Eating Out,1,1848
13,12,2016,The West Cornwall Pasty Company,Eating Out,5,1843
14,12,2016,Wild Bean Cafe,Eating Out,1,1842
14,12,2016,ATM Cash Withdrawal,General,10,1832
15,12,2016,BRGAS-Electricity,Bills,43,1789
15,12,2016,BRGAS-Gas,Bills,24,1765
15,12,2016,Greggs,Eating Out,5,1760
16,12,2016,LBS Council Tax,Bills,50,1710
16,12,2016,Sainsburys,Groceries,56,1654
16,12,2016,Anglo restaurant,Eating Out,51,1603
17,12,2016,Pizza Express,Eating Out,41,1562
18,12,2016,ATM Cash Withdrawal,General,10,1552
19,12,2016,South West Trains,Transport,33,1519
19,12,2016,Costa Coffee,Eating Out,2,1517
19,12,2016,ATM Cash Withdrawal,General,20,1497
20,12,2016,VIRGIN MEDIA PYMTS,Bills,37,1460
20,12,2016,Wild Bean Cafe,Eating Out,1,1459
20,12,2016,Pret A Manger,Eating Out,8,1451
21,12,2016,Starbucks Coffee,Eating Out,1,1450
21,12,2016,Greggs,Eating Out,8,1442
21,12,2016,ATM Cash Withdrawal,General,10,1432
22,12,2016,Chicken Cottage,Eating Out,6,1426
22,12,2016,ATM Cash Withdrawal,General,10,1416
23,12,2016,Waitrose,Groceries,82,1334
23,12,2016,Starbucks Coffee,Eating Out,2,1332
23,12,2016,Chicken Cottage,Eating Out,7,1325
24,12,2016,O2,Bills,31,1294
26,12,2016,South West Trains,Transport,35,1259
27,12,2016,Wild Bean Cafe,Eating Out,2,1257
27,12,2016,McDonalds,Eating Out,7,1250
27,12,2016,ATM Cash Withdrawal,General,20,1230
28,12,2016,Starbucks Coffee,Eating Out,2,1228
28,12,2016,Chicken Cottage,Eating Out,5,1223
28,12,2016,ATM Cash Withdrawal,General,20,1203
29,12,2016,Wild Bean Cafe,Eating Out,2,1201
30,12,2016,Morrisons,Groceries,50,1151
30,12,2016,Pret A Manger,Eating Out,6,1145
31,12,2016,ATM Cash Withdrawal,General,10,1135
1,1,2017,Rhino Sports salary,General,1700,2835
2,1,2017,South West Trains,Transport,25,2810
2,1,2017,McDonalds,Eating Out,6,2804
3,1,2017,Caffe Nero,Eating Out,2,2802
3,1,2017,The West Cornwall Pasty Company,Eating Out,7,2795
4,1,2017,Wild Bean Cafe,Eating Out,1,2794
4,1,2017,Chicken Cottage,Eating Out,8,2786
4,1,2017,ATM Cash Withdrawal,General,10,2776
5,1,2017,Costa Coffee,Eating Out,2,2774
5,1,2017,Greggs,Eating Out,7,2767
6,1,2017,Tescos,Groceries,47,2720
6,1,2017,Starbucks Coffee,Eating Out,1,2719
6,1,2017,Greggs,Eating Out,8,2711
6,1,2017,ATM Cash Withdrawal,General,20,2691
7,1,2017,Cubit and West rent,Rent,550,2141
7,1,2017,ATM Cash Withdrawal,General,10,2131
9,1,2017,South West Trains,Transport,30,2101
9,1,2017,Starbucks Coffee,Eating Out,2,2099
9,1,2017,The West Cornwall Pasty Company,Eating Out,7,2092
9,1,2017,ATM Cash Withdrawal,General,20,2072
10,1,2017,Costa Coffee,Eating Out,1,2071
11,1,2017,Starbucks Coffee,Eating Out,2,2069
11,1,2017,Subway,Eating Out,7,2062
12,1,2017,Caffe Nero,Eating Out,1,2061
12,1,2017,ATM Cash Withdrawal,General,20,2041
13,1,2017,Morrisons,Groceries,75,1966
13,1,2017,Caffe Nero,Eating Out,2,1964
13,1,2017,The West Cornwall Pasty Company,Eating Out,6,1958
13,1,2017,Scott's Restaurant,Eating Out,47,1911
13,1,2017,ATM Cash Withdrawal,General,10,1901
14,1,2017,ATM Cash Withdrawal,General,20,1881
15,1,2017,BRGAS-Electricity,Bills,36,1845
15,1,2017,BRGAS-Gas,Bills,45,1800
16,1,2017,LBS Council Tax,Bills,50,1750
16,1,2017,South West Trains,Transport,30,1720
16,1,2017,Subway,Eating Out,5,1715
17,1,2017,Wild Bean Cafe,Eating Out,2,1713
18,1,2017,Wild Bean Cafe,Eating Out,1,1712
18,1,2017,Pret A Manger,Eating Out,7,1705
18,1,2017,ATM Cash Withdrawal,General,10,1695
19,1,2017,Costa Coffee,Eating Out,2,1693
19,1,2017,Pret A Manger,Eating Out,5,1688
19,1,2017,ATM Cash Withdrawal,General,10,1678
20,1,2017,VIRGIN MEDIA PYMTS,Bills,34,1644
20,1,2017,ASDA,Groceries,89,1555
20,1,2017,Wild Bean Cafe,Eating Out,1,1554
20,1,2017,Greggs,Eating Out,8,1546
20,1,2017,Restaurant Gordon RamsayPortland Restaurant,Eating Out,25,1521
21,1,2017,ATM Cash Withdrawal,General,10,1511
23,1,2017,South West Trains,Transport,32,1479
23,1,2017,Starbucks Coffee,Eating Out,2,1477
24,1,2017,O2,Bills,32,1445
24,1,2017,Costa Coffee,Eating Out,1,1444
24,1,2017,Chicken Cottage,Eating Out,8,1436
25,1,2017,The West Cornwall Pasty Company,Eating Out,8,1428
25,1,2017,ATM Cash Withdrawal,General,20,1408
26,1,2017,Starbucks Coffee,Eating Out,2,1406
26,1,2017,ATM Cash Withdrawal,General,20,1386
27,1,2017,Waitrose,Groceries,63,1323
27,1,2017,Wild Bean Cafe,Eating Out,2,1321
27,1,2017,Greggs,Eating Out,8,1313
27,1,2017,Scott's Restaurant,Eating Out,38,1275
27,1,2017,ATM Cash Withdrawal,General,20,1255
29,1,2017,ATM Cash Withdrawal,General,20,1235
30,1,2017,South West Trains,Transport,30,1205
30,1,2017,Caffe Nero,Eating Out,1,1204
30,1,2017,The West Cornwall Pasty Company,Eating Out,7,1197
31,1,2017,Starbucks Coffee,Eating Out,2,1195
31,1,2017,McDonalds,Eating Out,8,1187
1,2,2017,Rhino Sports salary,General,1700,2887
1,2,2017,Costa Coffee,Eating Out,1,2886
1,2,2017,Pret A Manger,Eating Out,5,2881
3,2,2017,Tescos,Groceries,44,2837
4,2,2017,ATM Cash Withdrawal,General,10,2827
5,2,2017,Pizza Express,Eating Out,30,2797
6,2,2017,South West Trains,Transport,35,2762
6,2,2017,Starbucks Coffee,Eating Out,2,2760
6,2,2017,ATM Cash Withdrawal,General,20,2740
7,2,2017,Cubit and West rent,Rent,550,2190
7,2,2017,Starbucks Coffee,Eating Out,2,2188
7,2,2017,Chicken Cottage,Eating Out,5,2183
8,2,2017,Costa Coffee,Eating Out,1,2182
9,2,2017,Caffe Nero,Eating Out,1,2181
10,2,2017,ASDA,Groceries,84,2097
10,2,2017,Costa Coffee,Eating Out,2,2095
11,2,2017,Ministry of Sound ClubXOYO Club,Eating Out,14,2081
11,2,2017,Ministry of Sound ClubXOYO Club,Eating Out,7,2074
11,2,2017,Ministry of Sound ClubXOYO Club,Eating Out,5,2069
11,2,2017,Ministry of Sound ClubXOYO Club,Eating Out,8,2061
11,2,2017,Ministry of Sound ClubXOYO Club,Eating Out,16,2045
11,2,2017,Ministry of Sound ClubXOYO Club,Eating Out,9,2036
13,2,2017,South West Trains,Transport,27,2009
13,2,2017,Caffe Nero,Eating Out,2,2007
13,2,2017,The West Cornwall Pasty Company,Eating Out,7,2000
14,2,2017,The West Cornwall Pasty Company,Eating Out,4,1996
15,2,2017,BRGAS-Electricity,Bills,31,1965
15,2,2017,BRGAS-Gas,Bills,24,1941
16,2,2017,LBS Council Tax,Bills,50,1891
16,2,2017,McDonalds,Eating Out,4,1887
17,2,2017,Sainsburys,Groceries,51,1836
17,2,2017,Costa Coffee,Eating Out,1,1835
17,2,2017,Greggs,Eating Out,8,1827
17,2,2017,Dominos Pizza,Eating Out,55,1772
18,2,2017,The Grand Pub,Eating Out,14,1758
18,2,2017,Anglo restaurant,Eating Out,59,1699
20,2,2017,VIRGIN MEDIA PYMTS,Bills,38,1661
20,2,2017,South West Trains,Transport,38,1623
20,2,2017,Wild Bean Cafe,Eating Out,2,1621
20,2,2017,Pret A Manger,Eating Out,4,1617
21,2,2017,Wild Bean Cafe,Eating Out,1,1616
21,2,2017,ATM Cash Withdrawal,General,20,1596
22,2,2017,Costa Coffee,Eating Out,2,1594
22,2,2017,McDonalds,Eating Out,7,1587
23,2,2017,Caffe Nero,Eating Out,2,1585
23,2,2017,ATM Cash Withdrawal,General,20,1565
24,2,2017,O2,Bills,36,1529
24,2,2017,ASDA,Groceries,64,1465
24,2,2017,Starbucks Coffee,Eating Out,2,1463
25,2,2017,Ministry of Sound ClubXOYO Club,Eating Out,7,1456
25,2,2017,Ministry of Sound ClubXOYO Club,Eating Out,13,1443
25,2,2017,Ministry of Sound ClubXOYO Club,Eating Out,9,1434
25,2,2017,Ministry of Sound ClubXOYO Club,Eating Out,8,1426
25,2,2017,Scott's Restaurant,Eating Out,45,1381
27,2,2017,South West Trains,Transport,32,1349
27,2,2017,Starbucks Coffee,Eating Out,1,1348
27,2,2017,McDonalds,Eating Out,7,1341
28,2,2017,Caffe Nero,Eating Out,2,1339
1,3,2017,Rhino Sports salary,General,1700,3039
1,3,2017,Wild Bean Cafe,Eating Out,2,3037
1,3,2017,The West Cornwall Pasty Company,Eating Out,7,3030
2,3,2017,Caffe Nero,Eating Out,2,3028
3,3,2017,Tescos,Groceries,68,2960
3,3,2017,Costa Coffee,Eating Out,2,2958
3,3,2017,Subway,Eating Out,8,2950
3,3,2017,Restaurant Gordon RamsayPortland Restaurant,Eating Out,39,2911
4,3,2017,Pizza Express,Eating Out,47,2864
5,3,2017,Restaurant Gordon RamsayPortland Restaurant,Eating Out,57,2807
5,3,2017,ATM Cash Withdrawal,General,20,2787
6,3,2017,South West Trains,Transport,28,2759
6,3,2017,Wild Bean Cafe,Eating Out,2,2757
6,3,2017,Greggs,Eating Out,7,2750
7,3,2017,Cubit and West rent,Rent,550,2200
7,3,2017,Costa Coffee,Eating Out,2,2198
7,3,2017,Greggs,Eating Out,7,2191
8,3,2017,Wild Bean Cafe,Eating Out,2,2189
8,3,2017,McDonalds,Eating Out,6,2183
9,3,2017,Wild Bean Cafe,Eating Out,1,2182
9,3,2017,ATM Cash Withdrawal,General,20,2162
10,3,2017,Sainsburys,Groceries,76,2086
10,3,2017,Pret A Manger,Eating Out,7,2079
11,3,2017,Dominos Pizza,Eating Out,45,2034
11,3,2017,ATM Cash Withdrawal,General,10,2024
13,3,2017,South West Trains,Transport,34,1990
13,3,2017,Wild Bean Cafe,Eating Out,2,1988
14,3,2017,Costa Coffee,Eating Out,2,1986
14,3,2017,The West Cornwall Pasty Company,Eating Out,6,1980
15,3,2017,BRGAS-Electricity,Bills,35,1945
15,3,2017,BRGAS-Gas,Bills,40,1905
15,3,2017,Costa Coffee,Eating Out,1,1904
15,3,2017,McDonalds,Eating Out,5,1899
16,3,2017,LBS Council Tax,Bills,50,1849
16,3,2017,Subway,Eating Out,4,1845
17,3,2017,Sainsburys,Groceries,81,1764
17,3,2017,Wild Bean Cafe,Eating Out,1,1763
17,3,2017,Greggs,Eating Out,7,1756
18,3,2017,Fabric Club,Eating Out,8,1748
18,3,2017,Fabric Club,Eating Out,13,1735
18,3,2017,Fabric Club,Eating Out,15,1720
18,3,2017,Fabric Club,Eating Out,10,1710
18,3,2017,Fabric Club,Eating Out,7,1703
18,3,2017,Fabric Club,Eating Out,6,1697
18,3,2017,ATM Cash Withdrawal,General,20,1677
19,3,2017,Anglo restaurant,Eating Out,27,1650
20,3,2017,VIRGIN MEDIA PYMTS,Bills,35,1615
20,3,2017,South West Trains,Transport,26,1589
20,3,2017,The West Cornwall Pasty Company,Eating Out,6,1583
21,3,2017,Wild Bean Cafe,Eating Out,2,1581
21,3,2017,McDonalds,Eating Out,6,1575
22,3,2017,The West Cornwall Pasty Company,Eating Out,6,1569
23,3,2017,Costa Coffee,Eating Out,2,1567
23,3,2017,Pret A Manger,Eating Out,5,1562
24,3,2017,O2,Bills,36,1526
24,3,2017,Tescos,Groceries,66,1460
24,3,2017,Costa Coffee,Eating Out,2,1458
24,3,2017,Subway,Eating Out,5,1453
24,3,2017,Fabric Club,Eating Out,15,1438
24,3,2017,Fabric Club,Eating Out,16,1422
24,3,2017,Restaurant Gordon RamsayPortland Restaurant,Eating Out,50,1372
24,3,2017,ATM Cash Withdrawal,General,20,1352
27,3,2017,South West Trains,Transport,25,1327
27,3,2017,Costa Coffee,Eating Out,1,1326
28,3,2017,Wild Bean Cafe,Eating Out,2,1324
28,3,2017,ATM Cash Withdrawal,General,10,1314
29,3,2017,Starbucks Coffee,Eating Out,2,1312
29,3,2017,Greggs,Eating Out,4,1308
29,3,2017,ATM Cash Withdrawal,General,20,1288
30,3,2017,Starbucks Coffee,Eating Out,2,1286
31,3,2017,Sainsburys,Groceries,61,1225
31,3,2017,Pret A Manger,Eating Out,8,1217
1,4,2017,Rhino Sports salary,General,1700,2917
3,4,2017,South West Trains,Transport,37,2880
3,4,2017,Wild Bean Cafe,Eating Out,2,2878
3,4,2017,Subway,Eating Out,7,2871
3,4,2017,ATM Cash Withdrawal,General,20,2851
4,4,2017,Costa Coffee,Eating Out,1,2850
4,4,2017,McDonalds,Eating Out,8,2842
4,4,2017,ATM Cash Withdrawal,General,10,2832
5,4,2017,The West Cornwall Pasty Company,Eating Out,8,2824
6,4,2017,Costa Coffee,Eating Out,1,2823
7,4,2017,Cubit and West rent,Rent,550,2273
7,4,2017,ASDA,Groceries,86,2187
7,4,2017,Costa Coffee,Eating Out,2,2185
7,4,2017,Chicken Cottage,Eating Out,8,2177
7,4,2017,Anglo restaurant,Eating Out,51,2126
7,4,2017,ATM Cash Withdrawal,General,20,2106
8,4,2017,ATM Cash Withdrawal,General,20,2086
10,4,2017,South West Trains,Transport,26,2060
10,4,2017,Starbucks Coffee,Eating Out,2,2058
10,4,2017,McDonalds,Eating Out,4,2054
10,4,2017,ATM Cash Withdrawal,General,10,2044
11,4,2017,Costa Coffee,Eating Out,1,2043
11,4,2017,Chicken Cottage,Eating Out,6,2037
13,4,2017,ATM Cash Withdrawal,General,10,2027
14,4,2017,ASDA,Groceries,80,1947
14,4,2017,Starbucks Coffee,Eating Out,1,1946
14,4,2017,Subway,Eating Out,8,1938
15,4,2017,BRGAS-Electricity,Bills,37,1901
15,4,2017,BRGAS-Gas,Bills,42,1859
15,4,2017,Scott's Restaurant,Eating Out,44,1815
16,4,2017,LBS Council Tax,Bills,50,1765
17,4,2017,South West Trains,Transport,30,1735
17,4,2017,Caffe Nero,Eating Out,1,1734
17,4,2017,The West Cornwall Pasty Company,Eating Out,7,1727
18,4,2017,The West Cornwall Pasty Company,Eating Out,6,1721
19,4,2017,Wild Bean Cafe,Eating Out,2,1719
19,4,2017,Pret A Manger,Eating Out,8,1711
19,4,2017,ATM Cash Withdrawal,General,10,1701
20,4,2017,VIRGIN MEDIA PYMTS,Bills,59,1642
20,4,2017,Wild Bean Cafe,Eating Out,1,1641
20,4,2017,Subway,Eating Out,7,1634
21,4,2017,ASDA,Groceries,80,1554
21,4,2017,Wild Bean Cafe,Eating Out,2,1552
21,4,2017,Subway,Eating Out,5,1547
21,4,2017,Fabric Club,Eating Out,10,1537
21,4,2017,Fabric Club,Eating Out,6,1531
21,4,2017,Fabric Club,Eating Out,5,1526
21,4,2017,Dominos Pizza,Eating Out,51,1475
21,4,2017,ATM Cash Withdrawal,General,20,1455
24,4,2017,O2,Bills,37,1418
24,4,2017,South West Trains,Transport,26,1392
24,4,2017,Caffe Nero,Eating Out,2,1390
26,4,2017,Wild Bean Cafe,Eating Out,1,1389
26,4,2017,Greggs,Eating Out,8,1381
28,4,2017,Waitrose,Groceries,73,1308
28,4,2017,Caffe Nero,Eating Out,1,1307
28,4,2017,The West Cornwall Pasty Company,Eating Out,5,1302
28,4,2017,Fabric Club,Eating Out,16,1286
28,4,2017,Fabric Club,Eating Out,10,1276
1,5,2017,Rhino Sports salary,General,1700,2976
1,5,2017,South West Trains,Transport,30,2946
1,5,2017,Starbucks Coffee,Eating Out,1,2945
2,5,2017,The West Cornwall Pasty Company,Eating Out,7,2938
4,5,2017,Caffe Nero,Eating Out,1,2937
4,5,2017,Chicken Cottage,Eating Out,4,2933
4,5,2017,ATM Cash Withdrawal,General,10,2923
5,5,2017,Tescos,Groceries,88,2835
5,5,2017,Wild Bean Cafe,Eating Out,2,2833
6,5,2017,The Grand Pub,Eating Out,11,2822
6,5,2017,The Grand Pub,Eating Out,12,2810
6,5,2017,The Grand Pub,Eating Out,11,2799
6,5,2017,The Grand Pub,Eating Out,16,2783
7,5,2017,Cubit and West rent,Rent,550,2233
8,5,2017,South West Trains,Transport,32,2201
8,5,2017,Wild Bean Cafe,Eating Out,2,2199
9,5,2017,Caffe Nero,Eating Out,2,2197
10,5,2017,Pret A Manger,Eating Out,8,2189
11,5,2017,Costa Coffee,Eating Out,1,2188
11,5,2017,The West Cornwall Pasty Company,Eating Out,7,2181
12,5,2017,Sainsburys,Groceries,43,2138
12,5,2017,Caffe Nero,Eating Out,2,2136
12,5,2017,Greggs,Eating Out,6,2130
12,5,2017,Pizza Express,Eating Out,28,2102
15,5,2017,BRGAS-Electricity,Bills,33,2069
15,5,2017,BRGAS-Gas,Bills,44,2025
15,5,2017,South West Trains,Transport,33,1992
15,5,2017,Starbucks Coffee,Eating Out,2,1990
15,5,2017,The West Cornwall Pasty Company,Eating Out,5,1985
15,5,2017,ATM Cash Withdrawal,General,20,1965
16,5,2017,LBS Council Tax,Bills,50,1915
16,5,2017,Chicken Cottage,Eating Out,5,1910
18,5,2017,Subway,Eating Out,6,1904
18,5,2017,ATM Cash Withdrawal,General,20,1884
19,5,2017,Sainsburys,Groceries,77,1807
19,5,2017,Caffe Nero,Eating Out,1,1806
19,5,2017,Pret A Manger,Eating Out,5,1801
20,5,2017,VIRGIN MEDIA PYMTS,Bills,29,1772
20,5,2017,ATM Cash Withdrawal,General,20,1752
22,5,2017,South West Trains,Transport,30,1722
22,5,2017,Wild Bean Cafe,Eating Out,2,1720
22,5,2017,McDonalds,Eating Out,7,1713
22,5,2017,ATM Cash Withdrawal,General,20,1693
23,5,2017,The West Cornwall Pasty Company,Eating Out,6,1687
23,5,2017,ATM Cash Withdrawal,General,20,1667
24,5,2017,O2,Bills,34,1633
24,5,2017,Caffe Nero,Eating Out,1,1632
24,5,2017,Pret A Manger,Eating Out,6,1626
25,5,2017,Subway,Eating Out,5,1621
25,5,2017,ATM Cash Withdrawal,General,20,1601
26,5,2017,Waitrose,Groceries,65,1536
26,5,2017,Costa Coffee,Eating Out,2,1534
26,5,2017,The West Cornwall Pasty Company,Eating Out,8,1526
27,5,2017,ATM Cash Withdrawal,General,10,1516
28,5,2017,Pizza Express,Eating Out,54,1462
28,5,2017,ATM Cash Withdrawal,General,10,1452
29,5,2017,South West Trains,Transport,26,1426
29,5,2017,Costa Coffee,Eating Out,2,1424
29,5,2017,The West Cornwall Pasty Company,Eating Out,6,1418
29,5,2017,ATM Cash Withdrawal,General,10,1408
30,5,2017,Caffe Nero,Eating Out,1,1407
31,5,2017,Caffe Nero,Eating Out,2,1405
31,5,2017,The West Cornwall Pasty Company,Eating Out,7,1398
1,6,2017,Rhino Sports salary,General,1700,3098
1,6,2017,Caffe Nero,Eating Out,2,3096
1,6,2017,Greggs,Eating Out,6,3090
2,6,2017,Morrisons,Groceries,66,3024
2,6,2017,Wild Bean Cafe,Eating Out,2,3022
2,6,2017,Greggs,Eating Out,5,3017
2,6,2017,Restaurant Gordon RamsayPortland Restaurant,Eating Out,33,2984
4,6,2017,Anglo restaurant,Eating Out,40,2944
5,6,2017,South West Trains,Transport,26,2918
5,6,2017,Wild Bean Cafe,Eating Out,2,2916
6,6,2017,Costa Coffee,Eating Out,1,2915
6,6,2017,Chicken Cottage,Eating Out,7,2908
7,6,2017,Cubit and West rent,Rent,550,2358
7,6,2017,Costa Coffee,Eating Out,1,2357
9,6,2017,Waitrose,Groceries,71,2286
9,6,2017,Caffe Nero,Eating Out,1,2285
9,6,2017,Chicken Cottage,Eating Out,8,2277
9,6,2017,Ministry of Sound ClubXOYO Club,Eating Out,16,2261
9,6,2017,Ministry of Sound ClubXOYO Club,Eating Out,10,2251
9,6,2017,Ministry of Sound ClubXOYO Club,Eating Out,12,2239
9,6,2017,Anglo restaurant,Eating Out,44,2195
9,6,2017,ATM Cash Withdrawal,General,10,2185
10,6,2017,Pizza Express,Eating Out,33,2152
12,6,2017,South West Trains,Transport,33,2119
12,6,2017,Pret A Manger,Eating Out,4,2115
13,6,2017,Costa Coffee,Eating Out,2,2113
13,6,2017,Subway,Eating Out,6,2107
14,6,2017,Wild Bean Cafe,Eating Out,1,2106
14,6,2017,The West Cornwall Pasty Company,Eating Out,4,2102
15,6,2017,BRGAS-Electricity,Bills,42,2060
15,6,2017,BRGAS-Gas,Bills,40,2020
15,6,2017,Starbucks Coffee,Eating Out,1,2019
15,6,2017,Chicken Cottage,Eating Out,5,2014
16,6,2017,LBS Council Tax,Bills,50,1964
16,6,2017,Sainsburys,Groceries,67,1897
16,6,2017,Starbucks Coffee,Eating Out,1,1896
16,6,2017,McDonalds,Eating Out,7,1889
17,6,2017,Pizza Express,Eating Out,47,1842
18,6,2017,Pizza Express,Eating Out,33,1809
18,6,2017,ATM Cash Withdrawal,General,20,1789
19,6,2017,South West Trains,Transport,32,1757
19,6,2017,Chicken Cottage,Eating Out,4,1753
20,6,2017,VIRGIN MEDIA PYMTS,Bills,54,1699
20,6,2017,Costa Coffee,Eating Out,2,1697
21,6,2017,Starbucks Coffee,Eating Out,2,1695
21,6,2017,Chicken Cottage,Eating Out,5,1690
22,6,2017,Wild Bean Cafe,Eating Out,2,1688
22,6,2017,Greggs,Eating Out,7,1681
23,6,2017,Waitrose,Groceries,63,1618
23,6,2017,Starbucks Coffee,Eating Out,2,1616
24,6,2017,O2,Bills,32,1584
24,6,2017,ATM Cash Withdrawal,General,20,1564
25,6,2017,ATM Cash Withdrawal,General,20,1544
26,6,2017,South West Trains,Transport,27,1517
26,6,2017,Costa Coffee,Eating Out,1,1516
26,6,2017,ATM Cash Withdrawal,General,10,1506
27,6,2017,Starbucks Coffee,Eating Out,2,1504
28,6,2017,Caffe Nero,Eating Out,2,1502
28,6,2017,Chicken Cottage,Eating Out,4,1498
28,6,2017,ATM Cash Withdrawal,General,20,1478
29,6,2017,Costa Coffee,Eating Out,2,1476
29,6,2017,Greggs,Eating Out,8,1468
30,6,2017,Tescos,Groceries,44,1424
30,6,2017,Costa Coffee,Eating Out,1,1423
30,6,2017,McDonalds,Eating Out,5,1418
30,6,2017,Pizza Express,Eating Out,41,1377
1,7,2017,Rhino Sports salary,General,1700,3077
2,7,2017,ATM Cash Withdrawal,General,10,3067
3,7,2017,South West Trains,Transport,27,3040
3,7,2017,Costa Coffee,Eating Out,2,3038
3,7,2017,Subway,Eating Out,6,3032
4,7,2017,Greggs,Eating Out,4,3028
4,7,2017,ATM Cash Withdrawal,General,10,3018
5,7,2017,Costa Coffee,Eating Out,2,3016
5,7,2017,Subway,Eating Out,8,3008
6,7,2017,Costa Coffee,Eating Out,2,3006
6,7,2017,Greggs,Eating Out,7,2999
7,7,2017,Cubit and West rent,Rent,550,2449
7,7,2017,Waitrose,Groceries,44,2405
7,7,2017,McDonalds,Eating Out,8,2397
7,7,2017,Scott's Restaurant,Eating Out,37,2360
8,7,2017,Ministry of Sound ClubXOYO Club,Eating Out,10,2350
8,7,2017,Ministry of Sound ClubXOYO Club,Eating Out,6,2344
8,7,2017,Ministry of Sound ClubXOYO Club,Eating Out,7,2337
8,7,2017,Ministry of Sound ClubXOYO Club,Eating Out,15,2322
8,7,2017,Ministry of Sound ClubXOYO Club,Eating Out,12,2310
8,7,2017,Ministry of Sound ClubXOYO Club,Eating Out,6,2304
8,7,2017,Restaurant Gordon RamsayPortland Restaurant,Eating Out,32,2272
10,7,2017,South West Trains,Transport,26,2246
10,7,2017,Costa Coffee,Eating Out,2,2244
10,7,2017,Subway,Eating Out,4,2240
11,7,2017,ATM Cash Withdrawal,General,10,2230
12,7,2017,ATM Cash Withdrawal,General,10,2220
13,7,2017,Wild Bean Cafe,Eating Out,2,2218
13,7,2017,Pret A Manger,Eating Out,6,2212
13,7,2017,ATM Cash Withdrawal,General,20,2192
14,7,2017,Tescos,Groceries,49,2143
14,7,2017,Wild Bean Cafe,Eating Out,1,2142
14,7,2017,McDonalds,Eating Out,6,2136
14,7,2017,Restaurant Gordon RamsayPortland Restaurant,Eating Out,50,2086
15,7,2017,BRGAS-Electricity,Bills,30,2056
15,7,2017,BRGAS-Gas,Bills,37,2019
16,7,2017,LBS Council Tax,Bills,50,1969
17,7,2017,South West Trains,Transport,37,1932
17,7,2017,Pret A Manger,Eating Out,7,1925
17,7,2017,ATM Cash Withdrawal,General,10,1915
18,7,2017,Chicken Cottage,Eating Out,8,1907
19,7,2017,Subway,Eating Out,6,1901
20,7,2017,VIRGIN MEDIA PYMTS,Bills,37,1864
20,7,2017,Pret A Manger,Eating Out,6,1858
20,7,2017,ATM Cash Withdrawal,General,20,1838
21,7,2017,ASDA,Groceries,76,1762
21,7,2017,Starbucks Coffee,Eating Out,1,1761
21,7,2017,Dominos Pizza,Eating Out,33,1728
23,7,2017,Scott's Restaurant,Eating Out,44,1684
24,7,2017,O2,Bills,34,1650
24,7,2017,South West Trains,Transport,35,1615
24,7,2017,Wild Bean Cafe,Eating Out,2,1613
24,7,2017,ATM Cash Withdrawal,General,20,1593
25,7,2017,Costa Coffee,Eating Out,1,1592
25,7,2017,ATM Cash Withdrawal,General,20,1572
26,7,2017,Caffe Nero,Eating Out,2,1570
26,7,2017,Chicken Cottage,Eating Out,6,1564
27,7,2017,Costa Coffee,Eating Out,2,1562
27,7,2017,McDonalds,Eating Out,8,1554
28,7,2017,ASDA,Groceries,48,1506
28,7,2017,Caffe Nero,Eating Out,2,1504
28,7,2017,ATM Cash Withdrawal,General,20,1484
29,7,2017,Scott's Restaurant,Eating Out,45,1439
31,7,2017,South West Trains,Transport,32,1407
31,7,2017,Costa Coffee,Eating Out,1,1406
31,7,2017,Chicken Cottage,Eating Out,5,1401
1,8,2017,Rhino Sports salary,General,1700,3101
1,8,2017,Caffe Nero,Eating Out,2,3099
1,8,2017,Pret A Manger,Eating Out,4,3095
2,8,2017,Caffe Nero,Eating Out,1,3094
2,8,2017,Chicken Cottage,Eating Out,4,3090
3,8,2017,Caffe Nero,Eating Out,2,3088
3,8,2017,The West Cornwall Pasty Company,Eating Out,8,3080
4,8,2017,Sainsburys,Groceries,88,2992
4,8,2017,Costa Coffee,Eating Out,2,2990
4,8,2017,The West Cornwall Pasty Company,Eating Out,6,2984
4,8,2017,ATM Cash Withdrawal,General,20,2964
5,8,2017,ATM Cash Withdrawal,General,10,2954
6,8,2017,ATM Cash Withdrawal,General,20,2934
7,8,2017,Cubit and West rent,Rent,550,2384
7,8,2017,South West Trains,Transport,29,2355
7,8,2017,McDonalds,Eating Out,4,2351
8,8,2017,Wild Bean Cafe,Eating Out,2,2349
8,8,2017,Chicken Cottage,Eating Out,7,2342
8,8,2017,ATM Cash Withdrawal,General,20,2322
9,8,2017,Caffe Nero,Eating Out,2,2320
10,8,2017,Starbucks Coffee,Eating Out,2,2318
10,8,2017,The West Cornwall Pasty Company,Eating Out,8,2310
11,8,2017,Sainsburys,Groceries,86,2224
11,8,2017,Pret A Manger,Eating Out,8,2216
11,8,2017,The Grand Pub,Eating Out,11,2205
11,8,2017,Anglo restaurant,Eating Out,27,2178
12,8,2017,Dominos Pizza,Eating Out,33,2145
12,8,2017,ATM Cash Withdrawal,General,10,2135
13,8,2017,ATM Cash Withdrawal,General,10,2125
14,8,2017,South West Trains,Transport,25,2100
14,8,2017,Costa Coffee,Eating Out,1,2099
14,8,2017,McDonalds,Eating Out,5,2094
14,8,2017,ATM Cash Withdrawal,General,10,2084
15,8,2017,BRGAS-Electricity,Bills,33,2051
15,8,2017,BRGAS-Gas,Bills,43,2008
15,8,2017,Starbucks Coffee,Eating Out,2,2006
15,8,2017,The West Cornwall Pasty Company,Eating Out,6,2000
15,8,2017,ATM Cash Withdrawal,General,20,1980
16,8,2017,LBS Council Tax,Bills,50,1930
16,8,2017,Starbucks Coffee,Eating Out,2,1928
16,8,2017,Greggs,Eating Out,5,1923
17,8,2017,Wild Bean Cafe,Eating Out,2,1921
17,8,2017,Subway,Eating Out,4,1917
18,8,2017,Sainsburys,Groceries,62,1855
18,8,2017,Caffe Nero,Eating Out,1,1854
18,8,2017,Pret A Manger,Eating Out,8,1846
18,8,2017,Pizza Express,Eating Out,44,1802
20,8,2017,VIRGIN MEDIA PYMTS,Bills,45,1757
21,8,2017,South West Trains,Transport,37,1720
21,8,2017,Wild Bean Cafe,Eating Out,2,1718
21,8,2017,McDonalds,Eating Out,6,1712
22,8,2017,Starbucks Coffee,Eating Out,2,1710
22,8,2017,ATM Cash Withdrawal,General,10,1700
23,8,2017,Costa Coffee,Eating Out,2,1698
24,8,2017,O2,Bills,36,1662
24,8,2017,Starbucks Coffee,Eating Out,2,1660
25,8,2017,Sainsburys,Groceries,49,1611
25,8,2017,Subway,Eating Out,6,1605
26,8,2017,Ministry of Sound ClubXOYO Club,Eating Out,16,1589
26,8,2017,Ministry of Sound ClubXOYO Club,Eating Out,13,1576
26,8,2017,Ministry of Sound ClubXOYO Club,Eating Out,9,1567
26,8,2017,Dominos Pizza,Eating Out,56,1511
28,8,2017,South West Trains,Transport,38,1473
28,8,2017,Starbucks Coffee,Eating Out,2,1471
28,8,2017,Subway,Eating Out,8,1463
28,8,2017,ATM Cash Withdrawal,General,10,1453
29,8,2017,Starbucks Coffee,Eating Out,2,1451
30,8,2017,Caffe Nero,Eating Out,2,1449
31,8,2017,Caffe Nero,Eating Out,2,1447
31,8,2017,McDonalds,Eating Out,5,1442
1,9,2017,Rhino Sports salary,General,1700,3142
1,9,2017,ASDA,Groceries,81,3061
1,9,2017,Caffe Nero,Eating Out,2,3059
1,9,2017,McDonalds,Eating Out,6,3053
1,9,2017,ATM Cash Withdrawal,General,10,3043
2,9,2017,Scott's Restaurant,Eating Out,32,3011
4,9,2017,South West Trains,Transport,29,2982
4,9,2017,Wild Bean Cafe,Eating Out,2,2980
4,9,2017,Pret A Manger,Eating Out,5,2975
5,9,2017,Starbucks Coffee,Eating Out,2,2973
6,9,2017,Costa Coffee,Eating Out,2,2971
7,9,2017,Cubit and West rent,Rent,550,2421
7,9,2017,Caffe Nero,Eating Out,2,2419
7,9,2017,Subway,Eating Out,4,2415
8,9,2017,ASDA,Groceries,75,2340
8,9,2017,Starbucks Coffee,Eating Out,1,2339
8,9,2017,Chicken Cottage,Eating Out,6,2333
8,9,2017,Scott's Restaurant,Eating Out,32,2301
8,9,2017,ATM Cash Withdrawal,General,10,2291
9,9,2017,ATM Cash Withdrawal,General,20,2271
10,9,2017,Dominos Pizza,Eating Out,25,2246
11,9,2017,South West Trains,Transport,32,2214
11,9,2017,Caffe Nero,Eating Out,1,2213
11,9,2017,Subway,Eating Out,7,2206
11,9,2017,ATM Cash Withdrawal,General,20,2186
12,9,2017,Starbucks Coffee,Eating Out,2,2184
12,9,2017,Chicken Cottage,Eating Out,6,2178
13,9,2017,Caffe Nero,Eating Out,1,2177
13,9,2017,Subway,Eating Out,5,2172
14,9,2017,Wild Bean Cafe,Eating Out,2,2170
14,9,2017,Chicken Cottage,Eating Out,7,2163
14,9,2017,ATM Cash Withdrawal,General,10,2153
15,9,2017,BRGAS-Electricity,Bills,29,2124
15,9,2017,BRGAS-Gas,Bills,34,2090
15,9,2017,Tescos,Groceries,46,2044
15,9,2017,Starbucks Coffee,Eating Out,2,2042
15,9,2017,Pret A Manger,Eating Out,6,2036
15,9,2017,Scott's Restaurant,Eating Out,59,1977
16,9,2017,LBS Council Tax,Bills,50,1927
17,9,2017,ATM Cash Withdrawal,General,10,1917
18,9,2017,South West Trains,Transport,29,1888
18,9,2017,Pret A Manger,Eating Out,4,1884
19,9,2017,Wild Bean Cafe,Eating Out,2,1882
19,9,2017,Pret A Manger,Eating Out,7,1875
20,9,2017,VIRGIN MEDIA PYMTS,Bills,53,1822
20,9,2017,Caffe Nero,Eating Out,2,1820
20,9,2017,McDonalds,Eating Out,6,1814
21,9,2017,Starbucks Coffee,Eating Out,2,1812
22,9,2017,Sainsburys,Groceries,78,1734
22,9,2017,Caffe Nero,Eating Out,2,1732
23,9,2017,ATM Cash Withdrawal,General,20,1712
24,9,2017,O2,Bills,36,1676
25,9,2017,South West Trains,Transport,30,1646
25,9,2017,Wild Bean Cafe,Eating Out,1,1645
26,9,2017,Costa Coffee,Eating Out,2,1643
26,9,2017,ATM Cash Withdrawal,General,20,1623
27,9,2017,Caffe Nero,Eating Out,2,1621
28,9,2017,Costa Coffee,Eating Out,1,1620
28,9,2017,Greggs,Eating Out,5,1615
28,9,2017,ATM Cash Withdrawal,General,10,1605
29,9,2017,Sainsburys,Groceries,89,1516
29,9,2017,Costa Coffee,Eating Out,1,1515
29,9,2017,ATM Cash Withdrawal,General,10,1505
1,10,2017,Rhino Sports salary,General,1700,3205
2,10,2017,South West Trains,Transport,36,3169
2,10,2017,Caffe Nero,Eating Out,2,3167
2,10,2017,ATM Cash Withdrawal,General,20,3147
3,10,2017,Wild Bean Cafe,Eating Out,1,3146
4,10,2017,Chicken Cottage,Eating Out,7,3139
6,10,2017,Waitrose,Groceries,60,3079
6,10,2017,Wild Bean Cafe,Eating Out,1,3078
6,10,2017,Scott's Restaurant,Eating Out,47,3031
7,10,2017,Cubit and West rent,Rent,550,2481
9,10,2017,South West Trains,Transport,30,2451
9,10,2017,Caffe Nero,Eating Out,1,2450
9,10,2017,Greggs,Eating Out,7,2443
9,10,2017,ATM Cash Withdrawal,General,10,2433
10,10,2017,Costa Coffee,Eating Out,2,2431
10,10,2017,The West Cornwall Pasty Company,Eating Out,6,2425
11,10,2017,Caffe Nero,Eating Out,1,2424
11,10,2017,Chicken Cottage,Eating Out,4,2420
12,10,2017,Starbucks Coffee,Eating Out,2,2418
13,10,2017,ASDA,Groceries,46,2372
13,10,2017,Costa Coffee,Eating Out,1,2371
13,10,2017,ATM Cash Withdrawal,General,20,2351
14,10,2017,ATM Cash Withdrawal,General,10,2341
15,10,2017,BRGAS-Electricity,Bills,27,2314
15,10,2017,BRGAS-Gas,Bills,24,2290
15,10,2017,Restaurant Gordon RamsayPortland Restaurant,Eating Out,30,2260
16,10,2017,LBS Council Tax,Bills,50,2210
16,10,2017,South West Trains,Transport,25,2185
16,10,2017,Chicken Cottage,Eating Out,8,2177
17,10,2017,Costa Coffee,Eating Out,1,2176
17,10,2017,Subway,Eating Out,4,2172
18,10,2017,Caffe Nero,Eating Out,1,2171
19,10,2017,Subway,Eating Out,7,2164
20,10,2017,VIRGIN MEDIA PYMTS,Bills,50,2114
20,10,2017,Tescos,Groceries,54,2060
20,10,2017,Chicken Cottage,Eating Out,5,2055
23,10,2017,South West Trains,Transport,32,2023
23,10,2017,Caffe Nero,Eating Out,2,2021
24,10,2017,O2,Bills,30,1991
25,10,2017,Caffe Nero,Eating Out,1,1990
26,10,2017,Caffe Nero,Eating Out,1,1989
27,10,2017,Morrisons,Groceries,56,1933
27,10,2017,Starbucks Coffee,Eating Out,1,1932
27,10,2017,Chicken Cottage,Eating Out,6,1926
28,10,2017,Anglo restaurant,Eating Out,32,1894
28,10,2017,ATM Cash Withdrawal,General,20,1874
29,10,2017,Restaurant Gordon RamsayPortland Restaurant,Eating Out,40,1834
30,10,2017,South West Trains,Transport,33,1801
30,10,2017,Wild Bean Cafe,Eating Out,1,1800
31,10,2017,Caffe Nero,Eating Out,1,1799
31,10,2017,Greggs,Eating Out,7,1792
1,11,2017,Rhino Sports salary,General,1700,3492
1,11,2017,Caffe Nero,Eating Out,2,3490
2,11,2017,Caffe Nero,Eating Out,2,3488
2,11,2017,McDonalds,Eating Out,7,3481
3,11,2017,Tescos,Groceries,55,3426
3,11,2017,Costa Coffee,Eating Out,2,3424
3,11,2017,The West Cornwall Pasty Company,Eating Out,4,3420
5,11,2017,Dominos Pizza,Eating Out,58,3362
5,11,2017,ATM Cash Withdrawal,General,10,3352
6,11,2017,South West Trains,Transport,29,3323
6,11,2017,Wild Bean Cafe,Eating Out,2,3321
6,11,2017,ATM Cash Withdrawal,General,10,3311
7,11,2017,Cubit and West rent,Rent,550,2761
7,11,2017,Costa Coffee,Eating Out,2,2759
8,11,2017,Caffe Nero,Eating Out,2,2757
9,11,2017,Wild Bean Cafe,Eating Out,1,2756
9,11,2017,Greggs,Eating Out,8,2748
10,11,2017,ASDA,Groceries,71,2677
10,11,2017,Caffe Nero,Eating Out,2,2675
10,11,2017,The West Cornwall Pasty Company,Eating Out,7,2668
10,11,2017,The Grand Pub,Eating Out,9,2659
10,11,2017,The Grand Pub,Eating Out,14,2645
10,11,2017,The Grand Pub,Eating Out,5,2640
10,11,2017,The Grand Pub,Eating Out,5,2635
10,11,2017,The Grand Pub,Eating Out,16,2619
10,11,2017,The Grand Pub,Eating Out,13,2606
10,11,2017,Dominos Pizza,Eating Out,51,2555
10,11,2017,ATM Cash Withdrawal,General,10,2545
11,11,2017,Scott's Restaurant,Eating Out,37,2508
11,11,2017,ATM Cash Withdrawal,General,10,2498
13,11,2017,South West Trains,Transport,30,2468
13,11,2017,Greggs,Eating Out,8,2460
13,11,2017,ATM Cash Withdrawal,General,20,2440
14,11,2017,Pret A Manger,Eating Out,6,2434
14,11,2017,ATM Cash Withdrawal,General,20,2414
15,11,2017,BRGAS-Electricity,Bills,62,2352
15,11,2017,BRGAS-Gas,Bills,85,2267
15,11,2017,Caffe Nero,Eating Out,2,2265
15,11,2017,McDonalds,Eating Out,4,2261
16,11,2017,LBS Council Tax,Bills,50,2211
16,11,2017,Wild Bean Cafe,Eating Out,1,2210
16,11,2017,ATM Cash Withdrawal,General,20,2190
17,11,2017,Sainsburys,Groceries,79,2111
17,11,2017,Starbucks Coffee,Eating Out,1,2110
17,11,2017,McDonalds,Eating Out,6,2104
17,11,2017,Pizza Express,Eating Out,46,2058
18,11,2017,ATM Cash Withdrawal,General,10,2048
19,11,2017,ATM Cash Withdrawal,General,10,2038
20,11,2017,VIRGIN MEDIA PYMTS,Bills,49,1989
20,11,2017,South West Trains,Transport,26,1963
21,11,2017,ATM Cash Withdrawal,General,10,1953
22,11,2017,Starbucks Coffee,Eating Out,1,1952
22,11,2017,Greggs,Eating Out,7,1945
23,11,2017,Costa Coffee,Eating Out,2,1943
23,11,2017,McDonalds,Eating Out,8,1935
24,11,2017,O2,Bills,33,1902
24,11,2017,ASDA,Groceries,57,1845
24,11,2017,Starbucks Coffee,Eating Out,2,1843
24,11,2017,The West Cornwall Pasty Company,Eating Out,4,1839
25,11,2017,Pizza Express,Eating Out,41,1798
26,11,2017,ATM Cash Withdrawal,General,10,1788
27,11,2017,South West Trains,Transport,26,1762
27,11,2017,Costa Coffee,Eating Out,2,1760
27,11,2017,ATM Cash Withdrawal,General,10,1750
28,11,2017,Costa Coffee,Eating Out,2,1748
28,11,2017,McDonalds,Eating Out,7,1741
28,11,2017,ATM Cash Withdrawal,General,20,1721
29,11,2017,Subway,Eating Out,4,1717
29,11,2017,ATM Cash Withdrawal,General,20,1697
30,11,2017,Caffe Nero,Eating Out,1,1696
30,11,2017,Pret A Manger,Eating Out,4,1692
1,12,2017,Rhino Sports salary,General,1700,3392
1,12,2017,ASDA,Groceries,79,3313
1,12,2017,Costa Coffee,Eating Out,2,3311
1,12,2017,McDonalds,Eating Out,6,3305
2,12,2017,Pizza Express,Eating Out,30,3275
2,12,2017,ATM Cash Withdrawal,General,10,3265
3,12,2017,Dominos Pizza,Eating Out,37,3228
4,12,2017,South West Trains,Transport,27,3201
4,12,2017,Caffe Nero,Eating Out,1,3200
4,12,2017,McDonalds,Eating Out,5,3195
5,12,2017,Wild Bean Cafe,Eating Out,2,3193
5,12,2017,McDonalds,Eating Out,4,3189
5,12,2017,ATM Cash Withdrawal,General,20,3169
6,12,2017,Starbucks Coffee,Eating Out,1,3168
6,12,2017,ATM Cash Withdrawal,General,10,3158
7,12,2017,Cubit and West rent,Rent,550,2608
7,12,2017,Subway,Eating Out,7,2601
7,12,2017,ATM Cash Withdrawal,General,10,2591
8,12,2017,Morrisons,Groceries,72,2519
8,12,2017,Caffe Nero,Eating Out,2,2517
8,12,2017,Greggs,Eating Out,8,2509
8,12,2017,The Grand Pub,Eating Out,5,2504
8,12,2017,Dominos Pizza,Eating Out,38,2466
8,12,2017,ATM Cash Withdrawal,General,10,2456
9,12,2017,Dominos Pizza,Eating Out,58,2398
10,12,2017,Scott's Restaurant,Eating Out,32,2366
11,12,2017,South West Trains,Transport,25,2341
11,12,2017,ATM Cash Withdrawal,General,20,2321
12,12,2017,Costa Coffee,Eating Out,1,2320
12,12,2017,Subway,Eating Out,5,2315
12,12,2017,ATM Cash Withdrawal,General,10,2305
13,12,2017,McDonalds,Eating Out,8,2297
13,12,2017,ATM Cash Withdrawal,General,10,2287
14,12,2017,Costa Coffee,Eating Out,2,2285
15,12,2017,BRGAS-Electricity,Bills,25,2260
15,12,2017,BRGAS-Gas,Bills,29,2231
15,12,2017,Morrisons,Groceries,70,2161
15,12,2017,Subway,Eating Out,7,2154
16,12,2017,LBS Council Tax,Bills,50,2104
17,12,2017,ATM Cash Withdrawal,General,10,2094
18,12,2017,South West Trains,Transport,37,2057
18,12,2017,Caffe Nero,Eating Out,2,2055
18,12,2017,McDonalds,Eating Out,5,2050
18,12,2017,ATM Cash Withdrawal,General,20,2030
19,12,2017,Caffe Nero,Eating Out,1,2029
19,12,2017,Pret A Manger,Eating Out,6,2023
19,12,2017,ATM Cash Withdrawal,General,20,2003
20,12,2017,VIRGIN MEDIA PYMTS,Bills,35,1968
20,12,2017,Wild Bean Cafe,Eating Out,1,1967
20,12,2017,Chicken Cottage,Eating Out,5,1962
20,12,2017,ATM Cash Withdrawal,General,10,1952
21,12,2017,Costa Coffee,Eating Out,2,1950
21,12,2017,Greggs,Eating Out,8,1942
22,12,2017,Sainsburys,Groceries,49,1893
22,12,2017,Starbucks Coffee,Eating Out,2,1891
22,12,2017,Pret A Manger,Eating Out,7,1884
23,12,2017,Dominos Pizza,Eating Out,29,1855
24,12,2017,O2,Bills,36,1819
25,12,2017,South West Trains,Transport,37,1782
26,12,2017,Caffe Nero,Eating Out,2,1780
26,12,2017,The West Cornwall Pasty Company,Eating Out,8,1772
27,12,2017,Wild Bean Cafe,Eating Out,1,1771
27,12,2017,McDonalds,Eating Out,7,1764
27,12,2017,ATM Cash Withdrawal,General,20,1744
28,12,2017,Caffe Nero,Eating Out,1,1743
28,12,2017,The West Cornwall Pasty Company,Eating Out,8,1735
28,12,2017,ATM Cash Withdrawal,General,10,1725
29,12,2017,Sainsburys,Groceries,63,1662
29,12,2017,Pret A Manger,Eating Out,6,1656
29,12,2017,Ministry of Sound ClubXOYO Club,Eating Out,15,1641
29,12,2017,Ministry of Sound ClubXOYO Club,Eating Out,16,1625
29,12,2017,Ministry of Sound ClubXOYO Club,Eating Out,9,1616
29,12,2017,Pizza Express,Eating Out,57,1559
31,12,2017,Anglo restaurant,Eating Out,30,1529
1,1,2018,Rhino Sports salary,General,1700,3229
1,1,2018,South West Trains,Transport,33,3196
2,1,2018,Wild Bean Cafe,Eating Out,1,3195
2,1,2018,ATM Cash Withdrawal,General,10,3185
3,1,2018,Wild Bean Cafe,Eating Out,2,3183
3,1,2018,Subway,Eating Out,5,3178
4,1,2018,Wild Bean Cafe,Eating Out,2,3176
4,1,2018,ATM Cash Withdrawal,General,10,3166
5,1,2018,Tescos,Groceries,79,3087
5,1,2018,Caffe Nero,Eating Out,1,3086
5,1,2018,Chicken Cottage,Eating Out,7,3079
5,1,2018,ATM Cash Withdrawal,General,10,3069
7,1,2018,Cubit and West rent,Rent,550,2519
7,1,2018,Pizza Express,Eating Out,29,2490
7,1,2018,ATM Cash Withdrawal,General,20,2470
8,1,2018,South West Trains,Transport,24,2446
8,1,2018,Greggs,Eating Out,4,2442
10,1,2018,Wild Bean Cafe,Eating Out,2,2440
11,1,2018,Pret A Manger,Eating Out,7,2433
11,1,2018,ATM Cash Withdrawal,General,20,2413
12,1,2018,ASDA,Groceries,60,2353
12,1,2018,Starbucks Coffee,Eating Out,1,2352
12,1,2018,Pret A Manger,Eating Out,5,2347
14,1,2018,Pizza Express,Eating Out,43,2304
15,1,2018,BRGAS-Electricity,Bills,83,2221
15,1,2018,BRGAS-Gas,Bills,71,2150
15,1,2018,South West Trains,Transport,34,2116
15,1,2018,Costa Coffee,Eating Out,2,2114
15,1,2018,Chicken Cottage,Eating Out,4,2110
15,1,2018,ATM Cash Withdrawal,General,20,2090
16,1,2018,LBS Council Tax,Bills,50,2040
16,1,2018,Wild Bean Cafe,Eating Out,2,2038
16,1,2018,McDonalds,Eating Out,5,2033
17,1,2018,Costa Coffee,Eating Out,2,2031
18,1,2018,Starbucks Coffee,Eating Out,1,2030
18,1,2018,Greggs,Eating Out,4,2026
19,1,2018,Morrisons,Groceries,78,1948
19,1,2018,Starbucks Coffee,Eating Out,1,1947
19,1,2018,Greggs,Eating Out,7,1940
19,1,2018,Restaurant Gordon RamsayPortland Restaurant,Eating Out,54,1886
20,1,2018,VIRGIN MEDIA PYMTS,Bills,56,1830
20,1,2018,Pizza Express,Eating Out,48,1782
21,1,2018,Restaurant Gordon RamsayPortland Restaurant,Eating Out,33,1749
21,1,2018,ATM Cash Withdrawal,General,10,1739
22,1,2018,South West Trains,Transport,24,1715
22,1,2018,Caffe Nero,Eating Out,1,1714
23,1,2018,Caffe Nero,Eating Out,2,1712
24,1,2018,O2,Bills,30,1682
24,1,2018,Wild Bean Cafe,Eating Out,1,1681
25,1,2018,Wild Bean Cafe,Eating Out,2,1679
25,1,2018,Subway,Eating Out,4,1675
26,1,2018,Morrisons,Groceries,65,1610
26,1,2018,Caffe Nero,Eating Out,1,1609
26,1,2018,Chicken Cottage,Eating Out,8,1601
28,1,2018,Restaurant Gordon RamsayPortland Restaurant,Eating Out,48,1553
29,1,2018,South West Trains,Transport,33,1520
29,1,2018,Starbucks Coffee,Eating Out,2,1518
29,1,2018,Subway,Eating Out,5,1513
30,1,2018,Starbucks Coffee,Eating Out,1,1512
30,1,2018,McDonalds,Eating Out,6,1506
30,1,2018,ATM Cash Withdrawal,General,20,1486
31,1,2018,ATM Cash Withdrawal,General,20,1466
1,2,2018,Rhino Sports salary,General,1700,3166
2,2,2018,Waitrose,Groceries,59,3107
2,2,2018,Caffe Nero,Eating Out,2,3105
2,2,2018,The West Cornwall Pasty Company,Eating Out,8,3097
4,2,2018,Scott's Restaurant,Eating Out,26,3071
5,2,2018,South West Trains,Transport,33,3038
5,2,2018,Costa Coffee,Eating Out,2,3036
5,2,2018,The West Cornwall Pasty Company,Eating Out,6,3030
6,2,2018,Starbucks Coffee,Eating Out,2,3028
6,2,2018,The West Cornwall Pasty Company,Eating Out,6,3022
7,2,2018,Cubit and West rent,Rent,550,2472
7,2,2018,Wild Bean Cafe,Eating Out,2,2470
7,2,2018,The West Cornwall Pasty Company,Eating Out,7,2463
7,2,2018,ATM Cash Withdrawal,General,10,2453
8,2,2018,Pret A Manger,Eating Out,5,2448
9,2,2018,Morrisons,Groceries,86,2362
9,2,2018,Starbucks Coffee,Eating Out,2,2360
9,2,2018,Greggs,Eating Out,7,2353
10,2,2018,Dominos Pizza,Eating Out,44,2309
11,2,2018,Pizza Express,Eating Out,43,2266
12,2,2018,South West Trains,Transport,34,2232
12,2,2018,Starbucks Coffee,Eating Out,1,2231
12,2,2018,Chicken Cottage,Eating Out,7,2224
13,2,2018,Costa Coffee,Eating Out,1,2223
13,2,2018,The West Cornwall Pasty Company,Eating Out,5,2218
14,2,2018,Caffe Nero,Eating Out,2,2216
14,2,2018,Subway,Eating Out,6,2210
15,2,2018,BRGAS-Electricity,Bills,28,2182
15,2,2018,BRGAS-Gas,Bills,39,2143
15,2,2018,Caffe Nero,Eating Out,2,2141
16,2,2018,LBS Council Tax,Bills,50,2091
16,2,2018,Tescos,Groceries,64,2027
16,2,2018,Costa Coffee,Eating Out,1,2026
17,2,2018,Dominos Pizza,Eating Out,31,1995
17,2,2018,ATM Cash Withdrawal,General,20,1975
18,2,2018,Anglo restaurant,Eating Out,33,1942
19,2,2018,South West Trains,Transport,34,1908
19,2,2018,Chicken Cottage,Eating Out,4,1904
20,2,2018,VIRGIN MEDIA PYMTS,Bills,38,1866
20,2,2018,Caffe Nero,Eating Out,1,1865
20,2,2018,Chicken Cottage,Eating Out,8,1857
21,2,2018,Starbucks Coffee,Eating Out,2,1855
22,2,2018,Wild Bean Cafe,Eating Out,2,1853
22,2,2018,Chicken Cottage,Eating Out,4,1849
22,2,2018,ATM Cash Withdrawal,General,20,1829
23,2,2018,Sainsburys,Groceries,75,1754
23,2,2018,Caffe Nero,Eating Out,2,1752
23,2,2018,McDonalds,Eating Out,5,1747
23,2,2018,Dominos Pizza,Eating Out,31,1716
24,2,2018,O2,Bills,33,1683
24,2,2018,ATM Cash Withdrawal,General,20,1663
25,2,2018,Dominos Pizza,Eating Out,24,1639
25,2,2018,ATM Cash Withdrawal,General,10,1629
26,2,2018,South West Trains,Transport,31,1598
26,2,2018,Wild Bean Cafe,Eating Out,1,1597
27,2,2018,Wild Bean Cafe,Eating Out,1,1596
27,2,2018,ATM Cash Withdrawal,General,20,1576
28,2,2018,Caffe Nero,Eating Out,2,1574
28,2,2018,McDonalds,Eating Out,4,1570
1,3,2018,Rhino Sports salary,General,1700,3270
1,3,2018,Starbucks Coffee,Eating Out,1,3269
1,3,2018,Subway,Eating Out,5,3264
2,3,2018,Morrisons,Groceries,43,3221
2,3,2018,Anglo restaurant,Eating Out,31,3190
3,3,2018,Dominos Pizza,Eating Out,33,3157
4,3,2018,Anglo restaurant,Eating Out,42,3115
4,3,2018,ATM Cash Withdrawal,General,10,3105
5,3,2018,South West Trains,Transport,32,3073
5,3,2018,Costa Coffee,Eating Out,2,3071
5,3,2018,Pret A Manger,Eating Out,4,3067
7,3,2018,Cubit and West rent,Rent,550,2517
7,3,2018,Starbucks Coffee,Eating Out,2,2515
7,3,2018,Subway,Eating Out,4,2511
8,3,2018,Wild Bean Cafe,Eating Out,2,2509
9,3,2018,Waitrose,Groceries,73,2436
9,3,2018,The West Cornwall Pasty Company,Eating Out,6,2430
10,3,2018,Pizza Express,Eating Out,51,2379
12,3,2018,South West Trains,Transport,33,2346
12,3,2018,Caffe Nero,Eating Out,2,2344
12,3,2018,Subway,Eating Out,4,2340
13,3,2018,Wild Bean Cafe,Eating Out,2,2338
14,3,2018,Wild Bean Cafe,Eating Out,2,2336
14,3,2018,The West Cornwall Pasty Company,Eating Out,8,2328
14,3,2018,ATM Cash Withdrawal,General,20,2308
15,3,2018,BRGAS-Electricity,Bills,38,2270
15,3,2018,BRGAS-Gas,Bills,34,2236
15,3,2018,Wild Bean Cafe,Eating Out,2,2234
15,3,2018,Pret A Manger,Eating Out,5,2229
16,3,2018,LBS Council Tax,Bills,50,2179
16,3,2018,Morrisons,Groceries,82,2097
16,3,2018,Greggs,Eating Out,6,2091
16,3,2018,Dominos Pizza,Eating Out,31,2060
17,3,2018,ATM Cash Withdrawal,General,10,2050
19,3,2018,South West Trains,Transport,38,2012
19,3,2018,Caffe Nero,Eating Out,1,2011
19,3,2018,The West Cornwall Pasty Company,Eating Out,5,2006
20,3,2018,VIRGIN MEDIA PYMTS,Bills,47,1959
20,3,2018,Starbucks Coffee,Eating Out,1,1958
20,3,2018,The West Cornwall Pasty Company,Eating Out,7,1951
21,3,2018,Starbucks Coffee,Eating Out,2,1949
21,3,2018,Pret A Manger,Eating Out,4,1945
21,3,2018,ATM Cash Withdrawal,General,20,1925
22,3,2018,Costa Coffee,Eating Out,2,1923
22,3,2018,Subway,Eating Out,6,1917
23,3,2018,Morrisons,Groceries,70,1847
23,3,2018,Wild Bean Cafe,Eating Out,2,1845
23,3,2018,Pret A Manger,Eating Out,4,1841
23,3,2018,Restaurant Gordon RamsayPortland Restaurant,Eating Out,48,1793
24,3,2018,O2,Bills,31,1762
24,3,2018,Restaurant Gordon RamsayPortland Restaurant,Eating Out,54,1708
26,3,2018,South West Trains,Transport,29,1679
26,3,2018,The West Cornwall Pasty Company,Eating Out,6,1673
